,A22,read_count,chromosome,start,end,length,rpkm,tpm
0,C1_00010W_A,27,C1,4059,4397,338,9.098310606411662,10.77193773470549
2,C1_00020C_A,766,C1,4409,4720,311,280.531785457286,332.135388235933
4,C1_00030C_A,6,C1,8597,8908,311,2.197376909587097,2.6015826754772817
6,C1_00040W_A,275,C1,10718,11485,767,40.836736243467286,48.34862197309747
8,C1_00050C_A,8,C1,11648,11995,347,2.625875961120411,3.1089037927893743
10,C1_00060W_A,5025,C1,12163,13701,1538,372.1289228305131,440.5817474717175
12,C1_00070W_A,1469,C1,13778,14917,1139,146.8966077753953,173.91812401754106
14,C1_00080C_A,786,C1,14910,15761,851,105.19780572677779,124.54885990789653
16,C1_00090W_A,43,C1,15595,16116,521,9.400358737014793,11.129547382967912
18,C1_00100C_A,298,C1,16600,17328,728,46.62282445666505,55.199056592922055
20,C1_00110W_A,2676,C1,17338,18960,1622,187.90959409444378,222.47541712993336
22,C1_00120C_A,573,C1,18948,19628,680,95.97528368116407,113.62986213678384
24,C1_00130C_A,856,C1,19615,21714,2099,46.44885591254871,54.99308667102272
26,C1_00140W_A,1353,C1,22270,25326,3056,50.42642060137365,59.70232127701555
28,C1_00150C_A,1294,C1,25381,27249,1868,78.8989274832953,93.41232355665814
30,C1_00160C_A,2452,C1,28286,29488,1202,232.34305389595832,275.082377149759
32,C1_00170W_A,230,C1,29804,31543,1739,15.064056962120473,17.835078472004025
34,C1_00180W_A,5457,C1,31842,32444,602,1032.45506158273,1222.3743635893504
36,C1_00190C_A,1803,C1,32680,33318,638,321.87610936350615,381.08496822581054
38,C1_00200C_A,123,C1,34099,34446,347,40.372842902226324,47.79939581413663
40,C1_00210C_A,1982,C1,34525,35679,1154,195.6192261443249,231.60322997249386
42,C1_00220W_A,15328,C1,37851,39485,1634,1068.4326098548518,1264.9699537598538
44,C1_00230C_A,730,C1,40484,41770,1286,64.65402796572816,76.54708590119327
46,C1_00240C_A,1,C1,42100,42172,72,1.5819079140777477,1.8728986390588769
48,C1_00270W_A,969,C1,42605,43504,899,122.76590806382238,145.34860094533892
50,C1_00280C_A,1,C1,43549,43679,130,0.8761336139507526,1.037297707786455
52,C1_00290W_A,3674,C1,43803,45764,1961,213.3905847502083,252.64361611064075
54,C1_00310W_A,430,C1,46803,48359,1556,31.475494228693492,37.265386802868136
56,C1_00320W_A,324,C1,48513,49298,785,47.00986983389261,55.65729866492418
58,C1_00330C_A,300,C1,49295,49843,548,62.35257471547327,73.82228212348856
60,C1_00340W_A,492,C1,49997,50743,746,75.11730019878036,88.93506888742849
62,C1_00350C_A,2884,C1,50806,51681,875,375.4057309056185,444.46132183234016
64,C1_00360W_A,375,C1,53099,54442,1343,31.803063052940573,37.653211656433115
66,C1_00370W_A,103,C1,54558,54842,284,41.307848911269645,48.9063954481008
68,C1_00380C_A,1160,C1,54837,57074,2237,59.06166695743116,69.92601445426793
70,C1_00390W_A,7009,C1,59349,62552,3203,249.2371729701865,295.0841562297171
72,C1_00400W_A,5697,C1,63202,64350,1148,565.2206583868178,669.1925569370437
74,C1_00410C_A,2771,C1,64696,66324,1628,193.86339788297275,229.52441847414903
76,C1_00420W_A,1435,C1,67843,68814,971,168.32412531669712,199.2872166710228
78,C1_00430W_A,1263,C1,69226,70902,1676,85.83077450750241,101.61927842569094
80,C1_00440W_A,2652,C1,71068,72581,1513,199.64033360585688,236.36401701021688
82,C1_00450C_A,665,C1,72741,73283,542,139.74492790782762,165.45089822534874
84,C1_00460W_A,872,C1,73580,73900,320,310.37033274205413,367.4627129833516
86,C1_00470C_A,624,C1,74056,75381,1325,53.639214161271745,63.506105702367705
88,C1_00480C_A,1293,C1,75573,77828,2255,65.30789320132239,77.32122913606437
90,C1_00490C_A,2155,C1,78008,78367,359,683.7014817501486,809.467835198817
92,C1_00500C_A,2959,C1,78641,79669,1028,327.84272108797273,388.1491335157739
94,C1_00510W_A,560,C1,80124,81053,929,68.65718740109234,81.28662338735619
96,C1_00520W_A,408,C1,81233,81901,668,69.56605820950287,82.36268027094845
98,C1_00530C_A,601,C1,82117,84558,2441,28.042736279382346,33.20117571051033
100,C1_00540C_A,857,C1,85080,87248,2168,45.023083916168524,53.30504502974581
102,C1_00550W_A,558,C1,87900,89810,1910,33.27472898219246,39.39558938368033
104,C1_00560W_A,715,C1,90099,91271,1172,69.48517015078707,82.266912917023
106,C1_00570C_A,800,C1,91310,93694,2384,38.22059389718048,45.25124228598628
108,C1_00580W_A,437,C1,93970,94899,929,53.577126596923854,63.432597179061894
110,C1_00590W_A,5929,C1,95214,96494,1280,527.5761762693919,624.6234017426294
112,C1_00600W_A,873,C1,96816,101423,4607,21.58289642875427,25.553053365896407
114,C1_00610W_A,3887,C1,101751,103523,1772,249.8414652739587,295.79960763068476
116,C1_00620W_A,800,C1,103868,104809,941,96.83092013908424,114.64289225270065
118,C1_00630W_A,516,C1,105179,106924,1745,33.6796807013275,39.875031655195066
120,C1_00640C_A,1920,C1,107125,111027,3902,56.0438108770138,66.35302610545851
122,C1_00650C_A,1477,C1,111571,112251,680,247.39178708041766,292.8993130471723
124,C1_00660C_A,839,C1,112788,113801,1013,94.33355703219013,111.68614115327603
126,C1_00670C_A,383,C1,114127,115878,1751,24.913016926675027,29.495746927862697
128,C1_00680W_A,320,C1,117319,119442,2123,17.167761818347294,20.325758193083615
130,C1_00690W_A,335,C1,119767,122808,3041,12.547063100149712,14.855085555442324
132,C1_00700W_A,398,C1,123066,123431,365,124.19494023510121,147.04050246814018
134,C1_00710C_A,2389,C1,123869,125597,1728,157.46575028048915,186.43145202965235
136,C1_00720W_A,3,C1,126521,126612,91,3.754858345503226,4.445561604799091
138,C1_00730C_A,1331,C1,126791,128620,1829,82.8854014335149,98.13210627571912
140,C1_00740C_A,1639,C1,129260,130681,1421,131.37071718823847,155.53625798596758
142,C1_00750C_A,2418,C1,131413,133938,2525,109.07082780565527,129.13432137251255
144,C1_00760W_A,615,C1,134254,134913,659,106.2926895832514,125.8451467944265
146,C1_00770C_A,349,C1,135654,136436,782,50.831434865659396,60.1818375988126
148,C1_00780C_A,329,C1,138574,140931,2357,15.898275209450018,18.8227505142243
150,C1_00790W_A,296,C1,150607,151707,1100,30.64874678620451,36.286559814202526
152,C1_00800C_A,2225,C1,154633,155286,653,388.0882815241274,459.4768177292987
154,C1_00810W_A,248,C1,155443,156324,881,32.0619156796507,37.959680021606474
156,C1_00820W_A,248,C1,156643,157689,1046,27.004347718711536,31.971776385310996
158,C1_00830W_A,483,C1,158725,160524,1799,30.579449483028213,36.20451532624318
160,C1_00840C_A,193,C1,160942,162672,1730,12.706469580360915,15.043814733157314
162,C1_00850W_A,372,C1,167077,167823,746,56.7960074673705,67.2435886709825
164,C1_00860W_A,487,C1,168533,169534,1001,55.41260649272942,65.60571216779266
166,C1_00870W_A,1819,C1,170158,172254,2096,98.84509336399546,117.02757106882775
168,C1_00880W_A,249,C1,174459,176084,1625,17.452581589898994,20.662970339106177
170,C1_00890W_A,442,C1,176325,178475,2150,23.415180212841975,27.72238432065567
172,C1_00900W_A,416,C1,178690,179307,617,76.79304026330098,90.91906002770092
174,C1_00910W_A,160,C1,179823,180829,1006,18.114889831188524,21.447109663974413
176,C1_00920W_A,637,C1,181403,185239,3836,18.913614330360225,22.39275891079153
178,C1_00930C_A,2740,C1,185507,190145,4638,67.28736379673525,79.6648218011072
180,C1_00940W_A,237,C1,190698,191156,458,58.93815861533338,69.7797868491281
182,C1_00950C_A,625,C1,191444,193405,1961,36.30079354079482,42.97829615382429
184,C1_00960C_A,925,C1,194676,197798,3122,33.74601764176105,39.95357122399782
186,C1_00970W_A,68,C1,198221,198746,525,14.75242123299934,17.46611759396621
188,C1_00980W_A,189,C1,198951,199220,269,80.02454607721187,94.74499881157321
190,C1_00990C_A,1138,C1,199316,202249,2933,44.192024155429365,52.321112475256776
192,C1_01000C_A,352,C1,202532,203623,1091,36.747822341325794,43.50755555298641
194,C1_01010W_A,1195,C1,203945,204415,470,289.5901211218073,342.8599976694165
196,C1_01020W_A,1,C1,204985,205057,72,1.5819079140777477,1.8728986390588769
198,C1_01030W_A,870,C1,205265,206284,1019,97.24309297137401,115.13088395549366
200,C1_01040W_A,517,C1,206477,206920,443,132.92311556124173,157.37421882692465
202,C1_01050C_A,999,C1,206917,207855,938,121.30434162450346,143.61818050130796
204,C1_01060W_A,3586,C1,208285,208740,455,897.6614684649711,1062.7855943206362
206,C1_01070C_A,278,C1,209078,210502,1424,22.235582028216434,26.3257999714905
208,C1_01080W_A,224,C1,210872,212377,1505,16.952166669930843,20.070504485542568
210,C1_01090C_A,573,C1,212439,212747,308,211.89348345192067,250.87112419809424
212,C1_01100W_A,4308,C1,213635,220399,6764,72.54137627986096,85.88530577597962
214,C1_01110C_A,1129,C1,220539,222068,1529,84.10080478714976,99.57108212676125
216,C1_01130W_A,3170,C1,224667,226874,2207,163.5952253326258,193.68843922917898
218,C1_01140C_A,3477,C1,227677,229779,2102,188.4020717611226,223.05848567866573
220,C1_01150C_A,759,C1,232865,234934,2069,41.782553740222696,49.46842185949227
222,C1_01160C_A,441,C1,235077,235889,812,61.85805429531607,73.23679505837124
224,C1_01170C_A,446,C1,236084,238300,2216,22.923387606888376,27.140126849033685
226,C1_01180C_A,67,C1,239091,240914,1823,4.186025111086701,4.956041160076808
228,C1_01190C_A,400,C1,241113,242504,1391,32.7526584654487,38.777484403231945
230,C1_01200W_A,736,C1,242741,244663,1922,43.61522590156504,51.63821263319875
232,C1_01210W_A,796,C1,245206,246453,1247,72.70433550250512,86.07824122032265
234,C1_01220C_A,920,C1,246661,247413,752,139.34252689961437,164.9744758660372
236,C1_01240W_A,1095,C1,248816,249865,1049,118.8919160589987,140.76199113765665
238,C1_01250W_A,1140,C1,250103,251977,1874,69.28655367529431,82.03176109602595
240,C1_01260C_A,168,C1,252036,252488,452,42.333535682930176,50.12075650012427
242,C1_01270W_A,801,C1,253158,254441,1283,71.1081786599313,84.18847257350235
244,C1_01280C_A,90,C1,254618,254965,347,29.54110456260463,34.97516766888046
246,C1_01290C_A,553,C1,255170,257443,2273,27.710182801108495,32.80744927970446
248,C1_01300W_A,1317,C1,257921,258904,983,152.59698478586813,180.66708092585853
250,C1_01310W_A,18,C1,258992,259345,353,5.807797894177793,6.876137779660918
252,C1_01320W_A,2738,C1,259647,261173,1526,204.3584525226939,241.950030215931
254,C1_01330C_A,181,C1,261359,261838,479,43.03846333248687,50.95535504011541
256,C1_01340C_A,211,C1,262217,263083,866,27.750975785992082,32.85574610228921
258,C1_01350C_A,9556,C1,263479,264672,1193,912.3246152043092,1080.146015447575
260,C1_01360C_A,1599,C1,265483,267465,1982,91.8879386134929,108.79065313701832
262,C1_01370C_A,1627,C1,269372,270012,640,289.54846982300575,342.81068464673916
264,C1_01380C_A,539,C1,270319,271974,1655,37.09406787282733,43.91749267951473
266,C1_01390C_A,1447,C1,272374,274197,1823,90.4056468021262,107.03569490494242
268,C1_01400C_A,1936,C1,275477,276952,1475,149.49512404008502,176.99463531911522
270,C1_01420C_A,2013,C1,278222,279262,1040,220.45712061035815,261.0100357217667
272,C1_01440C_A,26,C1,280421,280819,398,7.440531696365689,8.809211689241753
274,C1_01450W_A,1873,C1,282437,284137,1700,125.4881021534522,148.57154051113167
276,C1_01460W_A,1095,C1,284639,287617,2978,41.87965747007711,49.5833877445943
278,C1_01470W_A,1782,C1,288033,289328,1295,156.72981699446436,185.56014439058697
280,C1_01480C_A,5079,C1,289699,290448,749,772.3427787493504,914.4146295329273
282,C1_01490W_A,4900,C1,291847,292449,602,927.0716147618429,1097.605714053109
284,C1_01500W_A,3,C1,296046,296504,458,0.7460526407004227,0.8832884411282038
286,C1_01510W_A,1384,C1,299614,301767,2153,73.2159590441335,86.6839775127445
288,C1_01520C_A,1914,C1,305308,306012,704,309.6584741807191,366.6199085957751
290,C1_01530C_A,2312,C1,306618,308486,1868,140.96933565794336,166.90053482457006
292,C1_01540W_A,1209,C1,309122,310972,1850,74.4334703268323,88.1254490447552
294,C1_01550W_A,947,C1,311200,312759,1559,69.18589429985705,81.91258550711382
296,C1_01560W_A,1555,C1,313161,317798,4637,38.19504206602214,45.220990215447884
298,C1_01570C_A,206,C1,317950,318471,521,45.034276740117384,53.318296764916035
300,C1_01580W_A,354,C1,318929,319459,530,76.07484700757288,90.0687556836465
302,C1_01590C_A,3371,C1,319665,323369,3704,103.65767646912482,122.72542507647356
304,C1_01600W_A,562,C1,323650,324531,881,72.65643795146649,86.02153295218886
306,C1_01610C_A,557,C1,324887,325940,1053,60.24770653957645,71.33022509099447
308,C1_01620C_A,461,C1,326428,327426,998,52.61191130668197,62.289831290222686
310,C1_01630W_A,1876,C1,331354,332037,683,312.84255603266405,370.38969981692617
312,C1_01640W_A,522,C1,332721,334077,1356,43.84544767160625,51.91078351798585
314,C1_01650W_A,1418,C1,334643,336025,1382,116.86430564086956,138.36140336711657
316,C1_01660C_A,1,C1,336119,336200,81,1.4061403680691091,1.6647987902745571
318,C1_01670C_A,330,C1,336700,341496,4796,7.836974987174163,9.278580413686178
320,C1_01680C_A,356,C1,341928,342440,512,79.19426494851726,93.76198811788501
322,C1_01690C_A,3324,C1,342930,343901,971,389.90201571616814,461.62418690904514
324,C1_01700W_A,1226,C1,345562,348762,3200,43.636929809834676,51.663908958439116
326,C1_01710W_A,1871,C1,351098,353101,2003,106.39140235708516,125.96201770589086
328,C1_01720C_A,371,C1,353541,353627,86,491.34795582377683,581.7310284481478
330,C1_01730W_A,5,C1,354206,354278,72,7.909539570388739,9.364493195294383
332,C1_01740W_A,9458,C1,357079,359466,2387,451.2950664838744,534.3104414041716
334,C1_01750W_A,942,C1,361029,362930,1901,56.439412080173156,66.82139784088862
336,C1_01760W_A,777,C1,364172,366307,2135,41.45117393216184,49.076084994618164
338,C1_01770W_A,213,C1,366730,367860,1130,21.4691502392003,25.418383653634454
340,C1_01780C_A,4035,C1,367933,369807,1874,245.23793340334436,290.3492596688286
342,C1_01790W_A,818,C1,372225,375440,3215,28.979175274501724,34.30987192721978
344,C1_01800W_A,216,C1,375835,376554,719,34.21673418600436,40.51087570882287
346,C1_01810C_A,1849,C1,376645,378174,1529,137.7346218347563,163.0707979206214
348,C1_01820C_A,547,C1,378463,379650,1187,52.486825010984006,62.14173546815063
350,C1_01830C_A,2297,C1,380212,380784,572,457.38157073747243,541.5165533603379
352,C1_01840C_A,594,C1,381538,382092,554,122.1210066232439,144.58507038857405
354,C1_01850C_A,574,C1,382760,383590,830,78.7675786421749,93.25681319882561
356,C1_01860W_A,603,C1,383753,384670,917,74.89652562442694,88.67368300259562
358,C1_01870C_A,1795,C1,384790,386280,1490,137.21193209087792,162.45195980669072
360,C1_01880C_A,487,C1,386597,388924,2327,23.836707820894777,28.22145160290522
362,C1_01890C_A,3032,C1,389271,390800,1529,225.85796290047656,267.4043587319222
364,C1_01900C_A,731,C1,391247,392764,1517,54.88396660101518,64.97982938098009
366,C1_01910W_A,874,C1,393296,394360,1064,93.55855377545538,110.76857665291071
368,C1_01920W_A,9122,C1,395587,399411,3824,271.69764838902705,321.6762185553465
370,C1_01930W_A,2545,C1,400591,401977,1386,209.14055279625288,247.61179409895277
372,C1_01940C_A,457,C1,402263,402769,506,102.86778261820992,121.79023086876141
374,C1_01950C_A,376,C1,403144,403689,545,78.5787358713996,93.03323294789341
376,C1_01970W_A,8,C1,405749,406027,278,3.27762215290929,3.8805381874025646
378,C1_01980W_A,10363,C1,406673,408310,1637,721.0253166636007,853.6573603865816
380,C1_01990W_A,29,C1,411340,412368,1028,3.213058097854414,3.8040976248588856
382,C1_02000W_A,460,C1,412817,413818,1001,52.340449664590416,61.96843449113886
384,C1_02010C_A,445,C1,414090,416273,2183,23.217741441617516,27.488626841707013
386,C1_02020W_A,124,C1,416452,417075,623,22.66978147172734,26.83987006343122
388,C1_02030C_A,216,C1,417078,417521,443,55.534609209338896,65.75015718881185
390,C1_02040C_A,5592,C1,418019,420493,2474,257.4430444614548,304.7994913712373
392,C1_02050C_A,1691,C1,421264,423846,2582,74.59351369279395,88.31493226285683
394,C1_02060W_A,626,C1,425985,426615,630,113.17421191001942,133.99251977724077
396,C1_02070W_A,26,C1,427843,428838,995,2.9762126785462755,3.5236846756967006
398,C1_02080W_A,318,C1,429371,430510,1139,31.79926567227754,37.64871575056369
400,C1_02090C_A,372,C1,430507,431994,1487,28.493491305082983,33.734846771051075
402,C1_02100W_A,159,C1,432225,433841,1616,11.206486262600283,13.26791065590719
404,C1_02110C_A,4967,C1,434412,436049,1637,345.5884153110205,409.1591343279119
406,C1_02120C_A,8355,C1,442448,444235,1787,532.5195997720257,630.4761641366861
408,C1_02130C_A,3005,C1,449253,450800,1547,221.24214369092536,261.9394631847308
410,C1_02140C_A,11,C1,451280,451624,344,3.642067057992954,4.312022448065786
412,C1_02150W_A,3360,C1,452164,454191,2027,188.79879752032008,223.52818883133864
414,C1_02160W_A,181,C1,454396,454902,506,40.74194453806563,48.236393407540085
416,C1_02170C_A,797,C1,454861,455823,962,94.3619581511824,111.71976663591953
418,C1_02180W_A,1309,C1,456751,457911,1160,128.52729059137894,152.16978528794917
420,C1_02190W_A,183,C1,458366,459304,938,22.22091543271685,26.308435467206568
422,C1_02200C_A,183,C1,459294,460130,836,24.932079755847376,29.51831634956909
424,C1_02210W_A,912,C1,461070,462782,1712,60.674299807243706,71.8352898569872
426,C1_02220C_A,598,C1,462849,463859,1010,67.43626450349655,79.84111267655346
428,C1_02230W_A,805,C1,465637,467649,2012,45.570269731583636,53.95288524843563
430,C1_02240W_A,1344,C1,469116,471743,2627,58.27105634924839,68.98997164234845
432,C1_02250W_A,1199,C1,474919,475644,725,188.36268469862597,223.01185339679267
434,C1_02260C_A,906,C1,475896,477035,1139,90.59790785875299,107.26332223273806
436,C1_02270C_A,1332,C1,477305,478183,878,172.7919095577589,204.57684633291856
438,C1_02280C_A,250,C1,478626,481568,2942,9.678566435553861,11.458931170312638
440,C1_02290C_A,341,C1,482379,483590,1211,32.07184401852755,37.971434670663534
442,C1_02300W_A,69,C1,483698,484063,365,21.53128360859795,25.491946407793147
444,C1_02310C_A,125,C1,484174,484539,365,39.00594856630063,46.181062332958604
446,C1_02320C_A,2236,C1,484846,486477,1631,156.14624089712126,184.8692199260372
448,C1_02330C_A,1073,C1,487350,488196,846,144.4584844089722,171.03150976256808
450,C1_02340C_A,33,C1,488645,488749,104,36.14051157546855,42.78853044619127
452,C1_02350W_A,437,C1,489332,490138,806,61.753288596206275,73.11275779075496
454,C1_02360C_A,64,C1,490252,492177,1925,3.786717749646889,4.483281521445871
456,C1_02370C_A,238,C1,492588,496217,3629,7.469709015055465,8.843756152910695
458,C1_02380C_A,71,C1,498351,498953,602,13.433078499610378,15.904082795463419
460,C1_02390W_A,387,C1,499217,501709,2492,17.687914172496935,20.94159216642718
462,C1_02400C_A,272,C1,502050,503384,1334,23.223451716115903,27.49538751673841
464,C1_02410C_A,322,C1,504151,505224,1073,34.17982579681128,40.467178050271194
466,C1_02420C_A,11106,C1,505969,511662,5693,222.19290165990122,263.0651123393514
468,C1_02430C_A,2068,C1,515594,517525,1931,121.97812572476455,144.41590666044044
470,C1_02440C_A,544,C1,518168,519169,1001,61.898270907689536,73.2844094851729
472,C1_02450C_A,375,C1,520056,520586,530,80.58776166056451,95.41181746148993
474,C1_02460W_A,6060,C1,521288,521950,662,1042.6254698948683,1234.41561056521
476,C1_02470W_A,92,C1,522615,523085,470,22.2948043039383,26.39591613856596
478,C1_02480W_A,586,C1,523976,524734,758,88.05258405114557,104.24978809917167
480,C1_02490C_A,524,C1,524841,526862,2021,29.53103502341676,34.96324584582548
482,C1_02500W_A,306,C1,527100,527726,626,55.675072145305016,65.91645817211688
484,C1_02510W_A,233,C1,528029,528760,731,36.303812813362924,42.981870819222586
486,C1_02520W_A,142,C1,530172,531908,1736,9.316489927149133,11.030250971047211
488,C1_02530C_A,14279,C1,532403,534163,1760,924.0571270274792,1094.0367136549787
490,C1_02540C_A,1,C1,536532,536604,72,1.5819079140777477,1.8728986390588769
492,C1_02560W_A,13,C1,536928,537227,299,4.95205955711295,5.862987044010397
494,C1_02570C_A,198,C1,537385,539079,1694,13.312679588602345,15.761536598833144
496,C1_02580W_A,391,C1,540001,541512,1511,29.47311157982578,34.894667430036726
498,C1_02590C_A,3777,C1,541722,542600,878,489.96624804778935,580.0951566061813
500,C1_02600W_A,491,C1,544056,544805,749,74.66436392319964,88.39881533779628
502,C1_02610W_A,953,C1,545022,549395,4373,24.821448303763717,29.387334328301826
504,C1_02620C_A,1385,C1,549494,550573,1079,146.19819943636054,173.09124401014938
506,C1_02630C_A,375,C1,550937,552376,1439,29.681385462195408,35.141253130361136
508,C1_02640C_A,816,C1,552858,553373,515,180.4665121706715,213.66318610094586
510,C1_02650W_A,1503,C1,553758,554360,602,284.3650279565408,336.6737526983312
512,C1_02660C_A,442,C1,554577,555404,827,60.87380587377297,72.07149490859696
514,C1_02670C_A,44,C1,555675,558101,2426,2.0657396009061437,2.4457307867017812
516,C1_02680C_A,210,C1,558921,561449,2528,9.461411258249822,11.20183046778885
518,C1_02690C_A,15,C1,562357,562659,302,5.657154129814462,6.697783212528433
520,C1_02700C_A,3773,C1,564255,564428,173,2484.0160480156337,2940.9488594923596
522,C1_02710W_A,4264,C1,565683,567173,1490,325.94522475515515,385.902594214891
524,C1_02720W_A,489,C1,567442,568635,1193,46.68551034270691,55.273273498730035
526,C1_02730W_A,254,C1,574220,575107,887,32.61548132204493,38.6150736314642
528,C1_02740C_A,161,C1,575478,576398,920,19.932039717379624,23.598522852141844
530,C1_02750C_A,1228,C1,576658,579045,2387,58.59487646883039,69.37335821995376
532,C1_02760W_A,1719,C1,579750,580802,1052,186.1117668341965,220.34688094965688
534,C1_02770W_A,329,C1,581212,581508,296,126.59538739416789,149.88251000684684
536,C1_02780W_A,1091,C1,581844,582602,758,163.93407713276417,194.08962255323598
538,C1_02790W_A,1767,C1,582899,583951,1052,191.30860500059637,226.49967343690736
540,C1_02800W_A,71,C1,584332,584934,602,13.433078499610378,15.904082795463419
542,C1_02810W_A,2919,C1,585914,588472,2558,129.9712363119203,153.879343695749
544,C1_02820W_A,3140,C1,588902,593116,4214,84.86894665749814,100.48052309407471
546,C1_02830W_A,575,C1,593697,595466,1769,37.02147407734243,43.8315453120619
548,C1_02840W_A,1048,C1,598018,599733,1715,69.6002586382802,82.40317184188142
550,C1_02850W_A,1305,C1,600683,602722,2039,72.89655105774654,86.30581467678864
552,C1_02860C_A,1242,C1,603130,603732,602,234.98427459881813,278.2094483375432
554,C1_02870W_A,473,C1,604676,605542,866,62.20953339703438,73.65292846626917
556,C1_02880C_A,995,C1,605725,606483,758,149.50908042813964,177.0111589738495
558,C1_02890C_A,297,C1,607149,607523,374,90.447911322563,107.08573395089577
560,C1_02900C_A,425,C1,607807,609984,2177,22.235361585107526,26.325538978043923
562,C1_02910C_A,280,C1,610205,611635,1430,22.30158290056461,26.403941652746123
564,C1_02920W_A,653,C1,611934,613046,1112,66.88397705780521,79.18723238668358
566,C1_02930C_A,316,C1,613106,614473,1367,26.32887261236058,31.172048160839477
568,C1_02940C_A,515,C1,614701,615219,518,113.23773253668512,134.0677249735582
570,C1_02950W_A,120,C1,615467,615844,377,36.25380471520356,42.92266377047399
572,C1_02960C_A,1382,C1,615939,617726,1787,88.08403194314059,104.28702080633153
574,C1_02970W_A,1737,C1,618379,619644,1265,156.39504455827623,185.16379082629197
576,C1_02980W_A,668,C1,620103,621131,1028,74.01113135747408,87.62542115192193
578,C1_02990C_A,1492,C1,622222,623538,1316,129.12984480386626,152.88317887709786
580,C1_03000W_A,437,C1,628046,629806,1760,28.28019920939901,33.48231976099346
582,C1_03010W_A,1276,C1,630193,630513,320,454.16576213172146,537.7091992738035
584,C1_03020C_A,5360,C1,631014,631622,608,1004.0952338830335,1188.7977677394763
586,C1_03030W_A,2752,C1,632083,632838,755,415.1596844066506,491.52798402341995
588,C1_03040W_A,214,C1,633766,634524,758,32.15572182072551,38.07074172904904
590,C1_03050W_A,1104,C1,635104,638259,3155,39.85505428659652,47.186360387167035
592,C1_03060C_A,234,C1,638337,638966,629,42.37199449345294,50.16628977879802
594,C1_03070C_A,1144,C1,639143,641560,2417,53.90922261760692,63.825782003310536
596,C1_03080C_A,250,C1,641962,642642,680,41.87403301970509,49.576728680970255
598,C1_03090W_A,6437,C1,643226,643996,770,952.1524279092588,1127.3001231854328
600,C1_03100W_A,4004,C1,645104,649550,4446,102.57423948125185,121.44269070108083
602,C1_03110W_A,3118,C1,650064,650956,892,398.1300438103117,471.36575434323044
604,C1_03120W_A,1658,C1,651902,653134,1232,153.28071359654643,181.4765811171205
606,C1_03130C_A,2001,C1,653447,655201,1754,129.93650912030176,153.83822846436172
608,C1_03140W_A,268,C1,655798,656274,476,64.12709056731978,75.92321878000017
610,C1_03150C_A,1182,C1,656446,657201,755,178.31349817175183,211.1141268588962
612,C1_03160C_A,1825,C1,657572,658543,971,214.07075170938833,253.4488992506039
614,C1_03170C_A,233,C1,658804,660771,1967,13.491655905728672,15.973435469675502
616,C1_03180W_A,102,C1,660929,661792,863,13.461798054446094,15.938085289974959
618,C1_03190C_A,16209,C1,662177,664336,2159,855.100725941921,1012.3958364596497
620,C1_03200C_A,914,C1,668763,671960,3197,32.56246356259882,38.552303296586345
622,C1_03210C_A,2585,C1,672483,673838,1355,217.28760219051694,257.25748686467756
624,C1_03220C_A,8414,C1,675074,675868,794,1206.9678458584538,1428.9886382002264
626,C1_03230C_A,1319,C1,677396,679090,1694,88.68396150185097,104.9973069386915
628,C1_03240W_A,469,C1,679785,680210,425,125.68909751194678,148.80950880880036
630,C1_03250C_A,391,C1,680242,681462,1220,36.50317344025964,43.21790367769302
632,C1_03260W_A,518,C1,681644,683680,2036,28.977818056701217,34.308265050265156
634,C1_03270W_A,398,C1,683901,685105,1204,37.65045945665444,44.57623206052423
636,C1_03280W_A,1517,C1,685412,686344,932,185.38874464294844,219.49085939116605
638,C1_03290W_A,1029,C1,686628,688511,1883,62.24131361560923,73.6905546312236
640,C1_03300C_A,933,C1,688617,690020,1403,75.74215683256364,89.67486741084754
642,C1_03310W_A,952,C1,690480,691616,1136,95.44920428040945,113.00701084124263
644,C1_03320C_A,1810,C1,691821,693329,1508,136.70705528024672,161.85421130116234
646,C1_03330C_A,745,C1,694143,695732,1589,53.400591888691245,63.22358904916183
648,C1_03340C_A,683,C1,696019,696900,881,88.29955003710253,104.54218328531137
650,C1_03350C_A,1640,C1,697530,699398,1868,99.99554951515015,118.38965273023135
652,C1_03360W_A,1677,C1,701716,705948,4232,45.13371672433922,53.43602865655128
654,C1_03370W_A,5468,C1,706488,708377,1889,329.6933923455548,390.34023430541214
656,C1_03380W_A,4289,C1,709461,712127,2666,183.2354910467071,216.9415164780546
658,C1_03390W_A,3202,C1,712967,714244,1277,285.59074247700886,338.1249364472902
660,C1_03400W_A,983,C1,715541,717490,1949,57.445415354934156,68.01245463213498
662,C1_03410W_A,100,C1,717686,718510,824,13.822496336601679,16.365133739349407
664,C1_03420W_A,3,C1,719205,719309,104,3.2855010523153227,3.8898664041992057
666,C1_03430W_A,358,C1,719613,720668,1055,38.649534022055,45.75908561173612
668,C1_03440C_A,769,C1,721115,722551,1436,60.99378648095874,72.21354585474364
670,C1_03450C_A,1374,C1,723114,726743,3629,43.1234461625471,51.055970395375184
672,C1_03460C_A,235,C1,727114,730086,2972,9.006016792124997,10.662666545382299
674,C1_03470C_A,41,C1,731029,732438,1409,3.314259873923003,3.923915388574737
676,C1_03480C_A,1630,C1,732768,735644,2876,64.55240361479989,76.42676783030244
678,C1_03490W_A,1253,C1,736791,737672,881,161.9902433330739,191.78822204464885
680,C1_03500W_A,2765,C1,738229,738852,623,505.4995626558556,598.4858123015107
682,C1_03510C_A,2981,C1,739135,739680,545,622.9872649804315,737.5852856852933
684,C1_03520W_A,3612,C1,740588,742033,1445,284.70401367938786,337.0750945800745
686,C1_03530W_A,580,C1,742220,743984,1764,37.449248578167094,44.33800859812851
688,C1_03540C_A,169,C1,744051,744458,407,47.29399385380353,55.99368707633516
690,C1_03550C_A,2491,C1,744891,746333,1442,196.7533621398559,232.94598939839642
692,C1_03560C_A,2925,C1,746720,747754,1034,322.1951708943653,381.46272087601494
694,C1_03570C_A,1,C1,748226,748341,115,0.9904119114225899,1.1725974088020792
696,C1_03580W_A,1,C1,749095,749193,98,1.162218059322427,1.3760071633901951
698,C1_03600W_A,872,C1,749583,750410,827,120.09492923513582,142.18629764772976
700,C1_03610C_A,172,C1,750533,751084,551,35.55416988736629,42.09433166262274
702,C1_03620C_A,585,C1,751389,752110,721,92.41326122185122,109.41260842879319
704,C1_03630W_A,462,C1,752775,756314,3539,14.868772210760726,17.60387124319143
706,C1_03640C_A,202,C1,756361,757074,713,32.2682590495747,38.20398009322904
708,C1_03650C_A,485,C1,757289,757795,506,109.1704038727173,129.2522143793201
710,C1_03660W_A,147,C1,758284,758523,239,70.05403080585307,82.94041504518472
712,C1_03670C_A,1780,C1,758553,759638,1085,186.85467121493468,221.22644201086234
714,C1_03680W_A,668,C1,761416,764853,3437,22.136585113611684,26.208592651782293
716,C1_03690W_A,638,C1,765465,766517,1052,69.0746406283987,81.78086680970395
718,C1_03700C_A,2,C1,766633,766720,87,2.618330340542479,3.0999701612008987
720,C1_03710C_A,796,C1,767067,770930,3863,23.469403668553944,27.786582138685567
722,C1_03720C_A,364,C1,773999,775771,1772,23.39652517615667,27.700297704545733
724,C1_03730C_A,1003,C1,776730,778577,1847,61.851143434238566,73.22861294979742
726,C1_03740W_A,517,C1,781112,783955,2843,20.712254728677483,24.522257805250657
728,C1_03750W_A,425,C1,784461,785012,551,87.8518732682016,104.01215672450387
730,C1_03760C_A,1963,C1,785087,786874,1787,125.11501787582125,148.12982767209033
732,C1_03770W_A,3113,C1,788296,790142,1846,192.07070001610515,227.40195523515732
734,C1_03780C_A,2229,C1,790364,793585,3221,78.81938445032895,93.31814864491804
736,C1_03790C_A,2687,C1,795543,796823,1280,239.09549428838858,283.0769236772551
738,C1_03800W_A,210,C1,797157,798089,932,25.663570451561746,30.384364187307096
740,C1_03810C_A,408,C1,798181,799359,1178,39.44832502881827,46.70481360016431
742,C1_03820W_A,2304,C1,801727,802836,1109,236.6271776830743,280.15456216068435
744,C1_03830C_A,597,C1,803002,803994,992,68.54509050273982,81.15390635212374
746,C1_03840W_A,46,C1,804198,804467,269,19.476873648421936,23.059629340382894
748,C1_03860C_A,1341,C1,806466,811433,4967,30.750226076109264,36.4067061402079
750,C1_03870C_A,2870,C1,813869,815560,1691,193.3089600029721,228.86799217925858
752,C1_03880C_A,4,C1,820902,821264,362,1.2585344730784291,1.490040906212587
754,C1_03890W_A,11,C1,823543,824613,1070,1.1709075401397908,1.3862950674155425
756,C1_03900W_A,98,C1,825308,825823,515,21.673674255791436,25.66052970329987
758,C1_03910C_A,583,C1,825919,827970,2051,32.375507850476616,38.33095722727226
760,C1_03920C_A,190,C1,828496,830040,1544,14.015868047010096,16.594076024822172
762,C1_03930W_A,337,C1,830273,831781,1508,25.453192060465827,30.135286855520278
764,C1_03940W_A,1187,C1,832111,832620,509,265.6113516085278,314.47035223679336
766,C1_03950C_A,72,C1,833227,833766,539,15.21449095840268,18.013184684380736
768,C1_03960C_A,868,C1,834229,836838,2609,37.893030662400506,44.86342405006652
770,C1_03970W_A,7,C1,837444,837761,317,2.5150838760100473,2.9777315901756274
772,C1_03980W_A,127,C1,838231,838758,527,27.447753256787333,32.496746025719865
774,C1_03990W_A,623,C1,839278,840204,926,76.62857601929964,90.72434271449781
776,C1_04000C_A,1877,C1,840359,841801,1442,148.256146421722,175.5277487357648
778,C1_04010C_A,4990,C1,842768,843802,1034,549.6594539360283,650.7688810842101
780,C1_04020C_A,8882,C1,844770,845783,1013,998.653937496916,1182.3555491339664
782,C1_04030W_A,484,C1,846649,848745,2096,26.300728525659043,31.138726991375826
784,C1_04040C_A,943,C1,848808,850970,2162,49.678640025079915,58.81698704789152
786,C1_04050C_A,1,C1,851796,852227,431,0.26426303901066783,0.31287401858988195
788,C1_04060W_A,135,C1,853943,855709,1766,8.706763830597797,10.308366235363692
790,C1_04070C_A,193,C1,855857,857047,1190,18.472430566407045,21.870419738119455
792,C1_04080W_A,149,C1,857251,857895,644,26.352031214636767,31.19946676991247
794,C1_04090C_A,254,C1,857906,859393,1487,19.455233310459885,23.03400827915853
796,C1_04100C_A,12043,C1,859621,860469,848,1617.5306894636308,1915.074196147872
798,C1_04110W_A,203,C1,862034,862951,917,25.213921561788837,29.852002735533848
800,C1_04120C_A,328,C1,863013,864074,1061,35.21049698290301,41.68744039586658
802,C1_04130W_A,1264,C1,864122,866671,2549,56.479511747503985,66.86887381069842
804,C1_04140W_A,978,C1,867380,868414,1034,107.72884688365444,127.54548410828806
806,C1_04150C_A,97,C1,868503,869087,584,18.91788505465581,22.397815231484923
808,C1_04160C_A,117,C1,869423,870325,902,14.773827348326995,17.49146134748556
810,C1_04170C_A,1048,C1,870671,871066,395,302.1884647206343,357.77579673120664
812,C1_04180W_A,1246,C1,871931,872323,392,362.03092547893607,428.62623139604574
814,C1_04190C_A,405,C1,872592,873764,1172,39.358732742753524,46.598740883068984
816,C1_04200C_A,353,C1,874582,875391,809,49.69811068504331,58.84003932054439
818,C1_04210C_A,1883,C1,876392,877791,1399,153.30146344460667,181.50114788352127
820,C1_04220C_A,405,C1,878742,879311,569,81.06930540335172,95.98194079957266
822,C1_04230W_A,1672,C1,879636,880616,980,194.32285951870978,230.06839771884063
824,C1_04240C_A,1582,C1,880940,881257,317,568.4089559782707,672.9673393796918
826,C1_04250C_A,9,C1,881368,881877,509,2.0139024132070342,2.3843581888215164
828,C1_04260W_A,1008,C1,882165,882575,410,280.02085066367465,331.5304673861879
830,C1_04270C_A,22,C1,882919,884154,1235,2.0289410007280586,2.402163112768632
832,C1_04280C_A,112,C1,884550,885734,1184,10.774075522907905,12.755958298455052
834,C1_04290C_A,24494,C1,886010,889117,3107,897.9086502137965,1063.0782449590554
836,C1_04300C_A,3660,C1,890373,892310,1937,215.2113440979701,254.79930271801507
838,C1_04310C_A,200,C1,892910,893674,764,29.8160653962298,35.30070733304689
840,C1_04320W_A,843,C1,895092,895877,785,122.31271688262801,144.81204560040456
842,C1_04330W_A,19826,C1,897942,899552,1610,1402.5647539903048,1660.5654447792872
844,C1_04340C_A,1181,C1,899992,900945,953,141.14668809009342,167.11051109806337
846,C1_04350C_A,395,C1,901560,903929,2369,18.990908010287527,22.48427070275832
848,C1_04360C_A,3990,C1,905274,905525,251,1810.559783092651,2143.610840752327
850,C1_04370C_A,1094,C1,905958,906560,602,206.98292786723593,245.0572757498166
852,C1_04380W_A,906,C1,907132,908076,944,109.31251806262675,129.42047036344135
854,C1_04390C_A,1174,C1,908570,910795,2225,60.096859398275896,71.15162973589605
856,C1_04400C_A,7052,C1,911109,914328,3219,249.51980488521033,295.41877806471274
858,C1_04410C_A,476,C1,914539,915072,533,101.71697566842883,120.42773387959818
860,C1_04420C_A,1062,C1,915265,916104,839,144.17044903699752,170.69049050893676
862,C1_04430C_A,280,C1,916437,917263,826,38.60927790291452,45.71142441092851
864,C1_04440W_A,1,C1,916801,917169,368,0.3095037223195593,0.3664366902506498
866,C1_04450C_A,1277,C1,917491,918323,832,174.8160351586111,206.97330825676607
868,C1_04460C_A,1979,C1,918745,919554,809,278.619153103968,329.87092865540325
870,C1_04470C_A,6537,C1,920167,920688,521,1429.0731410201327,1691.9500288944475
872,C1_04480C_A,6419,C1,921715,925908,4193,174.3637531203159,206.43782929085685
874,C1_04490W_A,4185,C1,926875,927996,1121,425.21007374657177,503.42713463088376
876,C1_04500W_A,38268,C1,929091,930743,1652,2638.392583551309,3123.722838138236
878,C1_04510W_A,420,C1,931183,932622,1439,33.24315171765886,39.35820350600447
880,C1_04520C_A,1052,C1,932754,933831,1077,111.25351257558489,131.71850930072011
882,C1_04530C_A,619,C1,934147,935706,1559,45.222881279420825,53.54159496188327
884,C1_04540C_A,817,C1,936078,938918,2840,32.7655461752498,38.79274279718287
886,C1_04550W_A,146,C1,939165,939467,302,55.06296686352743,65.19175660194341
888,C1_04560W_A,637,C1,940013,941746,1733,41.865334432349584,49.5664299952662
890,C1_04570C_A,488,C1,941946,943343,1397,39.78662596208715,47.105344725821546
892,C1_04580C_A,1325,C1,943640,944467,827,182.48369407861807,216.0514270450022
894,C1_04590W_A,3358,C1,946251,946439,188,2034.40089273437,2408.6273476441434
896,C1_04600C_A,1306,C1,947537,948574,1037,143.44258917700944,169.82874139632042
898,C1_04610W_A,34682,C1,949329,951471,2142,1844.1590008754438,2183.390608397982
900,C1_04620W_A,1137,C1,952320,954050,1730,74.8562482532143,88.6259966404138
902,C1_04630C_A,1322,C1,954196,957687,3491,43.13157344416395,51.06559268409628
904,C1_04640W_A,1053,C1,958785,960746,1961,61.15957695753112,72.40983335996317
906,C1_04650W_A,324,C1,961930,964107,2177,16.95119330252903,20.069352067967607
908,C1_04660W_A,4321,C1,965166,970607,5441,90.45222109254848,107.09083649970323
910,C1_04670W_A,648,C1,970917,972158,1241,59.47259922579484,70.41253739236983
912,C1_04680W_A,7191,C1,973480,974406,926,884.4881061874536,1047.189002343425
914,C1_04690C_A,69,C1,974965,976872,1907,4.1210899408171215,4.879161215964604
916,C1_04700C_A,1732,C1,977199,979934,2735,72.12806015252339,85.39596046990792
918,C1_04710C_A,239,C1,980592,981179,587,46.3738865169504,54.904326713671466
920,C1_04720W_A,259,C1,982170,982391,221,133.4815329489676,158.0353566568775
922,C1_04730C_A,1248,C1,982545,983831,1286,110.53181767291612,130.86405918450578
924,C1_04740W_A,855,C1,984729,985775,1046,93.09966653023533,110.22527745742299
926,C1_04750W_A,283,C1,986263,987447,1184,27.223780115919077,32.23157320056053
928,C1_04760C_A,783,C1,987525,990488,2963,30.098427460022652,35.63500967788836
930,C1_04770C_A,6158,C1,991622,992782,1160,604.637933889772,715.8606094753177
932,C1_04780C_A,832,C1,994377,997034,2657,35.665265970987356,42.22586378403573
934,C1_04790W_A,571,C1,997297,997971,674,96.4916886699768,114.24125941986429
936,C1_04800C_A,72,C1,998118,1000229,2111,3.8847042286021054,4.59929253665619
938,C1_04810W_A,1119,C1,1001617,1003743,2126,59.948803773008464,70.97633939402427
940,C1_04820C_A,187,C1,1003914,1004285,371,57.40918640200215,67.96956139161378
942,C1_04830W_A,3180,C1,1004469,1007279,2810,128.89453238691857,152.60458092488273
944,C1_04840C_A,298,C1,1007444,1007815,371,91.48629704704086,108.31512991818668
946,C1_04850C_A,115,C1,1008208,1008380,172,76.15231121257995,90.16046936864824
948,C1_04860W_A,1751,C1,1008955,1011525,2570,77.60089281852522,91.87551642935045
950,C1_04870W_A,67,C1,1012991,1014757,1766,4.32113464185224,5.116003983476794
952,C1_04880C_A,207,C1,1015097,1015459,362,65.12915898180871,77.10961689650138
954,C1_04890W_A,2869,C1,1015786,1016976,1190,274.5979445337918,325.11002191017985
956,C1_04900W_A,2443,C1,1017681,1019972,2291,121.45407003693565,143.79545133823663
958,C1_04910C_A,575,C1,1020126,1021085,959,68.29091516456597,80.85297565905891
960,C1_04930C_A,178,C1,1021667,1022368,701,28.921158098174633,34.24118253663133
962,C1_04940C_A,35,C1,1023215,1023751,536,7.4373282527535896,8.805418974679794
964,C1_04950C_A,1980,C1,1028271,1032458,4187,53.861187540225394,63.7689109109705
966,C1_04960C_A,1042,C1,1033844,1035829,1985,59.78894677368713,70.78707682456077
968,C1_04970W_A,2038,C1,1036804,1040895,4091,56.73987770230076,67.17713387947772
970,C1_04980C_A,690,C1,1041964,1043523,1559,50.40999690274696,59.682876451856956
972,C1_04990C_A,592,C1,1044362,1045495,1133,59.5121296819505,70.45933944505346
974,C1_05000W_A,1924,C1,1048309,1050273,1964,111.57766778073434,132.1022926026212
976,C1_05010C_A,550,C1,1050452,1051426,974,64.3157632417647,76.1465976455149
978,C1_05020C_A,506,C1,1051994,1053736,1742,33.083851392468716,39.16960001044374
980,C1_05030C_A,254,C1,1054104,1054799,695,41.625801341947984,49.28283498001257
982,C1_05050C_A,1084,C1,1055313,1057673,2360,52.315571558449186,61.93898007680814
984,C1_05060W_A,574,C1,1058030,1059178,1148,56.948684906798924,67.42435100611956
986,C1_05070C_A,861,C1,1059228,1061885,2657,36.908406251226104,43.69767874766198
988,C1_05080W_A,290,C1,1064009,1065736,1727,19.12578879325036,22.643962700375994
990,C1_05090W_A,650,C1,1066117,1067232,1115,66.39756984649202,78.61135094883895
992,C1_05100W_A,238,C1,1067544,1068347,803,33.757875486471086,39.96761030997872
994,C1_05110C_A,2861,C1,1068523,1069635,1112,293.03990560854623,346.94436731746055
996,C1_05120W_A,892,C1,1070515,1071795,1280,79.372229588851,93.97268921477914
998,C1_05130W_A,8,C1,1072175,1072615,440,2.0708612693381423,2.4517945820407117
1000,C1_05140W_A,2218,C1,1082624,1083892,1268,199.230572749653,235.87888096462646
1002,C1_05150C_A,12,C1,1084950,1085183,233,5.865958960356971,6.944997528527337
1004,C1_05160C_A,12827,C1,1092614,1093810,1196,1221.539768059381,1446.2410541061797
1006,C1_05170C_A,3347,C1,1094679,1095959,1280,297.823825598525,352.6082856523159
1008,C1_05180C_A,384,C1,1097142,1097528,386,113.30722800109217,134.15000407435187
1010,C1_05190C_A,434,C1,1098256,1098588,332,148.8899352382574,176.27812250997528
1012,C1_05200C_A,1157,C1,1099257,1100150,893,147.56915663419116,174.71438771350577
1014,C1_05210C_A,709,C1,1101241,1102398,1157,69.79536317877344,82.63416571017937
1016,C1_05220C_A,69,C1,1102611,1103048,437,17.983795233725974,21.291900317721968
1018,C1_05230W_A,166,C1,1103297,1103884,587,32.20947766449275,38.13438591828228
1020,C1_05240C_A,1667,C1,1104007,1105341,1334,142.3290220984015,168.51033452354017
1022,C1_05250W_A,1,C1,1104248,1104862,614,0.1855006023022766,0.21962329317954254
1024,C1_05260C_A,743,C1,1105631,1107547,1916,44.167925768007926,52.29258120829524
1026,C1_05270C_A,740,C1,1108146,1108865,719,117.22399674834827,138.78725937281914
1028,C1_05280W_A,469,C1,1109135,1110883,1748,30.559420161657542,36.18080162685363
1030,C1_05290W_A,3630,C1,1111172,1113130,1958,211.15804516004096,250.00040260696017
1032,C1_05300C_A,1816,C1,1113320,1115428,2108,98.12031479197992,116.16947004469937
1034,C1_05310W_A,2,C1,1116052,1116144,92,2.4760297785564744,2.9314935220051983
1036,C1_05320C_A,464,C1,1116245,1117987,1742,30.33776096068278,35.918368389023506
1038,C1_05330C_A,744,C1,1118242,1119618,1376,61.58404298060813,72.9123795763851
1040,C1_05340C_A,3838,C1,1119919,1122246,2327,187.85479387390998,222.4105364516432
1042,C1_05350W_A,568,C1,1123169,1123828,659,98.16950842810863,116.22771281176301
1044,C1_05360C_A,739,C1,1123871,1125682,1811,46.477170785338934,55.02661004254263
1046,C1_05370C_A,492,C1,1125926,1128109,2183,25.669952335451278,30.391920013752472
1048,C1_05380C_A,864,C1,1128387,1133384,4997,19.69328147267331,23.31584521484383
1050,C1_05390C_A,683,C1,1133457,1135511,2054,37.873370780276204,44.84014774798408
1052,C1_05400C_A,193,C1,1135748,1136341,593,37.06946437440874,43.88836338678271
1054,C1_05410C_A,834,C1,1136528,1137082,554,171.4628274811202,203.0032806465838
1056,C1_05420W_A,247,C1,1137313,1137870,557,50.507451245886294,59.798257445283774
1058,C1_05430W_A,548,C1,1138277,1140532,2255,27.67882867310493,32.77032758434902
1060,C1_05440C_A,1835,C1,1141075,1142832,1757,118.95371292427548,140.83515548802436
1062,C1_05450W_A,1,C1,1142087,1142581,494,0.2305614773554612,0.27297308099643547
1064,C1_05460W_A,2709,C1,1143981,1148279,4298,71.78873309098104,84.99421446048297
1066,C1_05470W_A,636,C1,1149114,1150163,1049,69.05503069728144,81.75764964707729
1068,C1_05480C_A,161,C1,1150297,1151418,1121,16.35814142728747,19.367208763577608
1070,C1_05490C_A,903,C1,1151708,1152454,746,137.86772780385905,163.22838862875594
1072,C1_05500W_A,787,C1,1152769,1155042,2273,39.43564894117972,46.689805756107425
1074,C1_05510C_A,206,C1,1155542,1155790,248,94.6082991193595,112.011421832747
1076,C1_05520W_A,254,C1,1158880,1160955,2075,13.942135871158483,16.506780872823487
1078,C1_05530C_A,522,C1,1161281,1162890,1609,36.95116658961968,43.748304816897964
1080,C1_05540C_A,1890,C1,1163603,1164622,1019,211.2522364550539,250.1119203171069
1082,C1_05550C_A,1,C1,1166517,1166614,97,1.1741996887999777,1.390192804249888
1084,C1_05560W_A,1835,C1,1166877,1167580,703,297.2996779629474,351.9877214686469
1086,C1_05570W_A,1,C1,1167998,1168103,105,1.0847368553675985,1.2842733524975154
1088,C1_05580W_A,1,C1,1168190,1168292,102,1.116640880525469,1.3220460981592073
1090,C1_05590W_A,1,C1,1168844,1168916,72,1.5819079140777477,1.8728986390588769
1092,C1_05600W_A,584,C1,1169206,1173921,4715,14.107330640751035,16.702363091229618
1094,C1_05610W_A,252,C1,1174224,1175690,1466,19.578538330850378,23.179995161721866
1096,C1_05620C_A,117,C1,1175776,1177029,1253,10.635269168548243,12.591618623648825
1098,C1_05630C_A,3171,C1,1177543,1180872,3329,108.49160699276622,128.44855334358977
1100,C1_05640C_A,370,C1,1181156,1182355,1199,35.147645397023524,41.61302730986528
1102,C1_05650W_A,195,C1,1182507,1183265,758,29.300774556268575,34.6906291456288
1104,C1_05660C_A,1869,C1,1183318,1187598,4280,49.73695892093794,58.886033659082926
1106,C1_05670W_A,1549,C1,1188181,1189434,1253,140.80369181266008,166.70442092335065
1108,C1_05680C_A,464,C1,1189532,1189963,431,122.61805010094989,145.1735446257052
1110,C1_05690C_A,205,C1,1190242,1190988,746,31.298875082825145,37.0562787030952
1112,C1_05700W_A,2438,C1,1191581,1192072,491,565.5433556121212,669.574614064845
1114,C1_05710C_A,373,C1,1192511,1194184,1673,25.393735170634788,30.06489291725355
1116,C1_05720W_A,4513,C1,1195171,1196708,1537,334.4299479302323,395.948075589613
1118,C1_05730W_A,1,C1,1195918,1195999,81,1.4061403680691091,1.6647987902745571
1120,C1_05740C_A,102,C1,1196996,1198138,1142,10.17296998335112,12.044279864490708
1122,C1_05750C_A,856,C1,1198353,1203407,5054,19.290888120387763,22.839431919761907
1124,C1_05760C_A,5,C1,1204128,1204523,395,1.4417388583999726,1.7069455950916343
1126,C1_05770C_A,2122,C1,1206048,1207700,1652,146.3015851964011,173.2136474999827
1128,C1_05780W_A,837,C1,1208498,1210402,1904,50.06937948213309,59.27960272281731
1130,C1_05790W_A,158,C1,1210686,1210895,209,86.10423172511224,101.94303788485063
1132,C1_05800C_A,101,C1,1211015,1211707,692,16.62374906238928,19.681674715659177
1134,C1_05810W_A,293,C1,1211852,1212328,476,70.10909528442053,83.00560859156735
1136,C1_05820C_A,215,C1,1212362,1213378,1016,24.102297745987734,28.53589658723564
1138,C1_05830W_A,7,C1,1213935,1214855,920,0.8666104224947663,1.0260227327018194
1140,C1_05840W_A,312,C1,1215414,1216451,1037,34.26806112038817,40.57164419268911
1142,C1_05850W_A,573,C1,1216759,1217970,1211,53.8919842305463,63.80537262841702
1144,C1_05860W_A,193,C1,1218269,1219270,1001,21.9602321418825,25.99979968867348
1146,C1_05870W_A,102,C1,1219787,1220767,980,11.854624205088754,14.03527306657999
1148,C1_05880W_A,251,C1,1221543,1222529,986,28.994158035713042,34.327610755651136
1150,C1_05890W_A,34,C1,1223689,1224744,1055,3.6706261361728214,4.345834946366001
1152,C1_05900W_A,974,C1,1226686,1229604,2918,38.017833515573784,45.011184290582904
1154,C1_05910W_A,4290,C1,1231376,1232920,1544,316.4635469561753,374.67676919203745
1156,C1_05920W_A,164,C1,1236305,1238380,2075,9.00200898767713,10.657921508437214
1158,C1_05930C_A,604,C1,1238529,1241924,3395,20.263331772433897,23.99075582191235
1160,C1_05940W_A,1147,C1,1244647,1247667,3020,43.258371912647924,51.215715631800755
1162,C1_05950C_A,490,C1,1248213,1249460,1247,44.75518140229586,52.98786205773631
1164,C1_05960W_A,2064,C1,1251550,1252941,1391,169.00371768171527,200.0918195206769
1166,C1_05970W_A,26,C1,1254843,1256615,1772,1.6711803697254763,1.9785926931818378
1168,C1_05980W_A,576,C1,1257107,1259197,2090,31.38989713523079,37.16404419093289
1170,C1_05990C_A,448,C1,1259288,1260358,1070,47.68787072569331,56.46001729110573
1172,C1_06000W_A,1020,C1,1261683,1263329,1646,70.58038712628785,83.56359419956493
1174,C1_06010W_A,1561,C1,1263838,1264770,932,190.76587368994228,225.8571071256494
1176,C1_06020W_A,1041,C1,1265500,1267533,2033,58.32127987012069,69.04943374064975
1178,C1_06030C_A,119,C1,1267647,1268351,704,19.252538363378044,22.794027754909738
1180,C1_06040W_A,324,C1,1268617,1271166,2549,14.477343201100705,17.140439172995478
1182,C1_06050C_A,943,C1,1271299,1271640,341,314.9713188686885,372.91004691361144
1184,C1_06060C_A,831,C1,1272151,1272585,434,218.08459519608252,258.20108611099243
1186,C1_06070W_A,520,C1,1272827,1273369,542,109.27422934145919,129.37513846192684
1188,C1_06080C_A,806,C1,1273457,1274497,1040,88.27046160553833,104.50774405948532
1190,C1_06090C_A,644,C1,1274861,1277509,2648,27.700115619319114,32.79553024768958
1192,C1_06100C_A,4835,C1,1278575,1280680,2105,261.61224847921403,309.7356172110101
1194,C1_06110C_A,1131,C1,1281140,1282936,1796,71.72490270555633,84.91864252552475
1196,C1_06120C_A,89,C1,1283082,1283711,629,16.11584405947569,19.08034098424369
1198,C1_06130C_A,8246,C1,1284280,1285402,1122,837.0746091648199,991.0538295837109
1200,C1_06140C_A,28,C1,1286026,1286367,341,9.352276700236773,11.072620693087083
1202,C1_06150W_A,9,C1,1288905,1289630,725,1.4138983838929386,1.6739838870484856
1204,C1_06160W_A,34,C1,1289661,1291016,1355,2.857941382776625,3.383657467465779
1206,C1_06180W_A,42,C1,1292811,1293806,995,4.807728173036291,5.692106014586978
1208,C1_06190C_A,1,C1,1293014,1293619,605,0.1882601153943766,0.22289041654915556
1210,C1_06200W_A,802,C1,1294855,1296609,1754,52.07850090678761,61.65830046397706
1212,C1_06210W_A,310,C1,1297212,1298261,1049,33.65889861031013,39.85042671477037
1214,C1_06220C_A,45,C1,1298404,1299762,1358,3.7742132854285004,4.468476870803212
1216,C1_06230C_A,9299,C1,1300699,1302570,1871,566.0778417405913,670.2074184990977
1218,C1_06250W_A,78,C1,1306250,1308475,2225,3.9928066721171382,4.727280340204337
1220,C1_06260W_A,8,C1,1309503,1310432,929,0.9808169628727478,1.1612374769622313
1222,C1_06270W_A,180,C1,1310816,1313557,2741,7.4795791924289,8.85544194170122
1224,C1_06280C_A,47,C1,1314438,1316969,2531,2.1150440068111807,2.5041046995556053
1226,C1_06290C_A,3,C1,1324455,1324766,311,1.0986884547935485,1.3007913377386409
1228,C1_06300W_A,3,C1,1334325,1334415,90,3.796578993786595,4.494956733741304
1230,C1_06310W_A,1,C1,1334422,1334490,68,1.6749613207882035,1.9830691472388104
1232,C1_06320W_A,280,C1,1337607,1340003,2396,13.310210161856174,15.758612922966172
1234,C1_06330W_A,12,C1,1340304,1340657,353,3.871865262785196,4.584091853107279
1236,C1_06340W_A,166,C1,1344841,1348191,3350,5.643869668375297,6.6820550847855795
1238,C1_06350W_A,1166,C1,1350783,1353404,2621,50.669337353168665,59.989922375532544
1240,C1_06360W_A,371,C1,1353982,1355679,1697,24.900367826072365,29.480771035085866
1242,C1_06370C_A,118,C1,1356733,1357260,527,25.5026368842591,30.19382701602318
1244,C1_06380C_A,102,C1,1359377,1359700,323,35.96759046745195,42.583800635443936
1246,C1_06390W_A,204,C1,1359948,1360724,776,29.942092064399432,35.44991650837214
1248,C1_06400C_A,829,C1,1361000,1363132,2132,44.28748572958378,52.43413413140067
1250,C1_06410W_A,302,C1,1364407,1366992,2585,13.30638517744934,15.754084335665848
1252,C1_06420C_A,640,C1,1367104,1369278,2174,33.53004447134435,39.697869957604894
1254,C1_06430C_A,61,C1,1370780,1372147,1367,5.082472244791125,6.017389043706355
1256,C1_06440C_A,500,C1,1372798,1375413,2615,21.777699773154463,25.78369063331532
1258,C1_06450C_A,2317,C1,1375843,1376671,828,318.72005538418625,377.34836058255803
1260,C1_06460C_A,1570,C1,1377036,1377428,392,456.17058828405254,540.0828116306516
1262,C1_06470W_A,1225,C1,1377812,1378198,386,361.46186015973404,427.9524869559402
1264,C1_06480C_A,1437,C1,1378615,1379223,608,269.1949349048357,318.7131328809007
1266,C1_06490C_A,4,C1,1380091,1380163,72,6.327631656310991,7.4915945562355075
1268,C1_06500W_A,256,C1,1380391,1381107,716,40.7230819445266,48.21406105465533
1270,C1_06510C_A,452,C1,1381134,1382531,1397,36.85154699767088,43.63036027883471
1272,C1_06520C_A,1138,C1,1382826,1389647,6821,19.0023760222657,22.49784824658087
1274,C1_06530C_A,1609,C1,1390212,1394330,4118,44.50239631619207,52.68857735252374
1276,C1_06540C_A,571,C1,1395028,1396152,1124,57.8606745227441,68.504100399456
1278,C1_06550W_A,4484,C1,1398176,1404556,6380,80.04949941131234,94.77454229198749
1280,C1_06560W_A,336,C1,1404816,1406129,1313,29.146623196777515,34.50812176398503
1282,C1_06570W_A,1044,C1,1407257,1408294,1037,114.66620451822193,135.758963260152
1284,C1_06580W_A,4431,C1,1408972,1409409,437,1154.8724156614464,1367.3102943163192
1286,C1_06590C_A,1083,C1,1409768,1410970,1202,102.62134068895712,121.49845613914722
1288,C1_06600W_A,2871,C1,1411658,1412701,1043,313.51807165372907,371.18947600876174
1290,C1_06610C_A,190,C1,1413016,1415442,2426,8.920239185731075,10.561110215303147
1292,C1_06620C_A,23,C1,1417195,1417896,701,3.7370035744832384,4.4244224625984305
1294,C1_06630W_A,290,C1,1418523,1421138,2615,12.63106586842959,14.954540567322884
1296,C1_06640C_A,467,C1,1421365,1421508,143,371.95854337727405,440.3800268511585
1298,C1_06650W_A,300,C1,1421838,1422404,566,60.369630643249735,71.47457703828928
1300,C1_06660W_A,2581,C1,1422905,1424605,1700,172.92300675817413,204.73205876093482
1302,C1_06670W_A,1114,C1,1425323,1427644,2321,54.66681170717277,64.72272901406048
1304,C1_06680W_A,675,C1,1427895,1430957,3062,25.10800934819678,29.726608052991967
1306,C1_06690W_A,206,C1,1431951,1432876,925,25.365252088217467,30.031170394077037
1308,C1_06700W_A,475,C1,1433430,1435013,1583,34.1764059769166,40.463129157178514
1310,C1_06710W_A,329,C1,1435371,1436402,1031,36.345523441972546,43.0312540853799
1312,C1_06720C_A,341,C1,1436436,1437638,1202,32.31198261766794,38.255746577515424
1314,C1_06730W_A,664,C1,1440080,1440790,710,106.5181036003225,126.11202554384052
1316,C1_06740C_A,333,C1,1441424,1442053,629,60.29860754837533,71.39048930059718
1318,C1_06750W_A,186,C1,1442282,1442668,386,54.88318856302901,64.97890822351418
1320,C1_06760C_A,561,C1,1442821,1444427,1606,39.78606753762664,47.10468357961778
1322,C1_06770W_A,859,C1,1444436,1445959,1523,64.24021055146457,76.05714709685711
1324,C1_06780W_A,2056,C1,1447122,1449623,2501,93.63174423700808,110.85523044268838
1326,C1_06790C_A,539,C1,1449873,1450304,431,142.43777802674995,168.63909601994638
1328,C1_06800W_A,746,C1,1450584,1451759,1175,72.3127130901651,85.6145801711748
1330,C1_06810W_A,23022,C1,1453350,1454807,1457,1799.6878845906997,2130.7390650142547
1332,C1_06820W_A,1167,C1,1455538,1456530,992,133.99015178676277,158.6375355325434
1334,C1_06830W_A,23,C1,1456981,1457044,63,41.58157945575794,49.23047851240476
1336,C1_06840C_A,323,C1,1457212,1457505,293,125.55921655219147,148.65573634796326
1338,C1_06850W_A,1914,C1,1459268,1461322,2054,106.13416057605953,125.65745650020725
1340,C1_06860W_A,232,C1,1462710,1464203,1493,17.69872056045191,20.954386381004337
1342,C1_06870C_A,29,C1,1464434,1464637,203,16.271052830513977,19.264100287462732
1344,C1_06880C_A,31,C1,1465177,1468227,3050,1.1576453981054207,1.3705933647145616
1346,C1_06890C_A,2112,C1,1468465,1469275,810,296.97684573619586,351.6055045059864
1348,C1_06900C_A,2088,C1,1469637,1470274,637,373.340201210035,442.0158395628811
1350,C1_06910C_A,1063,C1,1470485,1473181,2696,44.908347222497966,53.16920261090882
1352,C1_06920C_A,535,C1,1473495,1474850,1355,44.97054822898513,53.24284544394682
1354,C1_06930W_A,3923,C1,1475649,1479446,3797,117.6769506923214,139.32353384093076
1356,C1_06940C_A,1320,C1,1479745,1482981,3236,46.45999015882236,55.006269053200135
1358,C1_06950C_A,1,C1,1483972,1484082,110,1.0354306346690711,1.2258972910203558
1360,C1_06960W_A,1216,C1,1484762,1485664,902,153.5467867997062,181.79159827814053
1362,C1_06970C_A,1060,C1,1485816,1487471,1655,72.94937281112611,86.36835295043714
1364,C1_06980C_A,1496,C1,1487707,1489140,1433,118.90472103359552,140.7771515773271
1366,C1_06990C_A,3,C1,1489602,1489717,115,2.97123573426777,3.517792226406238
1368,C1_07000W_A,546,C1,1490452,1492731,2279,27.287390925065566,32.30688516835566
1370,C1_07010W_A,186,C1,1493064,1494020,956,22.159948520218826,26.236253738782924
1372,C1_07020C_A,827,C1,1494130,1497066,2936,32.08212698768576,37.98360918396518
1374,C1_07030C_A,632,C1,1497905,1498981,1076,66.8988268793623,79.20481382131517
1376,C1_07040C_A,15,C1,1502167,1503120,953,1.7927183076641842,2.122487439856859
1378,C1_07050C_A,424,C1,1504795,1506954,2159,22.367987402021992,26.48256121037026
1380,C1_07060C_A,152,C1,1507743,1508261,518,33.42162203024493,39.5695032931667
1382,C1_07070C_A,665,C1,1509898,1511547,1649,45.93192900305796,54.381071460363266
1384,C1_07080W_A,547,C1,1513268,1513834,566,110.0739598728587,130.32197879981413
1386,C1_07090C_A,1571,C1,1514079,1516313,2234,80.0952408134119,94.82869778926931
1388,C1_07100C_A,229,C1,1516783,1517724,941,27.717850889812865,32.816527907335555
1390,C1_07110W_A,1764,C1,1518188,1521970,3782,53.12399797757446,62.89611590417499
1392,C1_07120W_A,1672,C1,1526934,1528757,1823,104.4631938169696,123.67911671117048
1394,C1_07130C_A,634,C1,1528942,1530747,1805,40.00605676555182,47.365139654160444
1396,C1_07140C_A,1488,C1,1531432,1534566,3134,54.0776280416827,64.02516547358385
1398,C1_07150W_A,56,C1,1534761,1535003,242,26.356416155212727,31.20465831688178
1400,C1_07160C_A,523,C1,1535148,1535354,206,289.16662336170714,342.3585978271896
1402,C1_07170C_A,805,C1,1536685,1538385,1700,53.93375452938016,63.85482654108969
1404,C1_07180W_A,1043,C1,1540676,1541422,746,159.2425693238372,188.5351155479429
1406,C1_07190W_A,1471,C1,1542214,1544679,2465,67.96877525184682,80.47157836105629
1408,C1_07200W_A,168,C1,1545381,1546280,899,21.284491800538866,25.19975743943957
1410,C1_07210C_A,1009,C1,1546391,1548133,1742,65.97155346838129,78.10696919078603
1412,C1_07220W_A,4435,C1,1549757,1551385,1628,310.27938275387373,367.3550328158971
1414,C1_07230W_A,1157,C1,1551710,1552636,926,142.31021260727073,168.48806504121023
1416,C1_07240W_A,867,C1,1553508,1554062,554,178.2473278490782,211.03578455706014
1418,C1_07250C_A,498,C1,1554222,1555904,1682,33.72228904112469,39.92547776581158
1420,C1_07260C_A,477,C1,1556089,1557885,1796,30.25002527900121,35.814493797237226
1422,C1_07270W_A,789,C1,1558121,1560640,2519,35.67488081894748,42.23724727576684
1424,C1_07280C_A,126,C1,1560696,1560905,209,68.66539998331736,81.29634666766569
1426,C1_07290W_A,51,C1,1560957,1561400,443,13.112338285538351,15.524342669580577
1428,C1_07310C_A,1,C1,1569972,1570092,120,0.9491447484466486,1.123739183435326
1430,C1_07320W_A,2,C1,1570830,1570893,63,3.6157895178919945,4.280911174991718
1432,C1_07330W_A,694,C1,1578886,1580409,1523,51.90070561433809,61.44779986637817
1434,C1_07340W_A,1996,C1,1581153,1584276,3123,72.7951169221714,86.18572181121655
1436,C1_07350C_A,119,C1,1584338,1584853,515,26.318033024889598,31.15921463972127
1438,C1_07360W_A,687,C1,1585929,1589840,3911,20.007029675771342,23.687307154796283
1440,C1_07370C_A,177,C1,1590522,1592492,1970,10.23341850609483,12.115847845769707
1442,C1_07380C_A,1916,C1,1595184,1598036,2852,76.51730735022913,90.59260626067677
1444,C1_07390W_A,1892,C1,1600375,1602015,1640,131.3986729800775,155.56935622387587
1446,C1_07400C_A,424,C1,1602167,1603606,1439,33.55975316258894,39.73304353939498
1448,C1_07410C_A,1727,C1,1604432,1604926,494,398.1796713928815,471.424510880844
1450,C1_07420C_A,559,C1,1605356,1606747,1391,45.77184020546456,54.19153445351665
1452,C1_07430W_A,53,C1,1609045,1610016,971,6.216849227724701,7.360433786455895
1454,C1_07440W_A,1055,C1,1611003,1614224,3221,37.30572032081519,44.16807842996345
1456,C1_07450W_A,13,C1,1615492,1615589,97,15.264595954399711,18.072506455248543
1458,C1_07460C_A,324,C1,1615681,1616832,1151,32.061466394097046,37.95914809032622
1460,C1_07470C_A,118,C1,1617098,1619065,1967,6.832684106763877,8.089551010393603
1462,C1_07480C_A,29,C1,1619304,1621175,1871,1.7653787945453434,2.0901188446579018
1464,C1_07490C_A,147,C1,1621424,1623418,1994,8.396646621162931,9.941203207522141
1466,C1_07500C_A,778,C1,1623838,1624812,974,90.97757054925987,107.71282357856472
1468,C1_07510W_A,167,C1,1625174,1626007,833,22.83416657727592,27.034493680725006
1470,C1_07520C_A,1200,C1,1626202,1629063,2861,47.772402578230476,56.56009871187939
1472,C1_07530W_A,4,C1,1630610,1630705,95,4.795678728993593,5.677840084725858
1474,C1_07540C_A,3476,C1,1631817,1634681,2864,138.2357742570063,163.66413693943548
1476,C1_07550W_A,539,C1,1635159,1636253,1094,56.11579737616932,66.4382544648966
1478,C1_07560W_A,257,C1,1636861,1637820,959,30.523069908336442,36.137764772831545
1480,C1_07570C_A,165,C1,1637846,1639054,1208,15.557173856989772,18.418903834453193
1482,C1_07580C_A,40,C1,1639501,1640733,1232,3.69796655238954,4.378204610786984
1484,C1_07590C_A,726,C1,1641986,1645111,3125,26.46063695509505,31.328050451483392
1486,C1_07600W_A,1627,C1,1645623,1646147,524,353.64698604336576,418.70007285097915
1488,C1_07610C_A,62,C1,1646303,1647247,944,7.480547593689689,8.8565884796174
1490,C1_07620C_A,11,C1,1647560,1648828,1268,0.9880686655753755,1.1698231247118536
1492,C1_07630W_A,810,C1,1649647,1650174,527,175.0604735275413,207.26271087270152
1494,C1_07640C_A,1089,C1,1651145,1653661,2516,49.29818590103659,58.366548684947695
1496,C1_07650W_A,72,C1,1658863,1659375,512,16.016817630037195,18.963098720471127
1498,C1_07660W_A,107,C1,1660186,1662414,2228,5.469936521568657,6.476127071503405
1500,C1_07670W_A,57,C1,1666415,1667008,593,10.947976525084446,12.961848254127537
1502,C1_07680W_A,533,C1,1668121,1669215,1094,55.491131728197125,65.6986820589794
1504,C1_07690C_A,587,C1,1669743,1672880,3137,21.31264140279947,25.233085139045066
1506,C1_07700C_A,1192,C1,1674155,1675270,1115,121.76292808772075,144.16112358617852
1508,C1_07710C_A,1710,C1,1677049,1678674,1625,119.85507838846296,141.90232642518703
1510,C1_07770W_A,52,C1,1691292,1692819,1527,3.878626869880215,4.592097252545145
1512,C1_07780W_A,864,C1,1696626,1699202,2576,38.20160229772846,45.228757196651635
1514,C1_07790C_A,174,C1,1699242,1700171,929,21.332768942482264,25.256915123928533
1516,C1_07800W_A,220,C1,1700387,1702474,2087,12.006430933872318,14.215004524529279
1518,C1_07810C_A,176,C1,1702555,1704825,2270,8.83080928951243,10.455229759539245
1520,C1_07820W_A,249,C1,1705110,1706270,1160,24.4486595548154,28.9459713802134
1522,C1_07830C_A,167,C1,1706353,1707135,782,24.323351354054783,28.797612833815773
1524,C1_07840W_A,908,C1,1707470,1708372,902,114.65500198530692,135.74570003005888
1526,C1_07850C_A,119,C1,1708433,1709872,1439,9.41889298667001,11.151490993367931
1528,C1_07860W_A,68,C1,1710121,1711374,1253,6.1811820808656455,7.318205695795897
1530,C1_07870C_A,5810,C1,1711666,1713528,1862,355.3940486664895,420.7685062787912
1532,C1_07880C_A,1312,C1,1714644,1716962,2318,64.46650094712699,76.32506343401971
1534,C1_07890C_A,1941,C1,1718492,1720900,2408,91.80846960473148,108.69656586617779
1536,C1_07900W_A,1722,C1,1722824,1723399,575,341.09786229394,403.8425475914361
1538,C1_07910C_A,874,C1,1723764,1724978,1214,81.9986006730515,97.08217920815238
1540,C1_07920W_A,325,C1,1725659,1725850,191,193.80442507549373,229.45459766480477
1542,C1_07930C_A,121,C1,1726172,1727575,1403,9.822937810010933,11.629859546315705
1544,C1_07940W_A,8,C1,1729104,1729195,91,10.012955588008602,11.854830946130912
1546,C1_07950C_A,232,C1,1729610,1730410,800,33.030237245943376,39.10612358354935
1548,C1_07960W_A,247,C1,1730691,1731389,698,40.30465665323591,47.71866675791269
1550,C1_07970C_A,1873,C1,1731592,1735263,3671,58.11216934373979,68.80185749630179
1552,C1_07980C_A,1955,C1,1737039,1737770,731,304.6092448503198,360.64187747459295
1554,C1_07990C_A,4105,C1,1741763,1743058,1295,361.0414695635669,427.45476583802434
1556,C1_08000W_A,266,C1,1747219,1749510,2291,13.224225390841127,15.656811320495681
1558,C1_08010W_A,1036,C1,1750206,1750925,719,164.11359544768757,194.30216312194676
1560,C1_08020W_A,618,C1,1751228,1753102,1874,37.56060541344902,44.46984943626669
1562,C1_08030W_A,1795,C1,1753563,1753943,380,538.0152074089688,636.9826845051822
1564,C1_08040W_A,165,C1,1754691,1754915,224,83.8976161573377,99.33051710722972
1566,C1_08050W_A,1650,C1,1755407,1755907,500,375.8613203848729,445.0007166403891
1568,C1_08060W_A,1278,C1,1756486,1756893,407,357.6433381370468,423.4315507902742
1570,C1_08070W_A,10488,C1,1757979,1762451,4472,267.11887625335737,316.25518486233534
1572,C1_08080C_A,1155,C1,1762963,1763349,386,340.806896722035,403.4980591298865
1574,C1_08090C_A,4963,C1,1763704,1766757,3053,185.15317601863285,219.21195810243788
1576,C1_08100W_A,963,C1,1767333,1768439,1106,99.17103718851241,117.4134720052317
1578,C1_08110W_A,1849,C1,1768990,1772265,3275,64.30419443827249,76.13290076965806
1580,C1_08120W_A,620,C1,1772645,1774756,2111,33.45161974629591,39.60501906565052
1582,C1_08130C_A,434,C1,1774766,1777369,2603,18.990187667730105,22.4834178537502
1584,C1_08140W_A,169,C1,1777560,1778540,980,19.641485202549017,23.254521061294298
1586,C1_08150C_A,32,C1,1778537,1779175,638,5.712720743001772,6.763571260801962
1588,C1_08160W_A,481,C1,1779285,1780343,1058,51.78131841242019,61.30645148193479
1590,C1_08170C_A,730,C1,1780648,1782873,2225,37.36857526468603,44.24249549165597
1592,C1_08180C_A,6125,C1,1785337,1789293,3956,176.34514411230705,208.7836956079284
1594,C1_08190C_A,584,C1,1790347,1793517,3170,20.982985479855248,24.84278926660809
1596,C1_08200W_A,387,C1,1794134,1795096,962,45.81942008093801,54.24786660991324
1598,C1_08210C_A,4181,C1,1795204,1800024,4820,98.7976977573968,116.97145707742153
1600,C1_08220W_A,1308,C1,1801629,1803992,2363,63.04602611772576,74.64329336944934
1602,C1_08230C_A,1488,C1,1804089,1806353,2264,74.85834199762967,88.62847552747871
1604,C1_08240C_A,136,C1,1806847,1807839,992,15.614961990573898,18.48732205006504
1606,C1_08260C_A,477,C1,1808933,1809601,668,81.33090628905116,96.29166296382944
1608,C1_08270C_A,1178,C1,1810097,1813534,3437,39.03727135304575,46.2181469218556
1610,C1_08290C_A,1136,C1,1816300,1819245,2945,43.93460513013486,52.01634142135947
1612,C1_08300W_A,1579,C1,1820165,1822153,1988,90.46476204007595,107.10568434473117
1614,C1_08310W_A,2590,C1,1823757,1825340,1583,186.35135048466103,220.63053582545754
1616,C1_08320W_A,15532,C1,1826586,1828619,2033,870.1691824617814,1030.236123784603
1618,C1_08330C_A,18595,C1,1829194,1830240,1046,2024.7816364090363,2397.2386366324918
1620,C1_08340C_A,646,C1,1831872,1832345,473,155.55539302237676,184.16968604631387
1622,C1_08350C_A,2541,C1,1832850,1833041,191,1515.2524434363986,1793.981946665443
1624,C1_08360C_A,42991,C1,1834255,1835715,1460,3353.809469627661,3970.7401015124465
1626,C1_08370W_A,7297,C1,1839237,1841123,1886,440.6729096128438,521.7343470749252
1628,C1_08380W_A,3969,C1,1842502,1843878,1376,328.5310034812281,388.9640249175705
1630,C1_08390C_A,856,C1,1844112,1845788,1676,58.17192634871107,68.87260675565435
1632,C1_08400C_A,3146,C1,1846393,1849392,2999,119.48020187848576,141.45849167405947
1634,C1_08410C_A,431,C1,1850368,1851303,935,52.502423946161144,62.16020381526744
1636,C1_08420W_A,1142,C1,1851770,1854430,2660,48.89879561170253,57.89369086390116
1638,C1_08430W_A,512,C1,1854820,1855782,962,60.61897437064666,71.7697873495493
1640,C1_08440C_A,94,C1,1855865,1856236,371,28.858093699402147,34.166517490971636
1642,C1_08450C_A,1067,C1,1856784,1857359,575,211.3539018975807,250.23228703836372
1644,C1_08460C_A,8846,C1,1858136,1860274,2138,471.2516994252042,557.9380813845966
1646,C1_08470W_A,542,C1,1861221,1861655,434,142.2404940990093,168.40552186781935
1648,C1_08480C_A,445,C1,1861721,1862316,595,85.18374717151434,100.85323091671665
1650,C1_08490W_A,1168,C1,1862511,1863896,1385,96.0520779366659,113.72078263559227
1652,C1_08500C_A,31853,C1,1864127,1865449,1322,2744.306294003428,3249.119292886424
1654,C1_08510W_A,280,C1,1866411,1867046,635,50.22246228001164,59.46084498177473
1656,C1_08520C_A,353,C1,1867125,1867568,443,90.75794930970663,107.45280318356751
1658,C1_08530W_A,285,C1,1867837,1868310,473,68.62737927457798,81.25133207925614
1660,C1_08540C_A,3450,C1,1868417,1870555,2138,183.79135914729306,217.5996360814897
1662,C1_08550C_A,1280,C1,1871363,1872100,737,197.81361378752405,234.20127350836646
1664,C1_08560W_A,1686,C1,1872858,1874522,1664,115.40322446257571,136.6315574474971
1666,C1_08570C_A,167,C1,1874780,1875544,764,24.896414605851884,29.47609062309415
1668,C1_08580C_A,723,C1,1877922,1879172,1250,65.87823870018498,77.99648924387911
1670,C1_08590C_A,12791,C1,1880547,1882037,1490,977.7592330776712,1157.617280160101
1672,C1_08600C_A,1888,C1,1882757,1884955,2198,97.83359154143437,115.83000427620904
1674,C1_08610C_A,10112,C1,1885503,1886144,641,1796.7709883854934,2127.2856080308297
1676,C1_08620W_A,430,C1,1886878,1887366,488,100.3603873357522,118.82160218291563
1678,C1_08630W_A,647,C1,1887736,1889073,1337,55.11712660388766,65.2558789842324
1680,C1_08640W_A,863,C1,1889477,1890301,824,119.28814338487248,141.23110417058538
1682,C1_08650C_A,735,C1,1890487,1891423,936,89.43863975747267,105.89080766986726
1684,C1_08660C_A,326,C1,1891687,1892457,770,48.221483843159604,57.09178812466228
1686,C1_08670W_A,1012,C1,1892915,1895104,2189,52.65607046658795,62.342113493095475
1688,C1_08680C_A,693,C1,1895260,1895835,575,137.27109092317096,162.5220008599682
1690,C1_08690W_A,557,C1,1896172,1896639,467,135.8476123900942,160.8366745627777
1692,C1_08700W_A,2694,C1,1897121,1901266,4145,74.02642081491739,87.64352309311754
1694,C1_08710W_A,313,C1,1901480,1902264,784,45.47178157098995,53.836280267641385
1696,C1_08730W_A,994,C1,1902971,1904146,1175,96.35232816571595,114.07626365971548
1698,C1_08740C_A,5279,C1,1904314,1907100,2786,215.81630123689268,255.5155412500396
1700,C1_08750W_A,296,C1,1907474,1908382,908,37.129539058177265,43.95948876169909
1702,C1_08760W_A,246,C1,1908828,1909877,1049,26.709964703665463,31.623241844624236
1704,C1_08770W_A,435,C1,1910142,1911194,1052,47.0963458829991,55.75968191570724
1706,C1_08780W_A,1919,C1,1912020,1913675,1655,132.06589285335,156.35931067159328
1708,C1_08790W_A,5053,C1,1914832,1916589,1757,327.5602786955663,387.814736065933
1710,C1_08800W_A,481,C1,1916963,1918639,1676,32.68772964220798,38.70061197367961
1712,C1_08810C_A,1375,C1,1918866,1920872,2006,78.07023105368744,92.43118906621575
1714,C1_08820C_A,147,C1,1921091,1921723,632,26.491951523099498,31.365125309808782
1716,C1_08830C_A,46,C1,1921987,1922570,583,8.98675645184477,10.63986328055403
1718,C1_08840W_A,98,C1,1922753,1923817,1064,10.490547219673486,12.420275185337815
1720,C1_08850C_A,389,C1,1923990,1926056,2066,21.44534213818468,25.390196071036307
1722,C1_08860C_A,462,C1,1926303,1928510,2207,23.842584890748622,28.228409755167412
1724,C1_08870C_A,510,C1,1928994,1930622,1628,35.68037997846124,42.24375800137712
1726,C1_08880W_A,778,C1,1931304,1932899,1595,55.556209225692236,65.77573051129909
1728,C1_08890C_A,53,C1,1932950,1933345,395,15.28243189903971,18.093623307971324
1730,C1_08900W_A,79,C1,1933791,1935467,1676,5.368670772836652,6.356233567402679
1732,C1_08910C_A,126,C1,1936147,1938249,2102,6.827339960282268,8.08322381234164
1734,C1_08920W_A,461,C1,1938480,1939367,887,59.19581452544375,70.08483836261807
1736,C1_08930C_A,496,C1,1939545,1939769,224,252.20131887296665,298.5935544556723
1738,C1_08940C_A,2378,C1,1940406,1942679,2273,119.15879692773237,141.077964533702
1740,C1_08950W_A,3157,C1,1948142,1951585,3443,104.43624644250025,123.64721238821924
1742,C1_08960W_A,41,C1,1952350,1952526,176,26.53291001339495,31.413618082396614
1744,C1_08970W_A,75,C1,1952884,1952999,115,74.28089335669424,87.94480566015595
1746,C1_08980C_A,2730,C1,1953260,1954783,1523,204.1627180506383,241.71829054065188
1748,C1_08990C_A,1632,C1,1956445,1959255,2810,66.14964680989027,78.31782266333605
1750,C1_09000W_A,395,C1,1960295,1961950,1655,27.18396439659888,32.1844334107761
1752,C1_09010W_A,705,C1,1962465,1964288,1823,44.04698064650932,52.14938832618134
1754,C1_09020W_A,1369,C1,1964983,1965726,743,209.85935299436804,248.4628170319722
1756,C1_09030C_A,3321,C1,1966282,1966779,497,761.0727669033369,901.0715078121652
1758,C1_09040C_A,292,C1,1967483,1968947,1464,22.717234962821426,26.896052587140588
1760,C1_09050W_A,550,C1,1969726,1971693,1967,31.847256429831628,37.70553437047866
1762,C1_09060C_A,513,C1,1972141,1972821,680,85.92551575643485,101.73144725335098
1764,C1_09070W_A,1048,C1,1973678,1977250,3572,33.41669752649791,39.563672930802525
1766,C1_09080C_A,806,C1,1978117,1978776,659,139.3039151286189,164.9287614899313
1768,C1_09090C_A,1242,C1,1980940,1984239,3299,42.879822160802824,50.76753194883328
1770,C1_09100W_A,351,C1,1985645,1986385,740,54.02429297915249,63.96201946796747
1772,C1_09110W_A,266,C1,1986752,1988347,1595,18.994796470480892,22.488874442166527
1774,C1_09120W_A,1216,C1,1991466,1993010,1544,89.70155550086463,106.2020865588619
1776,C1_09130W_A,4158,C1,1996613,1998733,2120,223.38927532308483,264.48155800325014
1778,C1_09140C_A,583,C1,1999453,2000619,1166,56.94868490679892,67.42435100611956
1780,C1_09150W_A,3367,C1,2004765,2005862,1097,349.58290260928345,413.88840444412864
1782,C1_09160W_A,379,C1,2007208,2008347,1139,37.89912481067039,44.870639212149804
1784,C1_09170W_A,1389,C1,2010260,2012542,2282,69.32666374718991,82.07924938431208
1786,C1_09180W_A,381,C1,2014803,2017433,2630,16.499961178319687,19.535116147020194
1788,C1_09190C_A,2965,C1,2017549,2019336,1787,188.97912786643403,223.74169080374313
1790,C1_09200W_A,538,C1,2020180,2022249,2069,29.616619120210554,35.06457307036474
1792,C1_09210C_A,3193,C1,2022447,2024309,1862,195.313803337711,231.2416248792049
1794,C1_09220W_A,1604,C1,2025818,2027191,1373,133.0600008601682,157.53628406965151
1796,C1_09230C_A,439,C1,2027229,2028242,1013,49.359274776080404,58.43887481083216
1798,C1_09240C_A,96,C1,2028519,2029943,1424,7.678474369456035,9.090923731162189
1800,C1_09250W_A,550,C1,2030997,2034590,3593,17.43488822640657,20.642022295221683
1802,C1_09260C_A,483,C1,2034691,2035818,1127,48.813158491541934,57.79230086238819
1804,C1_09270W_A,157,C1,2036746,2038410,1664,10.7463263586147,12.723104697068234
1806,C1_09280W_A,373,C1,2038862,2041054,2192,19.381258640726276,22.946426026717695
1808,C1_09290C_A,2465,C1,2041212,2043785,2573,109.1166018618417,129.188515530575
1810,C1_09300C_A,87,C1,2044586,2045479,893,11.096384293150068,13.137555515190149
1812,C1_09310C_A,930,C1,2045895,2048825,2930,36.15172488964027,42.80180644074485
1814,C1_09320C_A,1036,C1,2050005,2051678,1673,70.53058883854594,83.5046355556962
1816,C1_09330W_A,69,C1,2054912,2055511,599,13.120064302401088,15.533489881209515
1818,C1_09340C_A,2204,C1,2055982,2059482,3500,71.72280087690561,84.91615406713571
1820,C1_09350W_A,504,C1,2060785,2061315,530,108.3099516717987,128.2334826682425
1822,C1_09360C_A,1753,C1,2061654,2064530,2876,69.42353591211301,82.19394110829457
1824,C1_09370W_A,1033,C1,2065803,2067635,1832,64.22269815362804,76.03641330711955
1826,C1_09380W_A,716,C1,2067844,2070201,2357,34.5992858661587,40.9637974716857
1828,C1_09390W_A,159,C1,2070405,2071802,1397,12.963265426171837,15.347847974191854
1830,C1_09400C_A,1980,C1,2072063,2073337,1274,177.0147505737235,209.57647565481432
1832,C1_09410W_A,3,C1,2074852,2075229,377,0.906345117880089,1.0730665942618498
1834,C1_09420W_A,19,C1,2075333,2076733,1400,1.545750018898828,1.8300895273089595
1836,C1_09430W_A,377,C1,2077583,2080183,2600,16.515118622971688,19.553061791774674
1838,C1_09440W_A,460,C1,2080806,2081780,974,53.791365620385015,63.68624530352155
1840,C1_09450C_A,1112,C1,2082040,2086968,4928,25.700867539107307,30.42852204496954
1842,C1_09460W_A,423,C1,2087338,2088633,1295,37.20354241787791,44.04710498160398
1844,C1_09470C_A,565,C1,2088739,2089725,986,65.26573422381621,77.27131504758125
1846,C1_09480W_A,112,C1,2089906,2090313,407,31.342765157550268,37.10824232277833
1848,C1_09490C_A,2370,C1,2090366,2091958,1592,169.55827038833348,200.74838176445147
1850,C1_09500W_A,6,C1,2092602,2092937,335,2.0399528921838423,2.415200633055029
1852,C1_09510W_A,550,C1,2093170,2094570,1400,44.74539528391344,52.97627579052251
1854,C1_09520C_A,384,C1,2094630,2095979,1349,32.42148999882993,38.38539775589312
1856,C1_09530W_A,294,C1,2096586,2097506,920,36.397637744780184,43.092954773476414
1858,C1_09540W_A,954,C1,2102573,2104153,1580,68.7709435456787,81.42130488587097
1860,C1_09550W_A,80,C1,2104221,2104577,356,25.594914564853447,30.30307910387396
1862,C1_09560C_A,5,C1,2105679,2105747,68,8.374806603941018,9.915345736194054
1864,C1_09570W_A,746,C1,2106955,2108577,1622,52.38436367505795,62.02042644952551
1866,C1_09580C_A,49,C1,2108735,2110141,1406,3.96939624528186,4.699563583641335
1868,C1_09590C_A,3,C1,2111646,2113043,1397,0.24458991370135544,0.2895820372489029
1870,C1_09600C_A,155,C1,2114091,2115482,1391,12.69165515536137,15.026275206252382
1872,C1_09610W_A,677,C1,2117863,2118681,818,94.26469359878452,111.60461034509277
1874,C1_09620C_A,398,C1,2118745,2119209,464,97.69645083149125,115.66763663980853
1876,C1_09630W_A,7829,C1,2120305,2121618,1313,679.1336696653904,804.0597776495202
1878,C1_09640W_A,3889,C1,2122166,2123452,1286,344.43769145029705,407.7967357119735
1880,C1_09650W_A,2028,C1,2124235,2125830,1595,144.81747083509495,171.45653146132975
1882,C1_09660W_A,1445,C1,2126282,2128567,2285,72.02700191713299,85.27631265106588
1884,C1_09670C_A,162,C1,2128602,2128934,332,55.57642743916521,65.7996678493456
1886,C1_09680W_A,3297,C1,2129681,2131222,1541,243.6856770119611,288.51146692689963
1888,C1_09690W_A,54741,C1,2132251,2133906,1655,3767.284544390429,4460.273593264037
1890,C1_09700W_A,21,C1,2134158,2134862,704,3.3975067700078907,4.022475486160542
1892,C1_09710C_A,551,C1,2134881,2136464,1583,39.644630933223254,46.93722982232707
1894,C1_09720W_A,1102,C1,2136910,2138244,1334,94.08913158514603,111.39675383619753
1896,C1_09730W_A,380,C1,2138426,2139259,833,51.95798382853202,61.515614363326364
1898,C1_09740C_A,69,C1,2139280,2139498,218,36.05008494100115,42.68146990295642
1900,C1_09750W_A,473,C1,2139718,2140614,896,60.12662491275868,71.18687059351461
1902,C1_09760C_A,970,C1,2140691,2141770,1079,102.3915187388229,121.22635862082664
1904,C1_09770W_A,336,C1,2142201,2142542,341,112.22732040284129,132.871448317045
1906,C1_09780C_A,4453,C1,2142636,2144831,2195,231.0637757539641,273.5677767929389
1908,C1_09790C_A,701,C1,2145394,2146539,1145,69.73105348413283,82.55802629744946
1910,C1_09800C_A,727,C1,2146924,2147445,521,158.93164655371524,188.16699877715516
1912,C1_09810W_A,233,C1,2148118,2149359,1241,21.38443768458364,25.318088290774952
1914,C1_09820C_A,1,C1,2148315,2148767,452,0.25198533144601293,0.29833783631026356
1916,C1_09830W_A,978,C1,2149689,2153891,4202,26.50919268864795,31.38553797429078
1918,C1_09840C_A,553,C1,2153952,2154935,983,64.07451221456725,75.8609686803339
1920,C1_09850C_A,2060,C1,2155954,2157804,1850,126.82626044108733,150.15585197038519
1922,C1_09860C_A,1107,C1,2158652,2159836,1184,106.49019289159865,126.07898068205127
1924,C1_09870W_A,85,C1,2161357,2163096,1739,5.567151486001044,6.591224652697139
1926,C1_09880C_A,200,C1,2163426,2163878,452,50.397066289202584,59.66756726205271
1928,C1_09890C_A,2,C1,2164157,2164251,94,2.423348293906337,2.8691213194093432
1930,C1_09900W_A,22,C1,2166008,2167423,1415,1.7708424988686589,2.0965875931231523
1932,C1_09910C_A,579,C1,2167566,2168384,818,80.61928743529725,95.4491423778563
1934,C1_09920W_A,967,C1,2169696,2172581,2885,38.176345445320315,45.19885436597408
1936,C1_09930W_A,100,C1,2172939,2173751,812,14.026769681477566,16.60698300643339
1938,C1_09940W_A,139,C1,2173813,2174097,284,55.74554367637359,65.99989288627197
1940,C1_09950C_A,456,C1,2174079,2174675,596,87.1429540855715,103.17283241204873
1942,C1_09960W_A,475,C1,2174942,2175366,424,127.59728929589382,151.0687109806924
1944,C1_09970C_A,694,C1,2175531,2178041,2510,31.49194209188721,37.28486023764699
1946,C1_09980C_A,1329,C1,2178865,2179779,914,165.61225873333865,196.076504348212
1948,C1_09990W_A,1445,C1,2180946,2182802,1856,88.675484580091,104.98727069379608
1950,C1_10000C_A,1008,C1,2183212,2185005,1793,64.03153863474992,75.81009014408089
1952,C1_10010C_A,2230,C1,2189027,2192563,3536,71.8300720261095,85.04315766043361
1954,C1_10020W_A,995,C1,2195272,2196825,1553,72.97352412397287,86.39694687841464
1956,C1_10030W_A,989,C1,2196988,2198682,1694,66.49616218751373,78.72807927396958
1958,C1_10040W_A,6349,C1,2199783,2201525,1742,415.11733693830803,491.47784677135826
1960,C1_10050W_A,83,C1,2202127,2202978,851,11.108674141631754,13.152106071698997
1962,C1_10060C_A,2264,C1,2203460,2203972,512,503.63993214450295,596.2841042103698
1964,C1_10070C_A,1337,C1,2205458,2207278,1820,83.67076013229686,99.06193109360645
1966,C1_10080W_A,199,C1,2208542,2209030,488,46.44585367398764,54.98953217302374
1968,C1_10090C_A,1510,C1,2209373,2211919,2546,67.55107164907021,79.97703850686608
1970,C1_10100C_A,1075,C1,2212261,2212744,483,253.49828685221053,300.12909868148455
1972,C1_10110W_A,236,C1,2213970,2216138,2168,12.398422175280947,14.679102248564774
1974,C1_10120C_A,1381,C1,2216358,2217212,854,184.18298326999837,218.0632991556232
1976,C1_10130W_A,37,C1,2217638,2217738,100,42.142026831031195,49.89401974452847
1978,C1_10140C_A,3005,C1,2217841,2220072,2231,153.41174194973624,181.63171203351794
1980,C1_10150W_A,12,C1,2230403,2232760,2357,0.5798762994328274,0.6865440917042297
1982,C1_10160W_A,8459,C1,2236246,2237169,923,1043.8329916069601,1235.8452549529045
1984,C1_10170W_A,58,C1,2239042,2239758,716,9.226323253056808,10.923498207695348
1986,C1_10180C_A,2348,C1,2240080,2242266,2186,122.33807151067143,144.84206419246908
1988,C1_10190W_A,660,C1,2245299,2246132,833,90.24281401797668,106.84290915735633
1990,C1_10200C_A,295,C1,2246376,2248130,1754,19.156057066711153,22.67979879909381
1992,C1_10210C_A,946,C1,2249405,2252335,2930,36.77369004903193,43.538181605316794
1994,C1_10220C_A,2203,C1,2255500,2256717,1217,206.1757647488546,244.1016356063786
1996,C1_10230C_A,1678,C1,2259255,2263580,4325,44.18954602247796,52.318178491684904
1998,C1_10240C_A,564,C1,2263977,2264711,734,87.51786999300978,103.61671380776956
2000,C1_10250C_A,324,C1,2264987,2265808,821,44.94853571206541,53.21678374173626
2002,C1_10260C_A,390,C1,2266205,2266927,722,61.52351001011518,72.84071161325937
2004,C1_10270C_A,1216,C1,2267309,2268271,962,143.97006413028586,170.45324495517957
2006,C1_10280C_A,2799,C1,2268532,2269221,689,462.6977331034257,547.8106196404315
2008,C1_10290W_A,399,C1,2271400,2274240,2840,16.001778364656882,18.945292993973034
2010,C1_10300W_A,1450,C1,2276260,2278746,2486,66.43249647213068,78.65270229997857
2012,C1_10310W_A,311,C1,2279973,2281007,1034,34.2573327002214,40.558942288013895
2014,C1_10320W_A,246,C1,2282222,2283286,1064,26.333414449384463,31.177425465235736
2016,C1_10330C_A,275,C1,2283308,2284648,1340,23.374460222939856,27.67417392042221
2018,C1_10340W_A,327,C1,2285484,2287037,1553,23.98225365682324,28.39377048164983
2020,C1_10350C_A,4212,C1,2287135,2289441,2306,208.03804061356206,246.30647566155733
2022,C1_10360C_A,2294,C1,2292855,2294669,1814,144.03559335854106,170.5308282337798
2024,C1_10370W_A,7,C1,2295437,2295772,335,2.379945040881149,2.817734071897534
2026,C1_10380C_A,1460,C1,2296797,2298995,2198,75.65521379793122,89.57193127291589
2028,C1_10390C_A,2510,C1,2299892,2300570,678,421.6554546196616,499.21864609250764
2030,C1_10400C_A,116,C1,2301144,2301896,752,17.569275130820944,20.801129565717734
2032,C1_10410W_A,154,C1,2304069,2305031,962,18.23305088492107,21.58700635123163
2034,C1_10420C_A,830,C1,2305152,2307086,1934,48.8804637772938,57.87198690287408
2036,C1_10430W_A,44,C1,2308995,2310503,1508,3.3232654322269926,3.9345775122934494
2038,C1_10440W_A,941,C1,2311138,2313651,2513,42.649194188060314,50.49448014067529
2040,C1_10450W_A,2310,C1,2315103,2316224,1121,234.70376830455933,277.87734312959174
2042,C1_10460W_A,875,C1,2316584,2317816,1232,80.8930183335212,95.77322586096528
2044,C1_10470W_A,1042,C1,2318202,2319212,1010,117.50599935224649,139.12113613539915
2046,C1_10480W_A,976,C1,2319689,2321215,1526,72.84654845220938,86.24661413102581
2048,C1_10490W_A,1688,C1,2321499,2323370,1871,102.75722086870826,121.65933137181166
2050,C1_10500W_A,231,C1,2323932,2324456,524,50.210481730803636,59.44666061989931
2052,C1_10510W_A,179,C1,2325501,2326049,548,37.20370291356572,44.04729500034818
2054,C1_10520W_A,367,C1,2327281,2329134,1853,22.558194668964063,26.707756955473158
2056,C1_10530W_A,528,C1,2330114,2330713,599,100.39701379228659,118.86496604751628
2058,C1_10540C_A,322,C1,2330849,2332411,1562,23.479483405876124,27.798516035813698
2060,C1_10550C_A,757,C1,2332801,2335641,2840,30.359263714399145,35.943826557487675
2062,C1_10560C_A,174,C1,2337547,2339439,1892,10.474705257698744,12.40151910683383
2064,C1_10570C_A,32,C1,2340437,2342245,1808,2.0158826515681034,2.3867026904821085
2066,C1_10580C_A,214,C1,2344169,2344501,332,73.41577451840342,86.92054888740715
2068,C1_10590W_A,3,C1,2346741,2346828,87,3.9274955108137193,4.64995524180135
2070,C1_10600C_A,9,C1,2348535,2348957,422,2.4290908254084846,2.8759201850951466
2072,C1_10610W_A,449,C1,2349806,2351599,1793,28.521984967264604,33.76858182013127
2074,C1_10620W_A,2742,C1,2352465,2353904,1439,217.03029049957283,256.9528428892006
2076,C1_10630C_A,160,C1,2354068,2356800,2732,6.670416972977911,7.8974349641135655
2078,C1_10640C_A,575,C1,2357212,2359116,1904,34.396527123329186,40.72374141651129
2080,C1_10650W_A,189,C1,2360939,2362294,1355,15.886791804258298,18.809154745618592
2082,C1_10660W_A,2208,C1,2362524,2363240,716,351.236581771542,415.8462765964022
2084,C1_10670C_A,1739,C1,2364210,2369207,4997,39.63728759372556,46.92853568126553
2086,C1_10680C_A,4453,C1,2369620,2373397,3777,134.2824961027141,158.9836563570296
2088,C1_10690W_A,243,C1,2373907,2374881,974,28.41587357772513,33.642951323382036
2090,C1_10700C_A,743,C1,2374926,2375831,905,93.50911134972729,110.7100393315952
2092,C1_10710C_A,658,C1,2376074,2377636,1562,47.97981391635556,56.8056632036193
2094,C1_10720C_A,886,C1,2378686,2380479,1793,56.28168971268694,66.63466256711872
2096,C1_10730W_A,1100,C1,2381413,2383287,1874,66.85544652879275,79.15345368914782
2098,C1_10740C_A,18060,C1,2383419,2384576,1157,1777.8621424663588,2104.8984946767832
2100,C1_10750C_A,277,C1,2386240,2386703,463,68.14162297703369,80.67622129025969
2102,C1_10760W_A,596,C1,2386721,2388169,1448,46.880409122171486,55.50402375641887
2104,C1_10770W_A,399,C1,2388397,2389050,653,69.59425812500083,82.396067538872
2106,C1_10780C_A,1750,C1,2389133,2389591,458,435.19737374191317,515.2515906581189
2108,C1_10790W_A,13205,C1,2390629,2393109,2480,606.4575678986128,718.0149637385555
2110,C1_10800C_A,173,C1,2393472,2395103,1631,12.081082144544713,14.303387767086061
2112,C1_10810W_A,23,C1,2396156,2396764,608,4.308617608080181,5.101184451120888
2114,C1_10820C_A,530,C1,2396747,2398237,1490,40.51382953101131,47.966316823145455
2116,C1_10830W_A,196,C1,2398464,2399432,968,23.061864135811135,27.304076027271556
2118,C1_10840C_A,2005,C1,2399586,2401076,1490,153.26458152769374,181.457481566805
2120,C1_10850W_A,53,C1,2403460,2404254,794,7.602721158842173,9.001235776635609
2122,C1_10860C_A,513,C1,2404309,2405646,1337,43.70183299504539,51.74075103386586
2124,C1_10870W_A,3107,C1,2406453,2407245,792,446.8170808217784,529.0087337778118
2126,C1_10880W_A,655,C1,2407718,2409013,1295,57.60832218371165,68.20532804480048
2128,C1_10890C_A,795,C1,2409010,2409846,836,108.31149402130417,128.23530873173456
2130,C1_10900C_A,1,C1,2410214,2410321,107,1.0644614001270825,1.2602682431050385
2132,C1_10910C_A,512,C1,2410846,2412303,1457,40.0243331122595,47.38677792056722
2134,C1_10920W_A,277,C1,2412526,2414079,1553,20.315242394312044,24.05221536213151
2136,C1_10930C_A,503,C1,2414144,2415460,1316,43.533721136960274,51.54171513081784
2138,C1_10940C_A,791,C1,2415772,2416490,718,125.47746451609457,148.5589460886924
2140,C1_10950C_A,623,C1,2416729,2418210,1481,47.91226292631429,56.72568626173192
2142,C1_10960W_A,230,C1,2418401,2419166,765,34.24365366944772,40.542747010215685
2144,C1_10970W_A,816,C1,2419611,2421629,2018,46.05562624771845,54.52752271654466
2146,C1_10980W_A,10,C1,2423223,2423756,533,2.136911253538421,2.5299944092352553
2148,C1_10990C_A,817,C1,2424019,2425581,1562,59.573720318636006,70.53225963124159
2150,C1_11000C_A,318,C1,2426349,2426756,407,88.99106535804451,105.36090230931704
2152,C1_11010C_A,664,C1,2427065,2428255,1190,63.55281811447813,75.24330935808972
2154,C1_11020W_A,328,C1,2429970,2432009,2039,18.32189176010794,21.692189436005116
2156,C1_11030W_A,1541,C1,2432310,2433429,1119,156.85062277279204,185.70317229746246
2158,C1_11040W_A,1640,C1,2433984,2434175,191,977.9669449963375,1157.8632005239378
2160,C1_11050W_A,49,C1,2434511,2435489,978,5.706514438513594,6.756223311451653
2162,C1_11060C_A,6731,C1,2435729,2436897,1168,656.3725994994238,777.1118264078609
2164,C1_11070W_A,747,C1,2438057,2440174,2117,40.18957735038148,47.582418707200105
2166,C1_11080W_A,4367,C1,2441889,2442974,1085,458.4237916829325,542.7504900345145
2168,C1_11090C_A,952,C1,2443283,2444914,1631,66.480868217379,78.70997198997648
2170,C1_11100W_A,374,C1,2445467,2446003,536,79.4731647579955,94.09219132943552
2172,C1_11110C_A,154,C1,2446099,2446473,374,46.89891698206971,55.525936122686694
2174,C1_11120C_A,1471,C1,2446811,2447839,1028,162.97960213599458,192.95957262646277
2176,C1_11130W_A,98,C1,2448571,2449272,701,15.922884795624237,18.851887014549835
2178,C1_11140W_A,651,C1,2449578,2451047,1469,50.47460023733982,59.759363519378944
2180,C1_11150W_A,490,C1,2451373,2452068,695,80.30174274627761,95.07318559136282
2182,C1_11160C_A,167,C1,2452098,2452403,305,62.36347789793718,73.83519093784896
2184,C1_11170W_A,1483,C1,2452925,2454238,1313,128.64417321672934,152.30816838092204
2186,C1_11180C_A,3,C1,2454370,2454459,89,3.8392371847280176,4.545461865581094
2188,C1_11190W_A,680,C1,2454869,2455636,767,100.97811143839182,119.5529561516592
2190,C1_11200W_A,31899,C1,2456985,2464640,7655,474.6194904877802,561.9253749821575
2192,C1_11210C_A,2195,C1,2464977,2466881,1904,131.30500354036096,155.45845636389961
2194,C1_11220C_A,2224,C1,2468077,2469486,1409,179.77838925865268,212.84848351683448
2196,C1_11230W_A,201,C1,2469709,2470272,563,40.663181762936354,48.1431422814566
2198,C1_11240C_A,2840,C1,2470408,2471229,821,393.9933377230425,466.46810440287345
2200,C1_11250W_A,1097,C1,2472572,2473468,896,139.44800746151432,165.09935949489542
2202,C1_11260C_A,612,C1,2473804,2473941,137,508.79700967826193,602.3898221276667
2204,C1_11270W_A,9464,C1,2475446,2476084,638,1689.5371597427743,2000.3262003821803
2206,C1_11280W_A,771,C1,2476659,2477750,1091,80.49025859421074,95.2963787822515
2208,C1_11290W_A,201,C1,2477968,2479077,1109,20.643256386414038,24.440567271830535
2210,C1_11300C_A,441,C1,2479082,2480827,1745,28.78437827380897,34.079242170428344
2212,C1_11310C_A,1612,C1,2481346,2483355,2009,91.39002495745133,108.20114865292656
2214,C1_11320C_A,563,C1,2485116,2485428,312,205.52634360594737,243.33275395157253
2216,C1_11330C_A,1060,C1,2486989,2487297,308,391.98445455329124,464.08968874342037
2218,C1_11340W_A,100,C1,2487814,2489685,1871,6.087513084639115,7.2073063608893175
2220,C1_11350C_A,319,C1,2489747,2491225,1478,24.582720548401703,29.10469278883916
2222,C1_11360W_A,2258,C1,2491976,2492601,625,411.4884176625663,487.1813906298175
2224,C1_11370C_A,583,C1,2492859,2495039,2180,30.459709450150246,36.06274920786028
2226,C1_11380W_A,479,C1,2495591,2496394,803,67.94127041184728,80.43901402722607
2228,C1_11390W_A,4,C1,2496926,2497660,734,0.6206941134256013,0.7348703106934011
2230,C1_11400C_A,845,C1,2497783,2501832,4049,23.769641267594512,28.142048209518908
2232,C1_11410C_A,81,C1,2503463,2503804,341,27.054800454256377,32.03150986214477
2234,C1_11420W_A,540,C1,2504035,2505111,1076,57.16039005515134,67.67499915112371
2236,C1_11430W_A,279,C1,2506060,2508006,1946,16.329581797530214,19.33339561223778
2238,C1_11440C_A,315,C1,2508110,2511814,3704,9.686196406933941,11.46796466896742
2240,C1_11450C_A,4906,C1,2513459,2514616,1157,482.9563494429655,571.7957926292526
2242,C1_11470C_A,192,C1,2517426,2518211,785,27.857700642306735,32.98210291254765
2244,C1_11480W_A,5279,C1,2522233,2523870,1637,367.2964051594276,434.8602919502812
2246,C1_11490C_A,26,C1,2524641,2526899,2258,1.3114843291202587,1.5527308469079795
2248,C1_11500C_A,514,C1,2528376,2529182,806,72.63430283398176,85.99532609713512
2250,C1_11510C_A,1438,C1,2529466,2530416,950,172.40465030731968,204.1183510458946
2252,C1_11520C_A,782,C1,2531200,2531787,587,151.73380441947788,179.64511920540204
2254,C1_11530C_A,64,C1,2532303,2533463,1160,6.283992817301949,7.4399283868821575
2256,C1_11540C_A,5576,C1,2534053,2538045,3992,159.0911157516587,188.3558022094803
2258,C1_11550W_A,955,C1,2538443,2539003,560,194.2356931642606,229.96519718158638
2260,C1_11560C_A,272,C1,2539189,2540280,1091,28.396044536479025,33.6194747454895
2262,C1_11570W_A,97,C1,2540442,2541055,613,18.022911699704718,21.338212227059042
2264,C1_11580W_A,342,C1,2541281,2541658,377,103.32334343833014,122.32959174585088
2266,C1_11590W_A,2676,C1,2542175,2547307,5132,59.389976933201055,70.31471679359936
2268,C1_11600W_A,273,C1,2547617,2548264,647,48.058704728148705,56.899065918610944
2270,C1_11610C_A,847,C1,2548322,2549842,1520,63.467810679024595,75.14266487129376
2272,C1_11620W_A,132,C1,2550020,2550913,893,16.83589341029666,19.932842850633328
2274,C1_11630C_A,56,C1,2550972,2552126,1154,5.527082070677192,6.5437844997273755
2276,C1_11640C_A,316,C1,2552572,2553426,854,42.14469421674112,49.89717779375593
2278,C1_11650W_A,2109,C1,2554159,2554632,473,507.84260663187706,601.2598573864954
2280,C1_11660W_A,8037,C1,2555723,2557429,1706,536.5727791277174,635.2749226684441
2282,C1_11670W_A,5032,C1,2558239,2559036,797,719.1111228381736,851.3910521023679
2284,C1_11680C_A,215,C1,2559106,2559327,221,110.80513352906577,131.18765127887517
2286,C1_11690W_A,1314,C1,2560903,2562321,1418,105.54382505999124,124.95852922713836
2288,C1_11700C_A,2546,C1,2562559,2563638,1079,268.7513471227249,318.1879474728089
2290,C1_11710C_A,5,C1,2564631,2565422,791,0.7199580898457512,0.8523938180293243
2292,C1_11720W_A,312,C1,2568085,2568453,368,96.56516136370253,114.32824735820273
2294,C1_11730W_A,2772,C1,2568686,2572051,3365,93.82570850617927,111.08487428764542
2296,C1_11740W_A,214,C1,2572482,2573666,1184,20.586180016984745,24.37299174883376
2298,C1_11750W_A,658,C1,2574666,2576585,1919,39.05391836234882,46.23785613551503
2300,C1_11760C_A,547,C1,2576806,2577432,626,99.52374007673805,117.83105431420894
2302,C1_11770C_A,3060,C1,2578004,2580928,2924,119.19492189795123,141.12073466397118
2304,C1_11780W_A,30,C1,2583710,2583821,111,30.78307292259401,36.44559513844301
2306,C1_11790W_A,195,C1,2584053,2584727,674,32.95250313598157,39.01409034478728
2308,C1_11800C_A,69,C1,2584789,2585226,437,17.983795233725974,21.291900317721968
2310,C1_11810W_A,520,C1,2585501,2587936,2435,24.32305228052192,28.79725874594018
2312,C1_11820W_A,1,C1,2588555,2588663,108,1.0546052760518319,1.2485990927059178
2314,C1_11830W_A,1,C1,2589041,2589134,93,1.224702901221482,1.4499860431423561
2316,C1_11850W_A,4762,C1,2593187,2594629,1442,376.1298717422697,445.3186678101822
2318,C1_11860W_A,3326,C1,2595221,2598883,3662,103.44692845440372,122.47591012908445
2320,C1_11870W_A,1853,C1,2600115,2601776,1661,127.06311033389332,150.43627021594165
2322,C1_11880W_A,351,C1,2602121,2602543,422,94.73454219093091,112.16088721871073
2324,C1_11890W_A,892,C1,2603042,2604070,1028,98.82923528572887,117.00879590945262
2326,C1_11900C_A,372,C1,2604245,2605468,1223,34.644171357856415,41.01693961451591
2328,C1_11910W_A,128,C1,2605723,2606970,1247,11.69114942753851,13.841727231408667
2330,C1_11920W_A,806,C1,2607298,2608521,1223,75.06237127535556,88.87003583145113
2332,C1_11930W_A,3863,C1,2610679,2613744,3065,143.55156267208108,169.95776048067853
2334,C1_11940C_A,173,C1,2613981,2615726,1745,11.291830932809415,13.368954411528579
2336,C1_11950W_A,329,C1,2616918,2617940,1022,36.6655916523226,43.41019859298109
2338,C1_11960C_A,207,C1,2618147,2618401,254,92.82187224966438,109.89638313595866
2340,C1_11970C_A,363,C1,2619019,2620410,1391,29.72303755739469,35.190567095933
2342,C1_11980W_A,117,C1,2620858,2621370,512,26.027328648810446,30.81503542076558
2344,C1_11990W_A,84,C1,2623918,2624403,485,19.726554771839627,23.355239111398117
2346,C1_12000C_A,31,C1,2624649,2626028,1379,2.560419480943824,3.0314066442200236
2348,C1_12010C_A,133,C1,2626511,2629225,2714,5.581558653356121,6.608282007232058
2350,C1_12020W_A,3,C1,2631951,2632376,425,0.8039814339783378,0.951873190674629
2352,C1_12030W_A,2239,C1,2632863,2634254,1391,183.33300576034907,217.0569689470909
2354,C1_12040W_A,13,C1,2634434,2634865,431,3.435419507138682,4.067362241668466
2356,C1_12050W_A,4802,C1,2635306,2638164,2858,191.36989847617102,226.57224179943046
2358,C1_12060C_A,172,C1,2638267,2638986,719,27.246658703670136,32.25866028665526
2360,C1_12070C_A,302,C1,2639138,2641018,1880,18.29627961899284,21.66186596154054
2362,C1_12080W_A,838,C1,2641810,2643402,1592,59.9535150149466,70.98191726523642
2364,C1_12090C_A,37,C1,2643534,2644889,1355,3.110112681256915,3.6822154793009947
2366,C1_12100C_A,1097,C1,2645318,2647321,2003,62.37913863480621,73.85373245503061
2368,C1_12110C_A,36,C1,2647733,2648113,380,10.790277140235585,12.775140190633179
2370,C1_12120W_A,337,C1,2648544,2650742,2198,17.46288154102933,20.67516495820045
2372,C1_12130C_A,818,C1,2650824,2653223,2399,38.83620196228555,45.98009097374389
2374,C1_12140W_A,791,C1,2653555,2654043,488,184.61643344786046,218.5764821550843
2376,C1_12150C_A,245,C1,2654122,2654799,677,41.218398233872186,48.80049038847649
2378,C1_12160W_A,934,C1,2655467,2655976,509,208.99831710393002,247.44339426214407
2380,C1_12170C_A,625,C1,2656050,2657330,1280,55.61395010429582,65.84409277941363
2382,C1_12180C_A,403,C1,2657594,2658760,1166,39.36590054449393,46.607227196339934
2384,C1_12190W_A,263,C1,2659187,2661355,2168,13.81688572923258,16.358491065137862
2386,C1_12200W_A,346,C1,2661669,2664584,2915,13.51920753190561,16.00605519596389
2388,C1_12210W_A,599,C1,2664810,2666372,1562,43.67767254695589,51.71214629022486
2390,C1_12220W_A,69,C1,2666903,2668348,1445,5.4386979357358145,6.439142172210726
2392,C1_12230W_A,1939,C1,2669523,2672528,3005,73.49317805942303,87.01219074932834
2394,C1_12240C_A,396,C1,2672727,2674139,1412,31.942888417977862,37.81875778813506
2396,C1_12250C_A,2921,C1,2674414,2676231,1817,183.10083501679654,216.7820905766376
2398,C1_12260W_A,249,C1,2677427,2678068,641,44.244064092957665,52.3827251186389
2400,C1_12270W_A,224,C1,2678223,2679232,1009,25.285441861492487,29.936679138495105
2402,C1_12280C_A,98,C1,2679385,2680083,698,15.991321263227206,18.93291231690463
2404,C1_12290C_A,1843,C1,2680478,2682487,2009,104.48623821127966,123.70640010381119
2406,C1_12300W_A,5,C1,2683626,2683973,347,1.641172475700257,1.943064870493359
2408,C1_12310C_A,260,C1,2685652,2686530,878,33.72815051427727,39.932417452371496
2410,C1_12320C_A,990,C1,2687249,2687452,203,555.4600793865117,657.6365270547623
2412,C1_12330W_A,40,C1,2687808,2689043,1235,3.6889836376873792,4.3675692959429675
2414,C1_12340C_A,866,C1,2689209,2690219,1010,97.65853688967894,115.62274845801889
2416,C1_12350W_A,1269,C1,2690712,2693726,3014,47.954798372082166,56.77604606951939
2418,C1_12360C_A,1240,C1,2693848,2694471,623,226.6978147172734,268.3987006343122
2420,C1_12370W_A,205,C1,2695803,2696300,497,46.97980042613191,55.62169801309662
2422,C1_12380C_A,1002,C1,2696433,2697707,1274,89.58019195700552,106.0583982859212
2424,C1_12390C_A,2818,C1,2698188,2699014,826,388.5748040371897,460.0528356785591
2426,C1_12400C_A,470,C1,2699565,2699942,377,141.9940684678806,168.11376643435645
2428,C1_12410C_A,2079,C1,2700195,2703026,2831,83.64275232867182,99.02877127638472
2430,C1_12420C_A,19,C1,2703220,2703618,398,5.437311624267235,6.437500849830511
2432,C1_12430W_A,822,C1,2704534,2707485,2951,31.72607183557351,37.56205796477823
2434,C1_12440W_A,66,C1,2707766,2708623,857,8.77155940221407,10.385080901759371
2436,C1_12450C_A,1788,C1,2708975,2716906,7931,25.677530856980574,30.400892598396617
2438,C1_12460C_A,36,C1,2718577,2718870,293,13.994216086312361,16.56844120286897
2440,C1_12470W_A,108,C1,2719965,2720702,737,16.69052366332234,19.76073245226842
2442,C1_12480W_A,87,C1,2720860,2721362,502,19.73918560514544,23.370193376623114
2444,C1_12490W_A,1716,C1,2723178,2727197,4019,48.63097452105845,57.57660429285949
2446,C1_12500C_A,3,C1,2727470,2727566,96,3.5592928066749328,4.214021937882473
2448,C1_12510W_A,896,C1,2729345,2733526,4181,24.408525078446228,28.898454198269853
2450,C1_12520W_A,255,C1,2734096,2736375,2279,12.74411114632183,15.088380435770503
2452,C1_12530C_A,294,C1,2736499,2737875,1376,24.335629887498378,28.812149993894113
2454,C1_12540W_A,150,C1,2738222,2738758,536,31.87426394037253,37.73750989148483
2456,C1_12550C_A,346,C1,2738857,2741595,2738,14.393166528672335,17.04077826743416
2458,C1_12560C_A,6,C1,2741867,2742981,1114,0.6134508248488215,0.7262946248415034
2460,C1_12570C_A,661,C1,2743121,2744461,1340,56.18370257222998,66.51865076872392
2462,C1_12580W_A,741,C1,2744834,2746261,1427,59.14362370839243,70.02304708554252
2464,C1_12590W_A,817,C1,2746753,2747097,344,270.5062533072949,320.2656672790679
2466,C1_12600C_A,1363,C1,2747573,2749495,1922,80.77113166281679,95.62891823240474
2468,C1_12610W_A,442,C1,2749614,2750276,662,76.0462801474475,90.03493397191797
2470,C1_12620W_A,2218,C1,2752402,2756802,4400,57.4146286924,67.97600478707872
2472,C1_12630C_A,210,C1,2756957,2757631,674,35.48731106951862,42.015174217463226
2474,C1_12640W_A,96,C1,2758065,2758466,401,27.267200753380035,32.28298103036149
2476,C1_12650C_A,253,C1,2758614,2759110,496,58.09684387669406,68.78371292156551
2478,C1_12660W_A,575,C1,2759575,2761665,2090,31.335400786037685,37.099523280879176
2480,C1_12670C_A,170,C1,2761699,2764434,2735,7.0795440103516025,8.38182060039512
2482,C1_12680W_A,802,C1,2764631,2766184,1553,58.81886065067963,69.6385441170739
2484,C1_12690C_A,67,C1,2766270,2766920,650,11.740190426940085,13.899789284338496
2486,C1_12700W_A,308,C1,2767655,2769733,2078,16.881804572949058,19.987199335789054
2488,C1_12710C_A,550,C1,2770318,2771721,1403,44.64971731823151,52.86299793779866
2490,C1_12720C_A,20,C1,2772373,2772915,542,4.2028549746715065,4.975966863920263
2492,C1_12730W_A,353,C1,2774634,2775641,1007,39.92628753147968,47.27069693179783
2494,C1_12740W_A,1341,C1,2776562,2779384,2822,54.12344894402364,64.07941509511433
2496,C1_12750C_A,233,C1,2779463,2781025,1562,16.989812526612226,20.115075268150907
2498,C1_12760W_A,370,C1,2781193,2782158,965,43.67049412542094,51.70364740365645
2500,C1_12770W_A,1884,C1,2782398,2785190,2792,76.85624811204094,90.99389491083758
2502,C1_12780W_A,875,C1,2785529,2786701,1172,85.03429913557859,100.67629203132186
2504,C1_12790C_A,301,C1,2787011,2788024,1013,33.84314739772256,40.06856792268902
2506,C1_12800W_A,85,C1,2789387,2789872,485,19.96139470959962,23.63327767224809
2508,C1_12810W_A,643,C1,2790164,2791078,914,80.12692427805625,94.86620940248332
2510,C1_12820C_A,484,C1,2791182,2792130,948,58.15013395546556,68.84680566869592
2512,C1_12830C_A,1105,C1,2792654,2796280,3626,34.70948528516978,41.094267987734206
2514,C1_12840W_A,151,C1,2797709,2798062,353,48.720971223380374,57.68315581826659
2516,C1_12850W_A,4259,C1,2799737,2799970,233,2081.9266010133615,2464.8953728331608
2518,C1_12860C_A,300,C1,2800779,2802220,1441,23.712151938986363,28.073983763824938
2520,C1_12870C_A,69,C1,2802305,2802952,647,12.146705590630992,14.381082594813755
2522,C1_12880C_A,262,C1,2803586,2805145,1559,19.1411872297387,22.662193667226845
2524,C1_12890W_A,253,C1,2805473,2806783,1310,21.996972948733017,26.0432989382416
2526,C1_12900W_A,345,C1,2807779,2809950,2171,18.099766276228124,21.429204142893827
2528,C1_12910W_A,211,C1,2811809,2811973,164,146.5386892113972,173.49436661330762
2530,C1_12920C_A,273,C1,2812364,2813373,1009,30.816632268693965,36.48532770004091
2532,C1_12930C_A,94,C1,2813599,2815155,1556,6.880689436039972,8.146386882487453
2534,C1_12940C_A,12,C1,2815280,2815492,212,6.447020932845161,7.632945396919196
2536,C1_12950W_A,477,C1,2815725,2819678,3953,13.743750417679275,16.271902570158883
2538,C1_12960C_A,1772,C1,2819824,2825022,5198,38.827652810637815,45.9699692123293
2540,C1_12970C_A,1954,C1,2827148,2829403,2255,98.69421756796905,116.84894178798902
2542,C1_12980W_A,8,C1,2830700,2830795,95,9.591357457987186,11.355680169451716
2544,C1_12990W_A,33,C1,2830952,2831055,103,36.491390328628434,43.20395307188244
2546,C1_13000W_A,35,C1,2831214,2831305,91,43.80668069753763,51.864885389322744
2548,C1_13010W_A,552,C1,2831895,2835419,3524,17.840904692708857,21.122725173313277
2550,C1_13020C_A,313,C1,2835573,2836151,578,61.677987459612666,73.0236050689115
2552,C1_13030C_A,1782,C1,2836350,2838695,2345,86.55228699694301,102.47351257390623
2554,C1_13040C_A,14,C1,2839166,2839269,103,15.481195896993883,18.328949788071338
2556,C1_13050W_A,1905,C1,2839748,2840497,749,289.6855667488703,342.97300044501407
2558,C1_13060C_A,1942,C1,2840957,2843242,2285,96.80030292254136,114.60664302309338
2560,C1_13070C_A,472,C1,2843540,2844841,1301,41.32172063952205,48.922818869928406
2562,C1_13080W_A,162,C1,2848507,2849721,1214,15.198825296377965,17.99463733606486
2564,C1_13090W_A,6,C1,2853410,2853805,395,1.7300866300799673,2.048334714109961
2566,C1_13100W_A,176,C1,2854902,2855117,215,93.23691668461962,110.3877746704841
2568,C1_13110C_A,4253,C1,2856152,2859793,3641,133.04188789267553,157.51483923593875
2570,C1_13120C_A,796,C1,2861151,2866055,4904,18.48741973320226,21.888166150436856
2572,C1_13130C_A,561,C1,2866542,2868221,1679,38.056238514251575,45.056653858764825
2574,C1_13140C_A,5463,C1,2868818,2869627,809,769.1240189019592,910.6037813261587
2576,C1_13150W_A,19,C1,2871131,2871499,368,5.880570724071629,6.962297114762346
2578,C1_13160W_A,3463,C1,2874071,2875447,1376,286.64723231430906,339.37576676481393
2580,C1_13170C_A,514,C1,2875520,2879164,3644,16.065655346923517,19.020920097225822
2582,C1_13180W_A,42,C1,2879441,2880202,761,6.286057203904218,7.442372515787178
2584,C1_13190W_A,2088,C1,2880525,2881034,509,467.225359864032,553.171099806592
2586,C1_13200C_A,190,C1,2881257,2882471,1214,17.825782755011193,21.10482156698965
2588,C1_13210C_A,27,C1,2882858,2883161,303,10.149270577449311,12.016220971387645
2590,C1_13220C_A,4433,C1,2883615,2886056,2441,206.84434263977028,244.89319787802376
2592,C1_13240W_A,860,C1,2887954,2889222,1268,77.24900476316573,91.45889884110855
2594,C1_13250W_A,3074,C1,2891491,2892429,938,373.26280896268634,441.92421107209276
2596,C1_13260W_A,994,C1,2893242,2893804,562,201.44837294433495,238.50464377253684
2598,C1_13270W_A,1346,C1,2894167,2895063,896,171.10028992087354,202.5740545853503
2600,C1_13280C_A,1311,C1,2895365,2895955,590,253.0838166536047,299.6383870136364
2602,C1_13290W_A,73,C1,2896606,2898192,1586,5.242438837574175,6.206781366263213
2604,C1_13300C_A,4699,C1,2898258,2901239,2981,179.5383229634674,212.56425721419376
2606,C1_13310W_A,314,C1,2902523,2904391,1868,19.145489358388502,22.667287169080883
2608,C1_13320C_A,1021,C1,2904794,2906515,1721,67.57072317239013,80.0003049125486
2610,C1_13330C_A,1784,C1,2907207,2908241,1034,196.5115161967684,232.65965608301218
2612,C1_13350W_A,8489,C1,2911530,2913284,1754,551.2398930146135,652.6400406966351
2614,C1_13360C_A,191,C1,2913583,2914710,1127,19.302926028746395,22.85368419195889
2616,C1_13370W_A,223,C1,2914941,2916115,1174,21.634679274644224,25.614361625834178
2618,C1_13380W_A,254,C1,2916409,2917254,845,34.236605837460175,40.53440273503993
2620,C1_13390W_A,180,C1,2917513,2919603,2090,9.809342854759624,11.613763809666526
2622,C1_13400C_A,849,C1,2919985,2922180,2195,44.05415351787907,52.15788064163599
2624,C1_13410W_A,406,C1,2925344,2925812,468,98.80840201777933,116.98413037813907
2626,C1_13420C_A,1574,C1,2925999,2930585,4586,39.091683403097036,46.28256802600618
2628,C1_13430C_A,1697,C1,2931984,2933711,1727,111.918839938434,132.50622311220022
2630,C1_13440C_A,2,C1,2935419,2937365,1946,0.11705793403247465,0.1385906495500916
2632,C1_13450W_A,316,C1,2944587,2947346,2759,13.045150004022078,15.444795156168018
2634,C1_13460W_A,28,C1,2951046,2951402,356,8.958220097698707,10.606077686355887
2636,C1_13470W_A,1039,C1,2952022,2954022,2000,59.16968361816408,70.05390069535822
2638,C1_13480W_A,27194,C1,2955558,2957528,1970,1572.2462308177562,1861.4596967110815
2640,C1_13490C_A,271,C1,2957814,2959928,2114,14.600845420759233,17.286659529478147
2642,C1_13500C_A,26,C1,2960256,2960366,110,26.921196501395855,31.873329566529247
2644,C1_13510C_A,514,C1,2960894,2962522,1628,35.96022609593937,42.57508159354478
2646,C1_13520C_A,285,C1,2963189,2964004,815,39.82914159125814,47.155681071764604
2648,C1_13540W_A,359,C1,2966485,2968239,1754,23.311947413387472,27.600161928388736
2650,C1_13550C_A,585,C1,2968355,2969704,1349,49.39211367009246,58.477754393743425
2652,C1_13560W_A,285,C1,2969916,2971433,1517,21.39798971448608,25.33413320599087
2654,C1_13570W_A,914,C1,2976150,2978966,2816,36.968109378419186,43.76836421846113
2656,C1_13580W_A,2443,C1,2981409,2983799,2390,116.4231273868701,137.83907071794988
2658,C1_13590W_A,41,C1,2984915,2986141,1226,3.8089658746798625,4.509622171698045
2660,C1_13600W_A,28,C1,2986247,2987143,896,3.5592928066749328,4.214021937882473
2662,C1_13610C_A,1036,C1,2987589,2989826,2237,52.74817842060231,62.45116463329447
2664,C1_13620W_A,2122,C1,2993143,2996184,3041,79.4772176075155,94.09698969745855
2666,C1_13630W_A,3690,C1,2997002,2998684,1682,249.86997301556246,295.83335934908587
2668,C1_13640W_A,1038,C1,2999684,3001459,1775,66.60589851634623,78.85800151476295
2670,C1_13650C_A,862,C1,3001541,3002887,1346,72.94170340217039,86.35927275969549
2672,C1_13660W_A,509,C1,3003281,3005827,2546,22.770526800911746,26.959147417215124
2674,C1_13670W_A,2371,C1,3006268,3008214,1946,138.77218079549874,164.29921504163357
2676,C1_13680C_A,1877,C1,3008286,3008819,533,401.0982422891616,474.8799506134575
2678,C1_13690C_A,1702,C1,3009398,3009805,407,476.29809194777283,563.9127538693637
2680,C1_13700W_A,18421,C1,3011259,3013047,1788,1173.4359336332693,1389.2885569169223
2682,C1_13710C_A,36,C1,3013321,3013620,299,13.713395696620475,16.235964121874943
2684,C1_13720W_A,758,C1,3013880,3015796,1916,45.05960663815614,53.348286077910885
2686,C1_13730C_A,316,C1,3015898,3016878,980,36.72609067458869,43.48182636313017
2688,C1_13740W_A,808,C1,3017711,3019987,2276,40.43456713944949,47.87247417657698
2690,C1_13750C_A,120,C1,3020078,3020674,596,22.93235633830829,27.15074537159177
2692,C1_13760W_A,759,C1,3020866,3022500,1634,52.90581621084502,62.637799771903
2694,C1_13770C_A,180,C1,3022624,3023331,707,28.997915935569466,34.33205991825041
2696,C1_13780W_A,2720,C1,3025935,3030620,4685,66.12611438484228,78.2899614670844
2698,C1_13790C_A,166,C1,3030836,3031201,365,51.79989969604724,61.32845077816902
2700,C1_13800C_A,215,C1,3031379,3033394,2015,12.152821096736247,14.388323043489534
2702,C1_13810W_A,3330,C1,3035056,3037140,2084,181.99531740848408,215.47321386792527
2704,C1_13820C_A,441,C1,3037435,3038457,1022,49.147495193538795,58.188138539527834
2706,C1_13830C_A,2212,C1,3038900,3040153,1253,201.0702171011001,238.05692645736067
2708,C1_13840W_A,1123,C1,3041388,3043343,1955,65.42544567809226,77.46040529910205
2710,C1_13850C_A,143,C1,3043435,3044964,1529,10.652271996955195,12.611749109058334
2712,C1_13860C_A,13932,C1,3045790,3047977,2187,725.5684299236603,859.0361757816715
2714,C1_13870W_A,326,C1,3051419,3053002,1583,23.455807049420656,27.770484432084622
2716,C1_13880C_A,10567,C1,3053314,3056847,3533,340.66048876883343,403.3247195480699
2718,C1_13890C_A,5,C1,3060917,3060989,72,7.909539570388739,9.364493195294383
2720,C1_13900C_A,1404,C1,3061337,3063046,1709,93.57045477957365,110.78266683743928
2722,C1_13910C_A,731,C1,3063729,3065366,1637,50.86070698456935,60.21649430112816
2724,C1_13920W_A,1010,C1,3065854,3066933,1079,106.61384940846509,126.22538371859268
2726,C1_13930W_A,1622,C1,3067395,3069419,2024,91.27546138224096,108.06551119755525
2728,C1_13940W_A,4507,C1,3074020,3075138,1118,459.15513931116766,543.6163684876223
2730,C1_13950C_A,83,C1,3075627,3076121,494,19.136602620503282,22.656765722704144
2732,C1_13960W_A,1097,C1,3076534,3078465,1931,64.70503090912317,76.60747079618143
2734,C1_13970C_A,609,C1,3078503,3080161,1658,41.83564428014541,49.53127836275852
2736,C1_13980C_A,319,C1,3080843,3082867,2024,17.951215894534446,21.253328034537688
2738,C1_13990W_A,137,C1,3083624,3084232,608,25.664374448129777,30.385316078415723
2740,C1_14000C_A,1191,C1,3084235,3086670,2435,55.7091447425031,65.95679839695146
2742,C1_14010W_A,13,C1,3087546,3088738,1192,1.242169301658366,1.4706653742945544
2744,C1_14020W_A,128,C1,3089131,3089538,407,35.820303037200304,42.40941979746095
2746,C1_14030W_A,1178,C1,3089848,3090855,1007,133.23843261213332,157.74753820299668
2748,C1_14040W_A,569,C1,3091015,3093318,2303,28.140513861891954,33.31693940293707
2750,C1_14050C_A,876,C1,3093320,3096691,3371,29.59777394147485,35.04226133572277
2752,C1_14060W_A,5271,C1,3097094,3098602,1508,398.11209302882907,471.34450152951746
2754,C1_14080W_A,1643,C1,3099207,3104663,5456,34.29863977341298,40.60784776504928
2756,C1_14090W_A,1033,C1,3104890,3105271,381,308.8083543765002,365.6134099176982
2758,C1_14100W_A,709,C1,3105687,3106352,665,121.43343638773064,143.77102214537976
2760,C1_14110C_A,6069,C1,3106574,3107665,1091,633.5867437201881,750.1345302587343
2762,C1_14120C_A,113,C1,3108041,3108856,815,15.79190526249884,18.696813898629472
2764,C1_14130W_A,3391,C1,3113601,3114746,1145,337.3152672820177,399.3641471820986
2766,C1_14140C_A,20550,C1,3115346,3118555,3209,729.3832812930619,863.5527660802474
2768,C1_14150C_A,494,C1,3119756,3120121,365,154.1515087340201,182.50755833985238
2770,C1_14160W_A,429,C1,3120934,3122688,1754,27.857452480064694,32.98180910105506
2772,C1_14170W_A,2050,C1,3123050,3124726,1676,139.31360866221695,164.94023814146195
2774,C1_14180W_A,408,C1,3125262,3126833,1571,29.579966189654943,35.02117786186732
2776,C1_14190C_A,356,C1,3126893,3127267,374,108.415678218291,128.35865753036666
2778,C1_14200W_A,530,C1,3127604,3128596,992,60.85242540444239,72.04618151863582
2780,C1_14210C_A,3758,C1,3128660,3131260,2600,164.6255060613464,194.90823929307484
2782,C1_14220C_A,311,C1,3132914,3134062,1148,30.8554721359137,36.53131213049335
2784,C1_14230C_A,426,C1,3135405,3138674,3269,14.842544980297546,17.57281953417371
2786,C1_14240W_A,906,C1,3139007,3140692,1685,61.24095967425498,72.50618636385082
2788,C1_14250C_A,986,C1,3140868,3143546,2678,41.93532734735156,49.64929805230312
2790,C1_14260C_A,1252,C1,3144084,3144923,839,169.96365555020796,201.22833721015897
2792,C1_14270W_A,123,C1,3145303,3146106,803,17.44629699510901,20.655529698014213
2794,C1_14280C_A,1928,C1,3146581,3147441,860,255.3420104658333,302.31197381348494
2796,C1_14290C_A,4680,C1,3147891,3150121,2230,239.03125144737123,283.0008634158202
2798,C1_14300C_A,2507,C1,3150921,3154691,3770,75.74024035084611,89.67259839381524
2800,C1_14310W_A,299,C1,3155030,3156043,1013,33.61827598644201,39.80233159097679
2802,C1_14320C_A,995,C1,3156047,3156742,695,163.0617021072372,193.0567748232776
2804,C1_14330W_A,240,C1,3157023,3158294,1271,21.506977777547977,25.463169538109668
2806,C1_14340C_A,17437,C1,3158465,3160450,1985,1000.5181045036301,1184.562628205246
2808,C1_14350W_A,990,C1,3162078,3162521,443,254.5336255428033,301.3548871153876
2810,C1_14360C_A,2030,C1,3162712,3164187,1475,156.75366828583296,185.58838310836975
2812,C1_14370W_A,17,C1,3164722,3165045,323,5.994598411241992,7.097300105907322
2814,C1_14380C_A,669,C1,3165464,3167263,1799,42.355386551026655,50.14662681833684
2816,C1_14390W_A,206,C1,3167371,3167592,221,106.16677910226768,125.69607517882923
2818,C1_14400C_A,718,C1,3167604,3169514,1910,42.815869908985995,50.691815730255335
2820,C1_14410W_A,299,C1,3169513,3169746,233,146.16014409556118,173.04618841913947
2822,C1_14420W_A,2560,C1,3169830,3170801,971,300.2855476033063,355.5228394967375
2824,C1_14430C_A,458,C1,3170798,3171577,779,66.96405054509347,79.28203532940374
2826,C1_14440C_A,5228,C1,3171639,3172988,1349,441.4050773799032,522.6011965307532
2828,C1_14450C_A,1752,C1,3173044,3174396,1352,147.59481650401142,174.74476769633355
2830,C1_14460W_A,1996,C1,3174488,3175426,938,242.3658317142231,286.94883711772843
2832,C1_14470W_A,520,C1,3175481,3176209,728,81.35526415256989,96.32050143731367
2834,C1_14480W_A,231,C1,3176297,3176611,314,83.79074021318823,99.20398141664724
2836,C1_14490C_A,379,C1,3176578,3177333,755,57.1749710719915,67.6922623346207
2838,C1_14500C_A,2141,C1,3177391,3178053,662,368.3599226146722,436.11944261058005
2840,C1_14520W_A,2610,C1,3179521,3180582,1061,280.1810887968806,331.7201811988163
2842,C1_14530W_A,1033,C1,3181102,3181422,320,367.67494692952056,435.3084661832594
2844,C1_14550C_A,320,C1,3182585,3182917,332,109.78059741069671,129.97465254191724
2846,C1_14560C_A,462,C1,3183132,3184109,977,53.85934990161946,63.766735240178576
2848,C1_14570C_A,218,C1,3184381,3185097,716,34.678249468385935,41.057286366854925
2850,C1_14580C_A,195,C1,3185175,3185702,527,42.14418807144512,49.89657854342813
2852,C1_14590C_A,309,C1,3186463,3186663,200,175.97143636200863,208.34124460890945
2854,C1_14630C_A,8,C1,3187660,3188340,680,1.3399690566305626,1.5864553177910485
2856,C2_00010W_A,53,C2,4248,4778,530,11.389736981359784,13.484870201223911
2858,C2_00030W_A,1220,C2,5665,7335,1670,83.20646177999365,98.51222542211481
2860,C2_00040C_A,4,C2,7396,7467,71,6.4167532289350895,7.5971099725205145
2862,C2_00050C_A,7,C2,7510,8043,533,1.4958378774768948,1.770996086464679
2864,C2_00060C_A,1032,C2,8144,9289,1145,102.65684336037815,121.54048949924085
2866,C2_00070C_A,1881,C2,9360,11063,1703,125.80208609476072,148.94328155315432
2868,C2_00080C_A,489,C2,11100,12443,1343,41.47119422103451,49.09978799998878
2870,C2_00090W_A,130,C2,12627,13253,626,23.652808427743963,28.003724060049656
2872,C2_00100C_A,6860,C2,13261,14415,1154,677.067553657956,801.6136012166033
2874,C2_00110W_A,410,C2,14823,15446,623,74.95653551135652,88.74473166134516
2876,C2_00120C_A,1870,C2,15457,17610,2153,98.92618743679887,117.12358233297127
2878,C2_00130W_A,45,C2,18818,19147,329,15.578667603683597,18.44435133906006
2880,C2_00140W_A,3508,C2,19683,21197,1514,263.9048700832901,312.4499647681208
2882,C2_00150W_A,924,C2,21533,22759,1226,85.84108459034618,101.63148504021936
2884,C2_00160C_A,699,C2,22785,23423,638,124.78724372994498,147.74175972814285
2886,C2_00170C_A,822,C2,23503,24807,1304,71.79726839476797,85.00431982673356
2888,C2_00180C_A,1586,C2,24905,25816,911,198.28894459315714,234.76404104435923
2890,C2_00190C_A,1445,C2,26026,27414,1388,118.57471136934358,140.3864368931452
2892,C2_00200W_A,508,C2,27574,28386,812,71.25598998190604,84.36347367268161
2894,C2_00210W_A,1402,C2,28553,28789,236,676.627595248577,801.0927128015222
2896,C2_00220C_A,1616,C2,28893,30038,1145,160.74947564958435,190.3192161150903
2898,C2_00230W_A,697,C2,30161,31549,1388,57.19486077815395,67.71581073669356
2900,C2_00240C_A,679,C2,31623,32573,950,81.40664642466626,96.38133543822143
2902,C2_00250W_A,14774,C2,33340,33609,269,6255.46372351708,7406.151388582976
2904,C2_00260C_A,1573,C2,33671,34845,1174,152.6069529103828,180.6788826790904
2906,C2_00270C_A,399,C2,34967,35674,707,64.27871365717898,76.10273281878841
2908,C2_00280C_A,196,C2,35745,36395,650,34.3444376668695,40.66207014522903
2910,C2_00290W_A,280,C2,36538,37167,629,50.70153187250778,60.028039051553186
2912,C2_00300C_A,311,C2,37264,38145,881,40.20667651762648,47.602663252901664
2914,C2_00310W_A,1,C2,37590,38036,446,0.25537526864035387,0.3023513498032267
2916,C2_00320W_A,320,C2,38515,39114,599,60.84667502562822,72.03937336213109
2918,C2_00330C_A,1362,C2,39143,41932,2789,55.621447718221674,65.85296957356388
2920,C2_00340C_A,3616,C2,42098,43573,1475,279.22229779387783,330.585021339835
2922,C2_00350W_A,671,C2,44274,47528,3254,23.486519712638028,27.806846665707575
2924,C2_00360C_A,2838,C2,47572,49671,2099,153.99749191566968,182.32521024808702
2926,C2_00370W_A,741,C2,50247,53261,3014,28.001974463130722,33.15291579000305
2928,C2_00380C_A,2061,C2,53348,55222,1874,125.26279572349262,148.30478913939425
2930,C2_00390C_A,1261,C2,55482,56696,1214,118.3069055477322,140.0693683998629
2932,C2_00400C_A,1210,C2,57065,57796,731,188.53053006081174,223.2105737822289
2934,C2_00410C_A,1139,C2,59132,62923,3791,34.22028599780742,40.51508087363238
2936,C2_00420W_A,483,C2,63244,64164,920,59.796119152138864,70.79556855642554
2938,C2_00430C_A,244,C2,64196,64981,785,35.40249456626481,41.914755784695984
2940,C2_00440W_A,114,C2,65221,66279,1058,12.272495424149483,14.530011369938808
2942,C2_00450C_A,658,C2,66331,68124,1793,41.79836549768399,49.48714217738613
2944,C2_00460W_A,71,C2,69092,70399,1307,6.187232790180144,7.32536942836188
2946,C2_00470W_A,844,C2,70659,74444,3785,25.397458420786414,30.069301056361905
2948,C2_00480C_A,341,C2,74565,74909,344,112.90407879778157,133.67269589003936
2950,C2_00490W_A,667,C2,75586,77595,2009,37.81460710088091,44.770574535671216
2952,C2_00500W_A,501,C2,78116,80620,2504,22.78857119673024,26.98051106554784
2954,C2_00510W_A,314,C2,80938,81942,1004,35.62128896560729,42.17379724287159
2956,C2_00520W_A,2135,C2,82824,84179,1355,179.46190741847337,212.47378508939522
2958,C2_00530W_A,26,C2,84514,84822,308,9.614713036212805,11.383331988046159
2960,C2_00540W_A,822,C2,84801,86633,1832,51.10460588797894,60.50525821728196
2962,C2_00550W_A,201,C2,87920,89629,1709,13.395770235537254,15.859911705359895
2964,C2_00560W_A,4,C2,89853,90329,476,0.9571207547361162,1.1331823698507488
2966,C2_00570W_A,741,C2,90640,92419,1779,47.44123160869927,56.168009101219326
2968,C2_00580C_A,865,C2,92547,94091,1544,63.80908347717755,75.54671453405882
2970,C2_00590W_A,407,C2,95115,96695,1580,29.339385768439442,34.73634286011476
2972,C2_00600C_A,1123,C2,96803,97516,713,179.39235105283362,212.3914338846347
2974,C2_00610C_A,1404,C2,97951,98402,451,354.5718563598478,419.7950723396535
2976,C2_00620C_A,321,C2,98606,99577,971,37.65299249244584,44.57923104627061
2978,C2_00630C_A,539,C2,99682,100710,1028,59.718562577363066,70.70374551030825
2980,C2_00640W_A,409,C2,101391,104714,3323,14.01866513805643,16.597387638581342
2982,C2_00650W_A,567,C2,105000,108470,3470,18.610895874440917,22.03435563139469
2984,C2_00660C_A,1053,C2,108666,109364,698,171.82511520590046,203.43221091531203
2986,C2_00670C_A,16,C2,110755,111075,320,5.694868490679892,6.742435100611956
2988,C2_00680C_A,146,C2,111314,112000,686,24.240548094439188,28.699577979281212
2990,C2_00690W_A,265,C2,115251,116162,911,33.131507135678845,39.226021990387885
2992,C2_00700W_A,2489,C2,117031,119571,2540,111.61045412049016,132.1411099639619
2994,C2_00710W_A,1074,C2,119808,121157,1349,90.67885484047746,107.35915934851359
2996,C2_00720C_A,1118,C2,121277,122833,1556,81.83628499460308,96.89000568745716
2998,C2_00730C_A,1041,C2,123700,126801,3101,38.23513768976309,45.268461397852604
3000,C2_00740C_A,4456,C2,127116,128738,1622,312.9017755175043,370.4598126797395
3002,C2_00750W_A,2247,C2,130083,130937,854,299.68078450954846,354.8068307043341
3004,C2_00760C_A,3013,C2,131108,131473,365,940.1993842421102,1113.1483264736341
3006,C2_00770W_A,692,C2,132166,132792,626,125.90571870768323,149.06597730426432
3008,C2_00780W_A,880,C2,133183,134364,1181,84.86848893815927,100.47998117762101
3010,C2_00790C_A,791,C2,134595,135632,1037,86.87832162252256,102.85952101415732
3012,C2_00800C_A,189,C2,136177,137634,1457,14.774607340267668,17.492384818334383
3014,C2_00810C_A,193,C2,137837,138739,902,24.37050152330863,28.853436239869346
3016,C2_00820W_A,341,C2,138889,140388,1499,25.90994203231278,30.676055627867605
3018,C2_00830C_A,529,C2,140471,142381,1910,31.54539718921113,37.34814835836361
3020,C2_00840W_A,581,C2,142772,144541,1769,37.40778511119296,44.28891795879646
3022,C2_00850W_A,707,C2,144760,146100,1340,60.09361228224901,71.14778531541272
3024,C2_00860C_A,103,C2,146138,147394,1256,9.34030978566925,11.05845247393362
3026,C2_00870W_A,426,C2,148523,148981,458,105.93947497946,125.42695864020494
3028,C2_00880W_A,743,C2,149617,150696,1079,78.42979218860351,92.85689119100431
3030,C2_00890W_A,151,C2,150838,151794,956,17.99006573415614,21.29932427180764
3032,C2_00900W_A,5,C2,152002,152691,689,0.826541145236559,0.9785827431947686
3034,C2_00910W_A,40,C2,152901,153590,689,6.612329161892472,7.8286619455581485
3036,C2_00920W_A,605,C2,153786,154454,668,103.15555200183637,122.13093520569561
3038,C2_00930C_A,1066,C2,154508,155250,742,163.63153129554624,193.73142364561576
3040,C2_00940W_A,2760,C2,155804,156277,473,664.6019887643341,786.855005399112
3042,C2_00950C_A,722,C2,156333,157421,1088,75.58262960056767,89.48599526915133
3044,C2_00960C_A,1428,C2,157848,158405,557,292.002592628039,345.7162414245556
3046,C2_00970C_A,1646,C2,158667,160769,2102,89.18890138590963,105.59513011995509
3048,C2_00980W_A,6,C2,161335,161679,344,1.9865820316325207,2.352012244399519
3050,C2_00990W_A,6,C2,163138,163450,312,2.190334034876882,2.5932442694661364
3052,C2_01000W_A,9280,C2,164439,166079,1640,644.4924340671878,763.0463138253532
3054,C2_01010W_A,11284,C2,167263,168915,1652,777.9769497437276,921.0852018802095
3056,C2_01020W_A,3860,C2,170189,171841,1652,266.1282369736608,315.082318261043
3058,C2_01030W_A,692,C2,172317,172958,641,122.95940703745664,145.57769390400853
3060,C2_01040W_A,126,C2,173128,173500,372,38.57814138847669,45.67456035898421
3062,C2_01050W_A,96,C2,173661,173918,257,42.54532101986535,50.371499584338345
3064,C2_01060C_A,152,C2,173925,174374,449,38.55768421306654,45.650340102138856
3066,C2_01070W_A,1107,C2,174572,175753,1181,106.76070142561626,126.39924904957553
3068,C2_01080C_A,1,C2,175896,176014,118,0.965231947572863,1.142785610273213
3070,C2_01090C_A,644,C2,176492,176908,416,176.32188980758897,208.75616369202402
3072,C2_01110C_A,3817,C2,178287,179666,1379,315.26197286330887,373.25416648347846
3074,C2_01120W_A,11997,C2,180775,182838,2063,662.3493677429633,784.188016500646
3076,C2_01130W_A,933,C2,183377,185773,2396,44.351521717899324,52.509949489740855
3078,C2_01140C_A,11,C2,185863,186258,395,3.1718254884799397,3.7552803092015954
3080,C2_01150W_A,910,C2,186639,188039,1400,74.0332903788386,87.65165630795542
3082,C2_01160W_A,522,C2,188329,189579,1250,47.56354163415846,56.31281796031106
3084,C2_01170C_A,1103,C2,189661,192597,2936,42.789100444277395,50.66012204342635
3086,C2_01180W_A,279,C2,193352,193537,185,171.76954690807457,203.36642087251195
3088,C2_01190C_A,247,C2,193702,194592,890,31.609719487594006,37.424302693284346
3090,C2_01200C_A,7361,C2,195354,198389,3035,276.24334075713136,327.05808748339115
3092,C2_01210C_A,2558,C2,201446,203062,1616,180.29051484107876,213.4548142000666
3094,C2_01220W_A,1449,C2,204898,207780,2882,57.26484693265207,67.79867078963723
3096,C2_01230W_A,108,C2,208012,208767,755,16.29260389386565,19.28961565208189
3098,C2_01240C_A,267,C2,208760,211288,2528,12.029508599774772,14.242327309045825
3100,C2_01250W_A,148,C2,211504,212085,581,29.013443601398414,34.350443886078125
3102,C2_01260W_A,276,C2,212467,214584,2117,14.849161109377896,17.58065269502976
3104,C2_01270W_A,963,C2,215536,216597,1061,103.3771603491939,122.39330823542532
3106,C2_01290C_A,2,C2,216899,217014,115,1.9808238228451798,2.3451948176041584
3108,C2_01300C_A,1836,C2,219289,221418,2129,98.22243822346906,116.29037900163036
3110,C2_01310W_A,1193,C2,223575,225620,2045,66.44477368587883,78.66723789760454
3112,C2_01320W_A,477,C2,225984,227225,1241,43.77844109676565,51.83145113605001
3114,C2_01330C_A,527,C2,227542,229101,1559,38.50154835905457,45.583878101635676
3116,C2_01340W_A,1228,C2,230474,232207,1733,80.70742650380735,95.5534945591631
3118,C2_01350C_A,1270,C2,232520,234412,1892,76.45330849010004,90.51683486022392
3120,C2_01360C_A,1534,C2,235005,236363,1358,128.6587373299404,152.32541155138057
3122,C2_01370C_A,1123,C2,237215,239071,1856,68.91527279130948,81.59218338348305
3124,C2_01380W_A,457,C2,241111,243219,2108,24.692171729039,29.234277428649563
3126,C2_01390W_A,1273,C2,243991,245559,1568,92.4689743448406,109.4785699372324
3128,C2_01400C_A,111,C2,245788,248499,2711,4.663448192294121,5.5212858441012695
3130,C2_01410C_A,708,C2,248998,250476,1478,54.55976848986959,64.59599528055838
3132,C2_01420C_A,228,C2,254547,256163,1616,16.069678414294742,19.025683204697103
3134,C2_01430W_A,462,C2,256700,257266,566,92.96923119060462,110.0708486389655
3136,C2_01440C_A,305,C2,257408,257812,404,85.98687572561224,101.8040943409231
3138,C2_01450C_A,673,C2,258044,258733,689,111.25243814884084,131.71723723401584
3140,C2_01460C_A,4,C2,259015,260121,1106,0.41192538811427787,0.4876987414547527
3142,C2_01470W_A,993,C2,260750,265747,4997,22.63359780366273,26.797030437893426
3144,C2_01480W_A,2779,C2,265919,268789,2870,110.28598979511791,130.57301146063153
3146,C2_01490C_A,456,C2,268951,270369,1418,36.62708084273668,43.36460375005715
3148,C2_01500W_A,13,C2,270227,270661,434,3.411672367688415,4.039246834467993
3150,C2_01510C_A,163,C2,270663,271475,812,22.863634580808434,27.069382300486424
3152,C2_01520W_A,327,C2,271716,272798,1082,34.42184836325924,40.75372047874509
3154,C2_01530C_A,1759,C2,272823,274967,2144,93.44471711852547,110.6337998318697
3156,C2_01540W_A,3326,C2,275532,276701,1169,324.0570162532305,383.66705123413794
3158,C2_01550W_A,3067,C2,277093,279438,2345,148.96513143637722,176.36715098999463
3160,C2_01560W_A,2604,C2,280217,282055,1838,161.36493525277953,191.04788903148565
3162,C2_01570W_A,89,C2,282280,282825,545,18.599753969560016,22.021164181815195
3164,C2_01580W_A,315,C2,283127,283840,713,50.31931485453481,59.57551351171854
3166,C2_01590W_A,3608,C2,284195,284599,404,1017.1824512065867,1204.2923684657394
3168,C2_01600C_A,2138,C2,285006,286565,1559,156.19793243198987,184.93042007836257
3170,C2_01610C_A,2958,C2,287835,288194,359,938.4635652050763,1111.0932048807892
3172,C2_01620W_A,3937,C2,289871,290344,473,948.0210252772404,1122.408752266777
3174,C2_01630W_A,358,C2,291098,292192,1094,37.271716995674616,44.12782021972724
3176,C2_01640W_A,2951,C2,292446,296219,3773,89.08325956001252,105.47005556271338
3178,C2_01650W_A,96,C2,296539,298170,1631,6.703953097550824,7.937140032602671
3180,C2_01660C_A,516,C2,298173,298751,578,101.68000488549566,120.38396235002661
3182,C2_01670C_A,2222,C2,299220,301475,2255,112.23057903583788,132.8753063730356
3184,C2_01680C_A,1213,C2,301846,304188,2342,58.99125088979257,69.84264540599746
3186,C2_01690W_A,1963,C2,305456,305986,530,421.85006970583504,499.449060471746
3188,C2_01700C_A,4692,C2,306372,308888,2516,212.40320316589867,251.47460645525672
3190,C2_01710W_A,376,C2,309725,310045,320,133.82940953097744,158.44722486438096
3192,C2_01720C_A,403,C2,310184,310579,395,116.20415198703779,137.57981496438572
3194,C2_01730W_A,136,C2,310853,311611,758,20.435411998218083,24.19449007079752
3196,C2_01740C_A,396,C2,311792,312133,341,132.26791333192006,156.59849265937444
3198,C2_01750C_A,2098,C2,314646,315143,497,480.79815265377925,569.2405972267156
3200,C2_01760C_A,157,C2,322580,323239,659,27.134881731008896,32.12632202719505
3202,C2_01770C_A,2,C2,323374,323492,118,1.930463895145726,2.285571220546426
3204,C2_01780W_A,1534,C2,327675,331904,4229,41.31439236085578,48.914142560126464
3206,C2_01800W_A,15,C2,332986,333273,287,5.952824206285601,7.047841568583926
3208,C2_01820C_A,189,C2,334153,335997,1844,11.673862741198478,13.821260672621037
3210,C2_01830W_A,111,C2,336552,338495,1943,6.506746294034668,7.7036571916410415
3212,C2_01840C_A,890,C2,338553,340511,1958,51.77153173345356,61.29486455101778
3214,C2_01850W_A,1850,C2,341194,342629,1435,146.8363304217115,173.84675869173682
3216,C2_01860C_A,135,C2,342785,343582,797,19.292528136556726,22.841373615623937
3218,C2_01870C_A,298,C2,343945,345300,1355,25.049015649042182,29.656762508964768
3220,C2_01880C_A,317,C2,345450,346557,1107,32.615597317895684,38.61521096466107
3222,C2_01890W_A,1064,C2,350675,354109,3434,35.29027416472571,41.78189252796226
3224,C2_01900C_A,474,C2,354235,355758,1523,35.448032364836095,41.96867022573956
3226,C2_01910W_A,105,C2,356072,356839,767,15.592208383869329,18.460382935182672
3228,C2_01920C_A,1701,C2,357352,359910,2558,75.73863410982405,89.67069668601201
3230,C2_01930C_A,1944,C2,360838,361875,1037,213.51638082703394,252.79255227752444
3232,C2_01940C_A,4,C2,364136,364561,425,1.0719752453044502,1.269164254232839
3234,C2_01950C_A,116,C2,365021,366994,1973,6.696449517677319,7.92825617507336
3236,C2_01960C_A,26,C2,367186,367519,333,8.892887733193826,10.52872748443909
3238,C2_01970C_A,1081,C2,369820,372591,2771,44.43271626434474,52.60607970957434
3240,C2_01980C_A,282,C2,374511,376388,1877,17.111911714136703,20.25963450583454
3242,C2_01990C_A,1786,C2,377896,385770,7874,25.83448088482166,30.586713461247026
3244,C2_02000W_A,1113,C2,386830,387852,1022,124.03891644083599,146.85577821880838
3246,C2_02010C_A,289,C2,388066,389232,1166,28.23013711503411,33.42304878347951
3248,C2_02020W_A,1400,C2,389582,391966,2384,66.88603932006585,79.189674000476
3250,C2_02030W_A,1217,C2,392597,393825,1228,112.87711650093533,133.64077389975165
3252,C2_02040W_A,1044,C2,394268,397570,3302,36.01116114033802,42.635386099569246
3254,C2_02050C_A,281,C2,398041,401169,3128,10.231828937858372,12.11396587769795
3256,C2_02060C_A,937,C2,402391,404049,1658,64.36781394170156,76.20822303104225
3258,C2_02070W_A,16,C2,405503,406978,1475,1.2354968928932646,1.4627655811497124
3260,C2_02080W_A,11,C2,407445,407548,103,12.163796776209477,14.401317690627478
3262,C2_02090W_A,627,C2,408135,409331,1196,59.710410429034994,70.69409378066382
3264,C2_02100W_A,1706,C2,410199,415271,5072,38.310116897081606,45.357232971782324
3266,C2_02110C_A,207,C2,415440,415994,554,42.557320489918325,50.38570634753339
3268,C2_02120W_A,538,C2,416496,417551,1055,58.08226062532288,68.7664470924973
3270,C2_02130C_A,38,C2,417791,418816,1025,4.22253663699192,4.9992689526488645
3272,C2_02140C_A,8,C2,418909,419430,521,1.7489039510725195,2.0706134665986813
3274,C2_02150C_A,788,C2,419670,422045,2375,37.78994838446952,44.74137986763976
3276,C2_02160W_A,149,C2,422849,423919,1070,15.860474861893533,18.77799682226507
3278,C2_02170W_A,528,C2,424993,426369,1376,43.704804695915456,51.744269376789426
3280,C2_02180W_A,477,C2,427326,429101,1775,30.607912902020377,36.23821456892285
3282,C2_02190C_A,341,C2,429572,430366,794,48.91562104085247,57.913611317598914
3284,C2_02200W_A,597,C2,433118,434554,1436,47.351483132811914,56.061751463305534
3286,C2_02210C_A,262,C2,434764,436032,1268,23.533999125522584,27.86305987950051
3288,C2_02220C_A,188,C2,437551,438750,1199,17.858803607136274,21.143916579066687
3290,C2_02230C_A,120,C2,443447,446347,2900,4.712994612976462,5.579946290161619
3292,C2_02240C_A,1201,C2,448737,450545,1808,75.65859576666539,89.57593535215662
3294,C2_02250C_A,1166,C2,451417,452715,1298,102.31458644272348,121.13527468896056
3296,C2_02260W_A,875,C2,455522,456319,797,125.04416384805285,148.0459401012663
3298,C2_02270C_A,346,C2,456427,456894,467,84.38648812741938,99.9093166942928
3300,C2_02280W_A,720,C2,457206,458084,878,93.4010321933832,110.5820790988749
3302,C2_02290C_A,103,C2,458105,459010,905,12.962905072707821,15.347421333989645
3304,C2_02300W_A,200,C2,459062,459790,728,31.290486212526876,37.0463467066591
3306,C2_02310W_A,1230,C2,460211,460957,746,187.79325049695086,222.3376722185712
3308,C2_02320C_A,1400,C2,461263,461838,575,277.31533519832516,328.32727446458216
3310,C2_02330W_A,10,C2,461588,462091,503,2.2643612288985655,2.6808887079968016
3312,C2_02340C_A,2511,C2,462350,463794,1444,198.05837645564,234.49106007806955
3314,C2_02350C_A,890,C2,464454,468125,3671,27.613363970063215,32.69282070032493
3316,C2_02360C_A,225,C2,468489,469331,842,30.435757966816524,36.034391867878625
3318,C2_02370C_A,1222,C2,469529,470626,1097,126.8756480512457,150.2143243928498
3320,C2_02380W_A,1521,C2,471161,472777,1616,107.20167047430837,126.921334010282
3322,C2_02390W_A,3696,C2,474604,475146,542,776.6875993192946,919.5586764524645
3324,C2_02400W_A,952,C2,476572,478212,1640,66.11603418447875,78.27802702173881
3326,C2_02410W_A,1843,C2,478612,479181,569,368.9153823663635,436.77707874966023
3328,C2_02420C_A,934,C2,479261,481102,1841,57.783891040684615,68.41319265585624
3330,C2_02430W_A,1036,C2,481327,484155,2828,41.72477904062495,49.40001954903809
3332,C2_02440W_A,696,C2,484479,487583,3104,25.538843231399515,30.23669349243506
3334,C2_02450C_A,1635,C2,487815,491342,3527,52.799035907352554,62.51137731500169
3336,C2_02460W_A,4680,C2,491786,493972,2186,243.84249347101456,288.6971296510883
3338,C2_02470C_A,3,C2,494231,495081,850,0.4019907169891689,0.4759365953373145
3340,C2_02480W_A,1,C2,496117,496190,73,1.5602379426520252,1.847242493318344
3342,C2_02490C_A,1453,C2,496573,500625,4052,40.84227007382963,48.355173747231845
3344,C2_02500W_A,653,C2,501159,502925,1766,42.11493912133601,49.861949271796234
3346,C2_02510W_A,957,C2,503320,504282,962,113.30538764200949,134.1478251826537
3348,C2_02520W_A,433,C2,504703,506571,1868,26.40126398784147,31.25775587328669
3350,C2_02530W_A,12,C2,507675,509003,1328,1.0291931007252817,1.218512367580474
3352,C2_02540W_A,1464,C2,509371,514539,5168,32.265044389920135,38.20017409944235
3354,C2_02550C_A,4025,C2,514896,517007,2111,217.16575722393713,257.1132286116828
3356,C2_02560W_A,13,C2,517641,517973,332,4.459836769809554,5.280220259515388
3358,C2_02570W_A,493,C2,519036,520763,1727,32.51384094852561,38.4947365906392
3360,C2_02580W_A,597,C2,521088,522620,1532,44.384288367309345,52.54874353871198
3362,C2_02590W_A,1103,C2,524004,525116,1112,112.97553858309212,133.75730064703217
3364,C2_02600C_A,164,C2,525523,526410,887,21.058814711871527,24.932567226614673
3366,C2_02610C_A,260,C2,526810,528321,1511,19.59848851855423,23.203615170868414
3368,C2_02620W_A,563,C2,529061,529480,419,153.04109595478658,181.1928859973523
3370,C2_02630W_A,467,C2,530019,531332,1313,40.51033640742589,47.96218114220539
3372,C2_02640C_A,1,C2,532052,533413,1361,0.08368653182483309,0.09908060397666357
3374,C2_02650C_A,1,C2,586142,586920,778,0.14639764757531856,0.17332738047845647
3376,C2_02660W_A,259,C2,536192,536950,758,38.91743902601826,46.076271531886455
3378,C2_02670C_A,73,C2,536947,537440,493,16.8651277817295,19.96745486185285
3380,C2_02680W_A,362,C2,537502,538596,1094,37.68816076098941,44.62086849033872
3382,C2_02690W_A,445,C2,538929,539834,905,56.00478405199009,66.30682032646013
3384,C2_02700C_A,309,C2,539908,540801,893,39.4112959377399,46.66097303670984
3386,C2_02710C_A,736,C2,540983,541825,842,99.55874606034205,117.87249962114964
3388,C2_02720W_A,2126,C2,542265,545273,3008,80.50060113820113,95.30862382912912
3390,C2_02730W_A,1368,C2,545624,546715,1091,142.81540046287978,169.08618180819718
3392,C2_02740C_A,670,C2,546837,547478,641,119.0502929408901,140.94950132324524
3394,C2_02750C_A,43,C2,548118,549434,1316,3.7215705942133033,4.4061505976643485
3396,C2_02760W_A,2043,C2,550317,553115,2798,83.16380504974282,98.46172201965851
3398,C2_02770W_A,2134,C2,553446,555599,2153,112.89223742787635,133.65867630939076
3400,C2_02780C_A,96,C2,555635,556579,944,11.582783370874358,13.713427323278555
3402,C2_02790C_A,64,C2,556999,558633,1634,4.461096492087063,5.281711706721728
3404,C2_02800W_A,248,C2,560211,560501,290,97.40188866818023,115.31888999667345
3406,C2_02810C_A,300,C2,560749,561198,449,76.1006925257892,90.09935546474775
3408,C2_02820C_A,523,C2,561952,563013,1061,56.14356683554352,66.47113209462871
3410,C2_02830C_A,2473,C2,563521,564555,1034,272.4063786741078,322.51531922269567
3412,C2_02840C_A,565,C2,564861,568430,3569,18.030824865419664,21.34758101342536
3414,C2_02850W_A,93,C2,570077,571711,1634,6.482530840064014,7.674987323830011
3416,C2_02860W_A,6514,C2,572923,573951,1028,721.719325842195,854.4790320114062
3418,C2_02870W_A,331,C2,574346,575000,654,57.64530490565885,68.24911370955833
3420,C2_02880C_A,577,C2,575277,576455,1178,55.78844005301014,66.05068001787943
3422,C2_02890W_A,1732,C2,577820,579976,2156,91.49825812483834,108.3292912269008
3424,C2_02900W_A,315,C2,580559,580909,350,102.50763283223806,121.3638318110152
3426,C2_02910W_A,483,C2,581973,582236,263,209.17273619759604,247.64989761183077
3428,C2_02920W_A,2118,C2,583204,583761,557,433.09628234326794,512.7640051381013
3430,C2_02930C_A,1365,C2,584177,585442,1265,122.90111446289411,145.5086784558944
3432,C2_02940W_A,845,C2,586142,587827,1685,57.117672102368054,67.62442326429796
3434,C2_02950W_A,101,C2,588152,589513,1361,8.452339714308142,10.00714100164302
3436,C2_02960C_A,625,C2,589813,591033,1220,58.34906240450709,69.08232685053234
3438,C2_02970C_A,58871,C2,591403,592902,1499,4473.15013895685,5295.982612516697
3440,C2_02980C_A,3537,C2,595308,597062,1754,229.67787744053342,271.92694356744005
3442,C2_02990C_A,1859,C2,597477,601388,3911,54.13838161173061,64.09709461538034
3444,C2_03000C_A,253,C2,602011,603051,1040,27.707725541192552,32.804540008746635
3446,C2_03010C_A,3618,C2,603455,604696,1241,332.0553456773545,393.1366671073981
3448,C2_03020C_A,12585,C2,606159,608219,2060,695.8244655845285,823.8208324388492
3450,C2_03030W_A,3477,C2,610668,613454,2786,142.14686103441483,168.29466507414048
3452,C2_03040W_A,1105,C2,613973,614860,887,141.89018449157342,167.9907730817635
3454,C2_03050W_A,859,C2,615026,616600,1574,62.1587297775607,73.59277956068196
3456,C2_03060W_A,3406,C2,616878,618113,1235,314.1169567490804,371.8985255495437
3458,C2_03070C_A,256,C2,618202,619698,1496,19.49045900553546,23.07571371332434
3460,C2_03080W_A,5601,C2,620854,621963,1109,575.2382040811195,681.0528223359345
3462,C2_03090C_A,576,C2,622122,622790,668,98.21090570753346,116.2767250883978
3464,C2_03100W_A,35809,C2,623498,626224,2726,1496.1668802843453,1771.3856090815373
3466,C2_03110W_A,444,C2,628185,629063,878,57.59730318591964,68.19228211097285
3468,C2_03120W_A,1432,C2,630696,632825,2129,76.60922196950311,90.70142850236093
3470,C2_03130W_A,285,C2,633048,633668,620,52.35604902721836,61.98690334433573
3472,C2_03140C_A,1776,C2,633926,636181,2255,89.70364913035468,106.20456530986107
3474,C2_03150C_A,690,C2,636492,638513,2021,38.88628657663657,46.039388613777824
3476,C2_03160C_A,1938,C2,639344,641908,2564,86.08935362665859,101.92542297180945
3478,C2_03170W_A,421,C2,643405,644115,710,67.53632773454181,79.9595824607784
3480,C2_03180C_A,4461,C2,644266,654126,9860,51.53105139335294,61.010148040222994
3482,C2_03200W_A,982,C2,655510,656850,1340,83.46807250518886,98.82195923583494
3484,C2_03210W_A,364,C2,657092,657531,439,94.43882143997635,111.81076886664017
3486,C2_03220C_A,16188,C2,658895,660025,1130,1631.6554181792228,1931.7971576762184
3488,C2_03230C_A,809,C2,663649,664527,878,104.94643756173195,124.2512527652636
3490,C2_03240C_A,3238,C2,665418,669563,4145,88.97459190746196,105.34139858036919
3492,C2_03250W_A,881,C2,672719,674041,1322,75.90286142645968,89.86513348924558
3494,C2_03260W_A,232,C2,674262,674963,701,37.69499257739615,44.62895701403634
3496,C2_03270W_A,5799,C2,675806,676552,746,885.3764712453807,1048.2407814597516
3498,C2_03280W_A,2958,C2,677031,679187,2156,156.26550088526085,185.01041769582713
3500,C2_03290W_A,589,C2,679560,680408,848,79.11031936345417,93.6626008080293
3502,C2_03300W_A,620,C2,680927,681952,1025,68.89401881407869,81.56701975374463
3504,C2_03310C_A,278,C2,682113,682763,650,48.713028935661846,57.67375255292688
3506,C2_03320W_A,953,C2,683898,691313,7415,14.63846169013604,17.33119528222035
3508,C2_03330C_A,1168,C2,691444,692577,1133,117.41582342655099,139.014372418619
3510,C2_03340W_A,398,C2,692973,695063,2090,21.68954697885739,25.679322201373765
3512,C2_03350W_A,91,C2,695735,697408,1673,6.195254425007414,7.33486663664899
3514,C2_03360W_A,2093,C2,698119,700455,2336,102.04931293658403,120.82120432860295
3516,C2_03370W_A,516,C2,700790,702436,1646,35.70537231094562,42.27334765389756
3518,C2_03380W_A,5804,C2,702727,706917,4190,157.77096286351357,186.79280822888686
3520,C2_03390C_A,3082,C2,707074,709512,2438,143.9834675002086,170.4691138645287
3522,C2_03400C_A,921,C2,710171,711886,1715,61.16587615062602,72.41729128470683
3524,C2_03410W_A,1455,C2,712666,715701,3035,54.6031871758764,64.64740079993672
3526,C2_03420C_A,787,C2,715773,718100,2327,38.52051140666158,45.60632938703575
3528,C2_03430W_A,422,C2,718272,719168,896,53.64362730060077,63.51133063522869
3530,C2_03440W_A,741,C2,719546,720286,740,114.0512851782108,135.03092998793133
3532,C2_03450W_A,376,C2,720617,721876,1259,34.01541783154312,40.272527368230264
3534,C2_03460C_A,788,C2,721980,723086,1106,81.14930145851275,96.07665206658629
3536,C2_03470C_A,3374,C2,723706,724234,528,727.8214502861347,861.703637479725
3538,C2_03480C_A,120,C2,724850,725209,359,38.07154422738646,45.07477504587381
3540,C2_03490C_A,1507,C2,725206,726486,1280,134.09635649147808,158.76327650972215
3542,C2_03500W_A,3529,C2,728326,731385,3059,131.3971291507639,155.56752840836612
3544,C2_03520C_A,11842,C2,740722,742359,1637,823.9295377719154,975.4907325772363
3546,C2_03530W_A,1152,C2,747174,748787,1613,81.34517670506182,96.30855841171696
3548,C2_03540W_A,2050,C2,749770,751692,1922,121.48262649213089,143.82926073105628
3550,C2_03550C_A,1083,C2,751790,754894,3104,39.73932071782425,47.04933771883214
3552,C2_03560C_A,832,C2,755206,756342,1136,83.41779197615617,98.76242964276668
3554,C2_03570C_A,270,C2,756676,757386,710,43.31308429531186,51.28049231451347
3556,C2_03580W_A,32,C2,757870,757953,83,43.912238964278686,51.989861016766895
3558,C2_03590C_A,316,C2,758090,758620,530,67.90862049263569,80.4003581808822
3560,C2_03600W_A,786,C2,759431,761515,2084,42.95745329821876,50.85944327333011
3562,C2_03610W_A,259,C2,763392,765050,1658,17.79217055592391,21.06502643013868
3564,C2_03620W_A,415,C2,766541,768199,1658,28.50869027300549,33.75284157724924
3566,C2_03630W_A,11,C2,768418,769167,749,1.6727250573425583,1.9804215248793462
3568,C2_03640W_A,723,C2,769687,770991,1304,63.150152128244805,74.76657327825835
3570,C2_03660W_A,1,C2,771703,771774,71,1.6041883072337724,1.8992774931301286
3572,C2_03670W_A,116,C2,773072,774163,1091,12.110077817027818,14.337717170870521
3574,C2_03680W_A,360,C2,775409,776503,1094,37.47993887833202,44.37434435503299
3576,C2_03690C_A,1619,C2,776856,779372,2516,73.29087509070544,86.77267430755768
3578,C2_03700W_A,439,C2,782202,783326,1124,44.48482682221481,52.66777596385496
3580,C2_03710W_A,725,C2,785869,788415,2546,32.433461553361525,38.39957146852842
3582,C2_03720W_A,3,C2,789500,789823,323,1.057870307866234,1.2524647245718805
3584,C2_03730W_A,1,C2,790147,790219,72,1.5819079140777477,1.8728986390588769
3586,C2_03740W_A,1,C2,790226,790313,87,1.3091651702712395,1.5499850806004494
3588,C2_03750W_A,1115,C2,790963,792051,1088,116.72386704242794,138.19513119820462
3590,C2_03760C_A,1319,C2,792275,795163,2888,52.018916476501225,61.587755524287886
3592,C2_03770C_A,1034,C2,795612,798083,2471,47.66081763952253,56.427987810868174
3594,C2_03780C_A,917,C2,798539,800725,2186,47.77853985318812,56.56736493377094
3596,C2_03790C_A,2365,C2,801061,801405,344,783.0444174684852,927.0848263341439
3598,C2_03800C_A,2068,C2,801900,803990,2090,112.69845013134945,133.42924199105767
3600,C2_03810C_A,3235,C2,804382,805193,811,454.3255133748324,537.8983366332843
3602,C2_03820C_A,3241,C2,805679,806736,1057,349.2349816138795,413.47648365342195
3604,C2_03830W_A,419,C2,807027,808910,1883,25.344130617045934,30.006163644783957
3606,C2_03840C_A,535,C2,809042,809518,476,128.01490094595556,151.56314196753766
3608,C2_03850W_A,1,C2,810292,810364,72,1.5819079140777477,1.8728986390588769
3610,C2_03860W_A,1,C2,810371,810458,87,1.3091651702712395,1.5499850806004494
3612,C2_03870W_A,214,C2,810975,811424,449,54.285160668396294,64.27087356485339
3614,C2_03880C_A,131,C2,811574,812026,452,33.01007841942769,39.08225655664452
3616,C2_03890W_A,58,C2,812259,813371,1112,5.94069015214809,7.033475464667148
3618,C2_03900C_A,1007,C2,813428,815788,2360,48.59942856029366,57.53925547725627
3620,C2_03910C_A,483,C2,816220,818748,2528,21.761245893974586,25.76421007591436
3622,C2_03920C_A,264,C2,819247,822291,3044,9.878089891849484,11.695156810522708
3624,C2_03930C_A,637,C2,822952,824469,1517,47.826384028518014,56.624010007776086
3626,C2_03940C_A,1103,C2,825401,827764,2363,53.16495933321982,62.9446120691916
3628,C2_03950W_A,886,C2,830390,831187,797,126.61614762214263,149.90708906253934
3630,C2_03960W_A,1264,C2,831558,832282,724,198.8484467463918,235.42646318158876
3632,C2_03970W_A,459,C2,832702,833439,737,70.93472556911996,83.98311292214078
3634,C2_03980C_A,444,C2,833964,835820,1856,27.247000106270175,32.25906448999686
3636,C2_03990W_A,517,C2,836081,837178,1097,53.67815879091165,63.55221416620567
3638,C2_04000C_A,27,C2,837207,837875,668,4.603636205040631,5.450471488518647
3640,C2_04010C_A,2127,C2,838065,838634,569,425.7639817109361,504.08293353257045
3642,C2_04020C_A,686,C2,839032,840156,1124,69.51387517093251,82.30089820319932
3644,C2_04030C_A,590,C2,840690,841022,332,202.40797647597208,239.64076562415988
3646,C2_04040C_A,469,C2,841309,846615,5306,10.067445616769202,11.919344373113486
3648,C2_04050C_A,2041,C2,847533,853277,5744,40.47084467088322,47.91542493157731
3650,C2_04060C_A,604,C2,854661,857303,2642,26.03861141840011,30.828393647006976
3652,C2_04070C_A,12,C2,857706,857920,214,6.386768400762496,7.561609458630231
3654,C2_04080W_A,2039,C2,858566,860644,2078,111.75973871507507,132.317855343097
3656,C2_04090W_A,35,C2,860981,862354,1373,2.9034289464500542,3.437512432941274
3658,C2_04100W_A,338,C2,862515,863651,1136,33.88847799031344,40.12223704237396
3660,C2_04110W_A,329,C2,864185,867989,3804,9.850745181039352,11.662782061521206
3662,C2_04120C_A,684,C2,868107,869474,1367,56.990344515362786,67.47367386713356
3664,C2_04130W_A,957,C2,870626,872458,1832,59.497698095858695,70.44225317997426
3666,C2_04140W_A,2841,C2,872931,874619,1688,191.69575097181962,226.95803460709203
3668,C2_04150C_A,341,C2,874851,875207,356,109.09832333268781,129.16687468026274
3670,C2_04160W_A,388,C2,875525,876382,857,51.56613709180393,61.05168772549449
3672,C2_04170C_A,1875,C2,876638,876868,230,928.5111669586781,1099.3100707519493
3674,C2_04180C_A,370,C2,877101,878081,980,43.0020681949298,50.912265045437216
3676,C2_04190C_A,553,C2,878553,879968,1415,44.51254099428947,52.70058813623197
3678,C2_04200W_A,528,C2,880756,883416,2660,22.60819972239837,26.7669603994219
3680,C2_04210W_A,161,C2,884415,885788,1373,13.355773153670249,15.81255719152986
3682,C2_04220C_A,850,C2,886061,886970,909,106.50469124483847,126.09614599604318
3684,C2_04230W_A,1021,C2,887776,888957,1181,98.46673546120526,116.57961452539894
3686,C2_04240C_A,322,C2,889091,890104,1013,36.20429721616832,42.86404940566732
3688,C2_04250W_A,525,C2,890702,892699,1997,29.94297403712512,35.45096071929171
3690,C2_04260W_A,304,C2,893030,894856,1826,18.962103189120345,22.45016725724025
3692,C2_04270W_A,220,C2,895055,896074,1019,24.590207418048603,29.11355686230874
3694,C2_04280W_A,625,C2,897773,900651,2878,24.734487885162835,29.284377608634276
3696,C2_04290W_A,1,C2,899422,900651,1229,0.09267483304605194,0.10972229618571126
3698,C2_04300C_A,368,C2,900914,901672,758,55.29582070106069,65.46744372098152
3700,C2_04310W_A,9468,C2,902492,903700,1208,892.6989216847221,1056.9101909369867
3702,C2_04320W_A,233,C2,903918,905699,1781,14.900666573031048,17.64163254848496
3704,C2_04330C_A,491,C2,905838,906848,1010,55.369909483640136,65.55516107723703
3706,C2_04340C_A,90,C2,907655,908230,575,17.82741440560662,21.106753358437427
3708,C2_04350C_A,462,C2,908645,910807,2162,24.33884590836365,28.81595759928514
3710,C2_04360W_A,554,C2,911437,914340,2903,21.73583977841309,25.73413052524301
3712,C2_04370W_A,356,C2,914705,915937,1232,32.91190231626691,38.966021036004165
3714,C2_04380C_A,669,C2,916040,917584,1544,49.35060907078818,58.42861505582122
3716,C2_04390W_A,231,C2,918662,919405,743,35.410891557121275,41.92469739546061
3718,C2_04400W_A,1728,C2,920773,921963,1190,165.39046641840088,195.8139135102094
3720,C2_04410W_A,377,C2,922531,924594,2063,20.814012806459715,24.642734201945782
3722,C2_04420W_A,291,C2,925532,927565,2033,16.30306670720953,19.302003091766643
3724,C2_04430W_A,13,C2,928590,928910,320,4.6270806486774125,5.478228519247214
3726,C2_04440W_A,34,C2,928957,929604,647,5.985333189586286,7.0863305539661985
3728,C2_04450W_A,85,C2,929893,930708,815,11.878866790375234,14.063975056491197
3730,C2_04460W_A,1277,C2,931947,933200,1253,116.07896348919746,137.4315981401671
3732,C2_04470W_A,158,C2,935501,936349,848,21.221443903948654,25.125111931525684
3734,C2_04480W_A,783,C2,937444,938493,1049,85.01586326410593,100.6544648956942
3736,C2_04490W_A,1442,C2,938705,939382,677,242.59971531936205,287.22574342931875
3738,C2_04500W_A,3092,C2,940654,946401,5747,61.279044277648254,72.55127660028595
3740,C2_04510W_A,305,C2,946908,948107,1199,28.973059043492363,34.30263062029436
3742,C2_04520C_A,100,C2,948352,949059,707,16.109953297538592,19.073366621250226
3744,C2_04530W_A,125,C2,949282,950001,719,19.801350802085857,23.443793812976203
3746,C2_04540C_A,685,C2,950284,951336,1052,74.1632113329986,87.80547612013667
3748,C2_04550C_A,3993,C2,952424,953896,1472,308.9620908055001,365.79542604271114
3750,C2_04560W_A,454,C2,955040,956479,1439,35.93426399956457,42.544343789823884
3752,C2_04570W_A,1201,C2,956813,958096,1283,106.6178808621442,126.23015675502664
3754,C2_04580W_A,1788,C2,958569,959624,1055,193.03175092579426,228.53979070889434
3756,C2_04590C_A,2030,C2,959841,960128,287,805.6155425839847,953.8078922816914
3758,C2_04600C_A,3365,C2,961320,961877,557,688.0873418720947,814.6604708638863
3760,C2_04610C_A,6,C2,963219,963350,131,5.2166734265770005,6.176276428041486
3762,C2_04620W_A,4054,C2,965382,968297,2915,158.4013506772987,187.53915538854798
3764,C2_04640C_A,519,C2,971681,974749,3068,19.267514645781382,22.81175891276144
3766,C2_04650C_A,363,C2,975240,976046,806,51.296209978084384,60.73210773007792
3768,C2_04660C_A,1939,C2,976775,979204,2429,90.92095515379424,107.64579382533208
3770,C2_04670W_A,145,C2,979878,980315,437,37.79203346217778,44.74384849376355
3772,C2_04680W_A,312,C2,981049,981513,464,76.58616246086753,90.6741272151263
3774,C2_04690C_A,147,C2,982318,984330,2012,8.321527516202229,9.852266001888244
3776,C2_04700C_A,135,C2,984870,985955,1085,14.171562142705723,16.778409927790122
3778,C2_04710C_A,378,C2,986357,987391,1034,41.637529777117976,49.29672085166962
3780,C2_04720C_A,536,C2,988585,990066,1481,41.221465374806506,48.80412172758958
3782,C2_04730W_A,450,C2,991582,993189,1607,31.89409857879218,37.76099309614661
3784,C2_04740C_A,117,C2,993261,994097,836,15.940182138984389,18.872366190708107
3786,C2_04750W_A,1405,C2,995291,996994,1703,93.96700210693186,111.2521587358755
3788,C2_04760W_A,906,C2,997716,1000391,2675,38.576081140605474,45.6721211301266
3790,C2_04770W_A,387,C2,1000715,1001686,971,45.39472926659358,53.74505425204587
3792,C2_04780W_A,1383,C2,1001834,1004284,2450,64.29390304171666,76.1207162787456
3794,C2_04790C_A,468,C2,1004405,1005511,1106,48.195270409370515,57.06075275020607
3796,C2_04800C_A,280,C2,1005765,1007186,1421,22.442831490364107,26.571172810293422
3798,C2_04810W_A,310,C2,1007626,1008294,668,52.85656383565169,62.579487460769656
3800,C2_04820W_A,540,C2,1008544,1009959,1415,43.46613406313981,51.46169546756828
3802,C2_04830W_A,964,C2,1010657,1011961,1304,84.20020283765976,99.68876437101113
3804,C2_04850C_A,3551,C2,1013027,1014433,1406,287.6597156529772,340.5744956226608
3806,C2_04860W_A,234,C2,1015779,1017017,1238,21.528258914686507,25.48836532379964
3808,C2_04870C_A,2901,C2,1017114,1021940,4826,68.46586610635048,81.06010868991001
3810,C2_04880C_A,253,C2,1023076,1023824,748,38.52411037812868,45.61059038649264
3812,C2_04890C_A,1,C2,1023950,1024021,71,1.6041883072337724,1.8992774931301286
3814,C2_04910W_A,14,C2,1026161,1026466,305,5.228075991443836,6.189776485807697
3816,C2_04920W_A,1,C2,1027101,1027171,70,1.6271052830513977,1.9264100287462733
3818,C2_04930C_A,895,C2,1027317,1029554,2237,45.569130971466286,53.95153701428431
3820,C2_04940C_A,1941,C2,1030003,1031667,1664,132.85744880300086,157.2964727198054
3822,C2_04950C_A,5649,C2,1032788,1033654,866,742.9633280335037,879.630851809629
3824,C2_04960C_A,253,C2,1034743,1035171,428,67.32718355803797,79.71196637639368
3826,C2_04970W_A,39,C2,1036592,1038424,1832,2.4246710822763737,2.8706874336666623
3828,C2_04980C_A,541,C2,1038614,1039603,989,62.303819079025715,73.76455792580522
3830,C2_04990W_A,204,C2,1040068,1040901,833,27.893233423738245,33.02417192136468
3832,C2_05000C_A,502,C2,1040957,1041808,851,67.18740263974867,79.5464728673843
3834,C2_05010W_A,2,C2,1042388,1042460,72,3.1638158281554953,3.7457972781177538
3836,C2_05020W_A,265,C2,1042890,1043339,449,67.22227839778046,79.58776399386049
3838,C2_05030C_A,632,C2,1043453,1044176,723,99.56173958809659,117.87604380599602
3840,C2_05040C_A,1476,C2,1044709,1045575,866,194.12530928968872,229.83450827952072
3842,C2_05050C_A,554,C2,1045870,1047258,1388,45.46047757689712,53.82289691266604
3844,C2_05060C_A,218,C2,1047799,1048197,398,62.38599653106616,73.86185185595006
3846,C2_05070W_A,506,C2,1049141,1051390,2249,25.625642119022014,30.339458967626943
3848,C2_05080C_A,133,C2,1051686,1052672,986,15.363438321712486,18.18953079881116
3850,C2_05090W_A,790,C2,1052876,1055224,2348,38.32151710082721,45.3707302341009
3852,C2_05100C_A,1806,C2,1055350,1056660,1310,157.02187013996772,185.90592048404872
3854,C2_05110W_A,2381,C2,1056968,1058287,1319,205.60245453083886,243.42286542163862
3856,C2_05120C_A,187,C2,1058325,1058669,344,61.915139985880224,73.30438161711835
3858,C2_05130W_A,772,C2,1058903,1060021,1118,78.64827325232338,93.11556167571432
3860,C2_05140W_A,852,C2,1060271,1063651,3380,28.710224580232357,33.99144796284844
3862,C2_05150W_A,473,C2,1063895,1065157,1262,42.68895080969237,50.54154996179802
3864,C2_05160C_A,1536,C2,1065176,1067179,2003,87.34216676669311,103.40869011023429
3866,C2_05170W_A,666,C2,1067412,1068083,671,113.0486561786232,133.84386816714047
3868,C2_05180W_A,11447,C2,1068935,1069132,197,6618.188793178957,7835.599451442138
3870,C2_05190W_A,576,C2,1069505,1070452,947,69.2765417240046,82.019907454118
3872,C2_05200C_A,291,C2,1070553,1071908,1355,24.460615952588178,28.96012714801593
3874,C2_05210W_A,74,C2,1072110,1072487,377,22.356512907708858,26.468975991792295
3876,C2_05220C_A,1223,C2,1072541,1075639,3098,44.96335806392194,53.234332653637324
3878,C2_05230C_A,495,C2,1076054,1077037,983,57.35421979423289,67.90448371928622
3880,C2_05240C_A,1,C2,1077341,1077426,85,1.3399690566305626,1.5864553177910485
3882,C2_05250C_A,2832,C2,1077700,1079013,1313,245.66439551569616,290.85416915358815
3884,C2_05260W_A,1330,C2,1083758,1086160,2402,63.065571129094565,74.66643367039052
3886,C2_05270W_A,698,C2,1086618,1089464,2846,27.93407031970882,33.072520732446556
3888,C2_05280C_A,78,C2,1089779,1090675,896,9.915172818594456,11.739061112672603
3890,C2_05290C_A,473,C2,1090726,1091367,641,84.04595307618061,99.50614048641044
3892,C2_05300C_A,831,C2,1091743,1092969,1226,77.20123516729186,91.40234206539209
3894,C2_05310C_A,1,C2,1092308,1092387,79,1.4417388583999726,1.7069455950916343
3896,C2_05320W_A,471,C2,1093474,1095444,1970,27.231300092489636,32.24047647094651
3898,C2_05330C_A,231,C2,1095605,1097107,1502,17.51683916573975,20.739048045823726
3900,C2_05340C_A,673,C2,1097889,1098899,1010,75.89398998470429,89.85463015270983
3902,C2_05350C_A,148,C2,1099417,1100277,860,19.600942712107535,23.20652081140859
3904,C2_05360C_A,376,C2,1100492,1101952,1460,29.33247332185807,34.72815887438487
3906,C2_05370C_A,342,C2,1102511,1104064,1553,25.082357035576603,29.696237017505332
3908,C2_05380W_A,530,C2,1106562,1107680,1118,53.99428085975568,63.92648664265361
3910,C2_05390C_A,62,C2,1107956,1108372,416,16.975088770295834,20.09764308836256
3912,C2_05400W_A,125,C2,1108620,1109912,1292,11.019482373606603,13.046507547623754
3914,C2_05410W_A,2834,C2,1110394,1111214,820,393.6404220143125,466.0502701252264
3916,C2_05420C_A,8,C2,1111557,1111675,118,7.721855580582904,9.142284882185704
3918,C2_05430C_A,1,C2,1112160,1112246,86,1.324388021088347,1.568008162933013
3920,C2_05440W_A,855,C2,1112792,1116265,3473,28.039807426036898,33.197708096880056
3922,C2_05450C_A,92,C2,1116605,1117036,431,24.31219958898144,28.78440971026914
3924,C2_05460W_A,8703,C2,1118612,1120126,1514,654.721802832062,775.1573669831685
3926,C2_05470W_A,975,C2,1120484,1121404,920,120.70645170462814,142.91030919775343
3928,C2_05480C_A,128,C2,1121552,1121806,254,57.397099748584736,67.95525140774255
3930,C2_05490W_A,156,C2,1121980,1122426,446,39.83854190789521,47.166810569303365
3932,C2_05500W_A,7062,C2,1122648,1123349,701,1147.4225757826362,1358.490062211744
3934,C2_05510C_A,300,C2,1123477,1124784,1307,26.143237141606235,30.952265190261464
3936,C2_05520W_A,344,C2,1125205,1126004,799,49.037165476692934,58.057513757459645
3938,C2_05530C_A,1077,C2,1126080,1127237,1157,106.02201148595064,125.5246776725856
3940,C2_05540C_A,552,C2,1127540,1128659,1119,56.185297709656844,66.5205393304343
3942,C2_05550W_A,814,C2,1128947,1129336,389,238.33537025261862,282.1769754189271
3944,C2_05560W_A,411,C2,1129692,1130708,1016,46.074624993492826,54.55001626676208
3946,C2_05570C_A,864,C2,1130820,1131869,1049,93.81060773970307,111.06699574697294
3948,C2_05580W_A,1583,C2,1134957,1139015,4058,44.43063982625071,52.60362131231506
3950,C2_05590C_A,266,C2,1139195,1140115,920,32.93119605480111,38.98886384266913
3952,C2_05600W_A,6,C2,1141059,1141154,95,7.193518093490391,8.516760127088785
3954,C2_05610C_A,5562,C2,1141641,1142261,620,1021.7696304890827,1209.7233557936677
3956,C2_05620W_A,101,C2,1143167,1143379,212,54.2624261847801,64.24395709073657
3958,C2_05630C_A,1,C2,1143807,1143888,81,1.4061403680691091,1.6647987902745571
3960,C2_05640W_A,2664,C2,1149967,1151790,1823,166.44135665574584,197.05811418574055
3962,C2_05650W_A,1209,C2,1152540,1155374,2834,48.58924492047981,57.5271985648543
3964,C2_05660W_A,25093,C2,1156982,1159933,2951,968.4943072628298,1146.6480784795376
3966,C2_05670C_A,140,C2,1160140,1160940,800,19.93203971737962,23.598522852141844
3968,C2_05680W_A,516,C2,1161273,1163942,2669,22.019873669470396,26.070412228668182
3970,C2_05690C_A,1331,C2,1164030,1164677,647,234.30819045115726,277.4089990390885
3972,C2_05700W_A,6072,C2,1165370,1166881,1511,457.70008571023567,541.8936589135116
3974,C2_05710C_A,1977,C2,1167165,1167944,779,289.0566111957419,342.22834900923846
3976,C2_05720C_A,3008,C2,1168416,1169708,1292,265.17282383846924,313.951157626018
3978,C2_05730C_A,422,C2,1170270,1171727,1457,32.988805807370134,39.05707086421751
3980,C2_05740W_A,554,C2,1172463,1174007,1544,40.867320516018914,48.38483219869202
3982,C2_05750W_A,705,C2,1174515,1175765,1250,64.2381165748692,76.05466793490287
3984,C2_05760C_A,1701,C2,1175951,1176283,332,583.5524881112347,690.8965124181287
3986,C2_05770W_A,1129,C2,1178196,1179634,1438,89.42290022221972,105.87217285940052
3988,C2_05780C_A,970,C2,1180382,1181722,1340,82.44809605909695,97.61435891930742
3990,C2_05790C_A,1358,C2,1182436,1185167,2731,56.635894619870335,67.05402319026756
3992,C2_05800C_A,928,C2,1185717,1187078,1361,77.66110153344512,91.9468004903438
3994,C2_05810W_A,531,C2,1189182,1190819,1637,36.94532887661604,43.74139326114781
3996,C2_05820W_A,627,C2,1191654,1193099,1445,49.4212116769037,58.51220495617573
3998,C2_05830C_A,365,C2,1193133,1194662,1529,27.189365586633883,32.19082814549854
4000,C2_05840W_A,262,C2,1194847,1196127,1280,23.313367883720808,27.601843693130196
4002,C2_05850C_A,429,C2,1196120,1198435,2315,21.10668321815701,24.989241107235674
4004,C2_05860C_A,239,C2,1198788,1200521,1733,15.707715744633516,18.59713778472311
4006,C2_05870W_A,67,C2,1204055,1204384,329,23.194905098817795,27.461589771489425
4008,C2_05880W_A,1,C2,1204115,1204271,156,0.7301113449589605,0.8644147564887124
4010,C2_05890C_A,1288,C2,1204413,1205714,1301,112.7592715756449,133.5012514925165
4012,C2_05900W_A,18,C2,1206361,1207523,1162,1.7643310298147685,2.08887834442367
4014,C2_05910W_A,1342,C2,1208390,1210834,2444,62.54102712350585,74.0454002047565
4016,C2_05920C_A,3664,C2,1211100,1211381,281,1485.1244234769483,1758.3119009709756
4018,C2_05930W_A,1512,C2,1211755,1211940,185,930.8801251792429,1102.1147969865167
4020,C2_05940C_A,513,C2,1212168,1214264,2096,27.876598623270848,33.00447716234669
4022,C2_05950C_A,1373,C2,1214551,1215612,1061,147.39028157782266,174.50260873025854
4024,C2_05960C_A,113,C2,1215977,1216873,896,14.36428882693812,17.006588535025692
4026,C2_05970C_A,387,C2,1217596,1218492,896,49.194511292257104,58.2438032128756
4028,C2_05980C_A,955,C2,1219015,1219995,980,110.99182466529177,131.40868410376365
4030,C2_05990C_A,330,C2,1221317,1222471,1154,32.57030505934774,38.56158723053632
4032,C2_06000W_A,373,C2,1223238,1224716,1478,28.74405882305277,34.03150598820378
4034,C2_06010W_A,1797,C2,1225302,1230872,5570,36.745704408444404,43.50504802800605
4036,C2_06020W_A,1362,C2,1232702,1234528,1826,84.95521231441415,100.58265725118821
4038,C2_06030W_A,634,C2,1234771,1236204,1433,50.39143926156388,59.66090514707578
4040,C2_06040C_A,149,C2,1236216,1237487,1271,13.352248703561038,15.808384421576418
4042,C2_06050C_A,1,C2,1237790,1237863,73,1.5602379426520252,1.847242493318344
4044,C2_06060C_A,9,C2,1238401,1238733,332,3.087579302175845,3.655537102741422
4046,C2_06070W_A,1943,C2,1238997,1241150,2153,102.78801186614984,121.69578634917818
4048,C2_06080C_A,369,C2,1241414,1242331,917,45.83220224778365,54.26300004636449
4050,C2_06090W_A,554,C2,1242516,1245644,3128,20.172360254710103,23.883050164571763
4052,C2_06100W_A,1349,C2,1246014,1248281,2267,67.77571763499932,80.2430079464096
4054,C2_06110W_A,436,C2,1248593,1249798,1205,41.21099853836404,48.791729524760385
4056,C2_06120C_A,120,C2,1249804,1250850,1046,13.066619863892678,15.47021437998919
4058,C2_06130W_A,182,C2,1251040,1251990,950,21.820338216920852,25.83417238550265
4060,C2_06140C_A,41,C2,1252015,1253619,1604,2.91134174710568,3.4468807870958877
4062,C2_06150C_A,1628,C2,1253885,1254724,839,221.0070537026666,261.6611285767882
4064,C2_06160W_A,82,C2,1255039,1255347,308,30.323325729594227,35.90127780845327
4066,C2_06170C_A,2684,C2,1255583,1259896,4313,70.87886403424451,83.916975701565
4068,C2_06180C_A,3,C2,1260497,1261645,1148,0.2976412103142801,0.3523920784291963
4070,C2_06190W_A,950,C2,1262842,1264551,1709,63.31334190925568,74.95978169199951
4072,C2_06200C_A,393,C2,1264660,1266624,1964,22.791072472883883,26.983472449495913
4074,C2_06210C_A,1217,C2,1266800,1267978,1178,117.66816558841136,139.31313272401954
4076,C2_06220C_A,135,C2,1268218,1269177,959,16.03351921255027,18.982872546039918
4078,C2_06230W_A,1069,C2,1269257,1271869,2612,46.614199207785646,55.18884473624947
4080,C2_06240W_A,120,C2,1272064,1272479,415,32.934179223209014,38.99239576257517
4082,C2_06250C_A,388,C2,1272572,1274758,2186,20.216001595460185,23.934719295859455
4084,C2_06260W_A,84,C2,1275158,1275673,515,18.57743507639266,21.994739745685603
4086,C2_06270W_A,116,C2,1275898,1277094,1196,11.046902088944274,13.078971098177039
4088,C2_06280C_A,92,C2,1277091,1278281,1190,8.80551094357227,10.425277802626889
4090,C2_06290C_A,2475,C2,1278612,1279313,701,402.13408029765293,476.10633021439634
4092,C2_06300W_A,691,C2,1279697,1280149,452,174.12186402919494,206.15144489039207
4094,C2_06310C_A,4322,C2,1280608,1281252,644,764.3857644943631,904.9939287218905
4096,C2_06320W_A,1413,C2,1285202,1288468,3266,49.27647995915915,58.34084995201894
4098,C2_06330C_A,239,C2,1288828,1290435,1607,16.939310134069622,20.055282999953423
4100,C2_06340W_A,102,C2,1295311,1297473,2162,5.373511434314051,6.361964664777239
4102,C2_06350C_A,9,C2,1297757,1299199,1442,0.7108712401680863,0.8416354494522552
4104,C2_06360C_A,853,C2,1299920,1300867,947,102.59182307391653,121.46350878187958
4106,C2_06370C_A,180,C2,1301184,1301768,584,35.105353709670574,41.56295609966274
4108,C2_06390C_A,3550,C2,1302199,1304011,1812,223.143301787126,264.1903378275104
4110,C2_06400C_A,1,C2,1303415,1303501,86,1.324388021088347,1.568008162933013
4112,C2_06410W_A,3,C2,1304759,1304860,101,3.3830901924831047,4.005406990462548
4114,C2_06420C_A,3298,C2,1305528,1308080,2552,147.19182039390506,174.26764076660055
4116,C2_06430C_A,240,C2,1309685,1310272,587,46.567919514929265,55.13405193004666
4118,C2_06440C_A,462,C2,1310642,1311376,734,71.69017010065696,84.87752088508783
4120,C2_06460W_A,10307,C2,1314688,1316082,1394,842.137869920196,997.0484731995327
4122,C2_06470W_A,6604,C2,1317087,1318448,1361,552.6658561711978,654.3283086618861
4124,C2_06480W_A,403,C2,1318661,1319632,971,47.27151393911424,55.96707199890048
4126,C2_06490W_A,965,C2,1319860,1321047,1187,92.59558708519118,109.62847299225841
4128,C2_06500W_A,1,C2,1321383,1321469,86,1.324388021088347,1.568008162933013
4130,C2_06510W_A,544,C2,1321731,1323038,1307,47.40640335011265,56.12677421167413
4132,C2_06520C_A,90,C2,1323080,1323985,905,11.326810257705864,13.410368155913282
4134,C2_06530W_A,135,C2,1324473,1325444,971,15.83537067439311,18.748274739085765
4136,C2_06540C_A,3221,C2,1325586,1329257,3671,99.93555657030744,118.31862413005234
4138,C2_06550W_A,167,C2,1330846,1331601,755,25.193193058107074,29.827461239793287
4140,C2_06560W_A,4,C2,1332428,1332503,75,6.074526390058551,7.191930773986087
4142,C2_06570C_A,543,C2,1332506,1332811,305,202.77466166814304,240.07490227096997
4144,C2_06590C_A,62,C2,1334165,1335724,1559,4.529593924594654,5.362809188427727
4146,C2_06600W_A,6798,C2,1341011,1343941,2930,264.2574470965318,312.867398047509
4148,C2_06610C_A,385,C2,1345071,1345313,242,181.2003610670875,214.53202592856223
4150,C2_06620W_A,201,C2,1346884,1348161,1277,17.927463846932785,21.225206816335213
4152,C2_06630C_A,609,C2,1349765,1349971,206,336.71601075961695,398.65465789055156
4154,C2_06640C_A,2949,C2,1350861,1354220,3359,99.99504125641562,118.38905097769967
4156,C2_06650C_A,238,C2,1354541,1356250,1709,15.861658288845105,18.77939793967988
4158,C2_06660W_A,146,C2,1356510,1357319,809,20.555025949054738,24.33610691444612
4160,C2_06670C_A,747,C2,1357769,1359901,2132,39.90681765983001,47.247645592468395
4162,C2_06680W_A,4627,C2,1365086,1365943,857,614.9394750612804,728.057111097585
4164,C2_06690C_A,627,C2,1366921,1367544,623,114.62865308687938,135.7145042723498
4166,C2_06700W_A,2536,C2,1371621,1373636,2015,143.34676419220057,169.7152894804161
4168,C2_06710W_A,382,C2,1374467,1375636,1169,37.21881545662479,44.065187483896786
4170,C2_06720W_A,1465,C2,1376330,1377367,1037,160.90612032489958,190.50467545605625
4172,C2_06730W_A,3241,C2,1379376,1380329,953,387.3466690093081,458.5987861717387
4174,C2_06740W_A,387,C2,1383179,1385761,2582,17.07137185045018,20.211637365893314
4176,C2_06750C_A,124,C2,1386153,1386893,740,19.08550521200829,22.596268985834666
4178,C2_06760C_A,73,C2,1387411,1388661,1250,6.651606397114113,7.875164197514764
4180,C2_06770W_A,199,C2,1389019,1390239,1220,18.57834146959506,21.995812869209495
4182,C2_06780C_A,423,C2,1390337,1391983,1646,29.270101720019376,34.654314065113695
4184,C2_06790W_A,76,C2,1392264,1392623,359,24.111978010678097,28.547357529053404
4186,C2_06800C_A,222,C2,1392696,1393475,779,32.458557251115174,38.42928350027867
4188,C2_06810C_A,1962,C2,1395463,1396380,917,243.69317292723986,288.520341709938
4190,C2_06820C_A,1860,C2,1396740,1397597,857,247.1984922442147,292.67046177685506
4192,C2_06830C_A,644,C2,1398004,1401462,3458,21.211655916702433,25.113523451672062
4194,C2_06840W_A,2,C2,1402344,1403921,1577,0.14444815448775883,0.1710192796604174
4196,C2_06850W_A,196,C2,1404233,1404912,679,32.87759128639938,38.92539851899686
4198,C2_06860W_A,278,C2,1407205,1412160,4955,6.3902056121453485,7.565678942361751
4200,C2_06870C_A,1787,C2,1412526,1413122,596,341.5010064713076,404.3198498252874
4202,C2_06880C_A,4214,C2,1413826,1415223,1397,343.5672987791706,406.76623498895896
4204,C2_06890C_A,1627,C2,1415603,1416562,959,193.2335982134762,228.77876764745886
4206,C2_06910W_A,549,C2,1417595,1418248,653,95.75751305921166,113.37203277904942
4208,C2_06920C_A,260,C2,1418391,1419161,770,38.45885214485122,45.533327952184635
4210,C2_06930C_A,46,C2,1419414,1420940,1526,3.4333414229524903,4.064901895519659
4212,C2_06940C_A,2920,C2,1422371,1424200,1829,181.83724431695225,215.28606335469559
4214,C2_06950C_A,196,C2,1426287,1427003,716,31.178609613778182,36.91389049497049
4216,C2_06960W_A,941,C2,1427773,1428666,893,120.01951287188753,142.09700850337853
4218,C2_06970W_A,23,C2,1429227,1430270,1043,2.5116390275290033,2.97365306450767
4220,C2_06980W_A,7,C2,1431599,1433137,1538,0.5183885492166352,0.6137457178710494
4222,C2_06990W_A,93,C2,1434464,1436020,1556,6.8074906122523124,8.059723192248224
4224,C2_07000W_A,410,C2,1436457,1437149,692,67.48254569880797,79.89590726158677
4226,C2_07010W_A,1464,C2,1437380,1438551,1171,142.39602852869962,168.5896667343451
4228,C2_07020C_A,394,C2,1438706,1439890,1184,37.901658535943874,44.87363901420795
4230,C2_07030C_A,429,C2,1440117,1440932,815,59.95333944789384,70.98170940276145
4232,C2_07040W_A,360,C2,1441145,1442233,1088,37.68662971773458,44.619055812873235
4234,C2_07060W_A,665,C2,1442700,1443479,779,97.22946203599817,115.11474562020412
4236,C2_07070W_A,1074,C2,1443720,1444874,1154,106.001538284059,125.50043844120002
4238,C2_07080C_A,282,C2,1444905,1445444,539,59.59008958707716,70.55164001382455
4240,C2_07090C_A,1167,C2,1445733,1447313,1580,84.1254623876384,99.60027547359688
4242,C2_07100W_A,897,C2,1447672,1449081,1409,72.50953919290082,85.84761228174484
4244,C2_07110C_A,428,C2,1449220,1451712,2492,19.561827560280847,23.16021045796081
4246,C2_07120W_A,456,C2,1452374,1453192,818,63.492910311736686,75.17238156183501
4248,C2_07130C_A,4134,C2,1453673,1455391,1718,274.0696896445946,324.48459494679656
4250,C2_07140W_A,1314,C2,1457732,1458469,737,203.0680379037552,240.42224483593245
4252,C2_07160W_A,4745,C2,1459884,1461638,1754,308.1203077340489,364.79879763288176
4254,C2_07170C_A,547,C2,1461999,1464395,2396,26.002446280483312,30.785575960223202
4256,C2_07180W_A,31,C2,1466280,1467026,746,4.733000622280875,5.603632389248543
4258,C2_07190C_A,759,C2,1467249,1467773,524,164.97729711549763,195.324742036812
4260,C2_07200W_A,199,C2,1468331,1468669,338,67.05791891392299,79.39317071134789
4262,C2_07210C_A,1141,C2,1469096,1470337,1241,104.71949956270358,123.9825696986018
4264,C2_07220W_A,1879,C2,1472227,1473021,794,269.53798221631024,319.1192834773265
4266,C2_07230C_A,398,C2,1473205,1475970,2765,16.394630446948263,19.410409909899155
4268,C2_07240C_A,167,C2,1476788,1478290,1502,12.663688920686312,14.993164604556545
4270,C2_07250C_A,125,C2,1479002,1479994,992,14.351987123689245,16.992023943074486
4272,C2_07260C_A,687,C2,1480464,1480904,440,177.835211504413,210.54785973274608
4274,C2_07270W_A,650,C2,1481388,1482407,1019,72.65288555332542,86.0173270931849
4276,C2_07280W_A,81,C2,1482648,1484342,1694,5.446096195337323,6.447901335886287
4278,C2_07290W_A,1434,C2,1484562,1485518,956,170.84605472039675,202.27305301835867
4280,C2_07300C_A,173,C2,1485601,1485972,371,53.11117244677204,62.88093112700099
4282,C2_07310W_A,2230,C2,1486613,1488259,1646,154.30810126629598,182.6929559461077
4284,C2_07320W_A,1733,C2,1488635,1489894,1259,156.77850825017083,185.6177923647422
4286,C2_07330W_A,1820,C2,1490143,1497591,7448,27.832064052194966,32.951750491712566
4288,C2_07340W_A,590,C2,1498450,1500138,1688,39.81009963863905,47.13313636683713
4290,C2_07350W_A,713,C2,1500487,1503123,2636,30.80759661498303,36.474629944888655
4292,C2_07360W_A,398,C2,1503394,1504845,1451,31.241318529160537,36.988134666348145
4294,C2_07370W_A,279,C2,1505218,1506252,1034,30.732462454539455,36.38567491432757
4296,C2_07380W_A,10900,C2,1506829,1508775,1946,637.9657404769869,755.3190400479991
4298,C2_07390C_A,471,C2,1509083,1511452,2369,22.644854867963097,26.810358230377634
4300,C2_07400C_A,13125,C2,1512062,1513321,1259,1187.3732953164986,1405.7896853936763
4302,C2_07410W_A,1082,C2,1514557,1516023,1466,84.06340664277822,99.52680462294866
4304,C2_07420W_A,562,C2,1516379,1517101,722,88.65695545047366,104.96533314526093
4306,C2_07430C_A,456,C2,1517213,1518205,992,52.35604902721836,61.98690334433573
4308,C2_07440C_A,979,C2,1519101,1520804,1703,65.47593954639594,77.52018747503354
4310,C2_07450C_A,575,C2,1521450,1522565,1115,58.7363117872814,69.54081045474214
4312,C2_07460W_A,722,C2,1523224,1524315,1091,75.3747946887421,89.23992928765962
4314,C2_07470W_A,670,C2,1524598,1528116,3518,21.691653716631766,25.68181647191592
4316,C2_07480W_A,2074,C2,1528366,1530174,1808,130.6543943547577,154.68816812687166
4318,C2_07490W_A,1031,C2,1530892,1532052,1160,101.2311967912236,119.85259635742976
4320,C2_07500C_A,259,C2,1532147,1533118,971,30.38045188642826,35.968912277208986
4322,C2_07510W_A,146,C2,1533370,1534185,815,20.40370060464452,24.156945391149584
4324,C2_07520C_A,419,C2,1534182,1535540,1358,35.142119257656475,41.60648464147878
4326,C2_07530C_A,15,C2,1535671,1537075,1404,1.2168522415982674,1.4406912608145206
4328,C2_07540W_A,642,C2,1537720,1538052,332,220.2473235552103,260.76164666222144
4330,C2_07550W_A,1747,C2,1538564,1539199,635,313.3522914399298,370.9932006541445
4332,C2_07560W_A,1865,C2,1539744,1544669,4925,43.130679127382734,51.06453385844182
4334,C2_07570W_A,1125,C2,1545974,1547158,1184,108.22174074349456,128.1290454085887
4336,C2_07580W_A,528,C2,1547643,1548842,1199,50.156639917914646,59.38291464759154
4338,C2_07590W_A,922,C2,1549130,1549471,341,307.9571113435109,364.6055813937961
4340,C2_07600C_A,3789,C2,1549800,1551644,1844,234.03315304974092,277.0833687225455
4342,C2_07610C_A,1665,C2,1552100,1554259,2159,87.83655430275147,103.99401984732661
4344,C2_07620W_A,49,C2,1554569,1556356,1787,3.123095199141743,3.697586121208571
4346,C2_07630C_A,2215,C2,1556455,1556820,365,691.1854085948471,818.3284245400265
4348,C2_07640W_A,1595,C2,1558200,1560074,1874,96.9403974667495,114.77250784926436
4350,C2_07650C_A,741,C2,1560176,1561576,1400,60.284250737054286,71.37349156504942
4352,C2_07660W_A,772,C2,1561929,1565840,3911,22.482426360546544,26.61805112591373
4354,C2_07670C_A,1062,C2,1565975,1567477,1502,80.53196187885547,95.34575335352727
4356,C2_07680W_A,681,C2,1568150,1569013,863,89.87729877527245,106.4101576713034
4358,C2_07690W_A,183,C2,1569249,1570613,1364,15.280952108422584,18.091871311026214
4360,C2_07700C_A,58,C2,1570678,1570995,317,20.839266401226105,24.672633175740913
4362,C2_07710W_A,27,C2,1571237,1572079,842,3.652290956017983,4.324127024145436
4364,C2_07720C_A,958,C2,1572155,1574203,2048,53.2781641999154,63.07864088267826
4366,C2_07730W_A,825,C2,1577337,1579364,2027,46.35684760543573,54.884153507694755
4368,C2_07740W_A,3060,C2,1580583,1584782,4199,83.00213184796604,98.27030915871676
4370,C2_07750W_A,468,C2,1585672,1586235,563,94.67845305997122,112.09448053592878
4372,C2_07760W_A,1160,C2,1587535,1588641,1106,119.4583625531406,141.4326350218783
4374,C2_07770C_A,38,C2,1588820,1589116,296,14.621959638232157,17.31165769076043
4376,C2_07780W_A,7,C2,1589082,1589399,317,2.5150838760100473,2.9777315901756274
4378,C2_07790C_A,134,C2,1589416,1590141,725,21.05137593796153,24.92376009605523
4380,C2_07800W_A,207,C2,1590890,1591228,338,69.75371464915608,82.58485596607545
4382,C2_07810W_A,762,C2,1591735,1593045,1310,66.2517525175279,78.43871063612688
4384,C2_07820C_A,355,C2,1593194,1594201,1007,40.152498792281264,47.53851957730377
4386,C2_07830W_A,369,C2,1595572,1597728,2156,19.493566540453436,23.07939287686282
4388,C2_07840W_A,19,C2,1598697,1600199,1502,1.4407789790002392,1.705809146626194
4390,C2_07850C_A,1,C2,1600287,1600358,71,1.6041883072337724,1.8992774931301286
4392,C2_07860W_A,237,C2,1600857,1602221,1364,19.790085517465315,23.430456288050344
4394,C2_07870C_A,1,C2,1601234,1601776,542,0.21014274873357533,0.24879834319601316
4396,C2_07880W_A,544,C2,1602503,1603915,1412,43.88113964489889,51.9530410018825
4398,C2_07890W_A,1282,C2,1604218,1605558,1340,108.96748365748688,129.01196714902278
4400,C2_07900W_A,11681,C2,1608279,1611449,3170,419.6956393667623,496.8983243548786
4402,C2_07910C_A,64,C2,1611757,1611933,176,41.41722538676285,49.03589164081422
4404,C2_07920W_A,200,C2,1612098,1613135,1037,21.966705846402668,26.007464226082764
4406,C2_07930C_A,1591,C2,1613187,1615181,1994,90.87799166170218,107.59492723243353
4408,C2_07940C_A,373,C2,1615386,1616870,1484,28.627842951800538,33.89391229822452
4410,C2_07950W_A,479,C2,1617396,1618439,1043,52.307612790712724,61.92955729996408
4412,C2_07960C_A,420,C2,1618432,1619652,1220,39.210569935828765,46.42332364355773
4414,C2_07970W_A,1,C2,1620166,1620252,86,1.324388021088347,1.568008162933013
4416,C2_07980W_A,359,C2,1620414,1621292,878,46.57079244086745,55.13745332846678
4418,C2_07990W_A,1,C2,1621504,1621576,72,1.5819079140777477,1.8728986390588769
4420,C2_08000C_A,2079,C2,1621750,1623579,1829,129.465627032515,153.2807279843877
4422,C2_08010W_A,3543,C2,1624653,1631255,6602,61.12365665700957,72.36730554822223
4424,C2_08020C_A,466,C2,1631507,1632622,1115,47.60195007456197,56.35829160332146
4426,C2_08030W_A,8,C2,1632157,1632687,530,1.7192055820920429,2.0354521058451187
4428,C2_08040C_A,2566,C2,1633293,1633968,675,432.9787421358401,512.6248435013415
4430,C2_08050C_A,1019,C2,1634398,1636212,1814,63.980937067285666,75.75018045781239
4432,C2_08055W_A,1453,C2,1637752,1638088,336,492.5383283903502,583.140369118403
4434,C2_08060W_A,92,C2,1638309,1638518,209,50.136641257660294,59.359237249406696
4436,C2_08070C_A,588,C2,1638718,1639695,977,68.54826351115203,81.15766303295456
4438,C2_08080C_A,553,C2,1640824,1641633,809,77.85568047826898,92.17717208005962
4440,C2_08090W_A,134,C2,1641292,1641828,536,28.47434245339946,33.71217550305978
4442,C2_08100W_A,5596,C2,1642751,1643854,1103,577.8510258176733,684.1462705897462
4444,C2_08110W_A,486,C2,1644085,1645620,1535,36.06131708756257,42.69476819410307
4446,C2_08120W_A,1077,C2,1646053,1647380,1327,92.43968898963443,109.44389756381428
4448,C2_08130W_A,1820,C2,1647947,1648927,980,211.52368679668172,250.4333037370155
4450,C2_08140C_A,6340,C2,1649319,1652102,2783,259.47155034790165,307.20113933079267
4452,C2_08150W_A,10,C2,1654158,1654853,695,1.638811076454645,1.9402690937012823
4454,C2_08160C_A,1620,C2,1654999,1655677,678,272.14415796169396,322.2048632150846
4456,C2_08170W_A,361,C2,1656941,1658284,1343,30.615748698964122,36.24749175459294
4458,C2_08180C_A,983,C2,1658532,1659985,1453,77.05513732055518,91.22936963388234
4460,C2_08190W_A,785,C2,1660612,1661778,1166,76.68047624671895,90.78578994820559
4462,C2_08200W_A,266,C2,1662501,1663337,836,36.24007221341749,42.90640518571245
4464,C2_08210C_A,3,C2,1663652,1663780,128,2.6694696050061997,3.160516453411854
4466,C2_08240W_A,1236,C2,1665658,1669284,3626,38.824365441149176,45.96607713379138
4468,C2_08260W_A,44,C2,1670481,1670792,311,16.11409733697204,19.078272953500065
4470,C2_08270C_A,351,C2,1671420,1672556,1136,35.191880989940884,41.665400005542196
4472,C2_08280W_A,236,C2,1673267,1674376,1109,24.237853269620462,28.696387443542317
4474,C2_08290C_A,28172,C2,1675845,1676450,605,5303.663970890378,6279.2688150228105
4476,C2_08300C_A,310,C2,1676486,1677021,535,65.99660680787913,78.13663107251239
4478,C2_08310W_A,545,C2,1678351,1678905,554,112.04705153142748,132.65801912756376
4480,C2_08320C_A,167,C2,1679166,1679777,611,31.130705006335255,36.85717387241233
4482,C2_08330W_A,1291,C2,1681559,1682557,998,147.33617678292063,174.4385514006019
4484,C2_08340C_A,83,C2,1682884,1683324,440,21.48518566938323,25.437368788672376
4486,C2_08350C_A,5,C2,1684411,1684974,563,1.0115219344014017,1.1975906040163333
4488,C2_08360C_A,25,C2,1685485,1688250,2765,1.0298134702856947,1.219246853636882
4490,C2_08370C_A,2317,C2,1690400,1691776,1376,191.78794030385626,227.06718209473695
4492,C2_08380C_A,507,C2,1692182,1694329,2147,26.896118535395487,31.843638528274443
4494,C2_08390W_A,1222,C2,1695306,1696499,1193,116.66604016112032,138.12666710725583
4496,C2_08400C_A,13,C2,1696572,1696691,119,12.442569811569513,14.731370808059737
4498,C2_08420W_A,155,C2,1699140,1700204,1064,16.592192031116227,19.644312793136336
4500,C2_08430C_A,17,C2,1700273,1701295,1022,1.8945746446488878,2.243080170457989
4502,C2_08440W_A,7,C2,1701368,1701685,317,2.5150838760100473,2.9777315901756274
4504,C2_08450W_A,910,C2,1704611,1709302,4691,22.094778625106382,26.15909589237638
4506,C2_08460C_A,149,C2,1709508,1709996,488,34.77604119308623,41.17306680291727
4508,C2_08470C_A,100,C2,1710326,1712089,1763,6.460429371162668,7.648820306990308
4510,C2_08480W_A,973,C2,1712468,1713754,1286,86.17584823377193,102.02782819433021
4512,C2_08490W_A,531,C2,1715956,1718130,2174,27.81945877231852,32.93682648045031
4514,C2_08500W_A,2395,C2,1719320,1721818,2498,109.20104111431819,129.28848731757915
4516,C2_08510W_A,622,C2,1722519,1723238,719,98.53152159117921,116.65631801336959
4518,C2_08520C_A,4,C2,1723457,1723618,161,2.8297483183502568,3.350278310863084
4520,C2_08530C_A,100,C2,1724226,1726340,2114,5.387765837918535,6.378841154788984
4522,C2_08540C_A,167,C2,1726552,1727601,1049,18.132374412650943,21.46781052053759
4524,C2_08550C_A,381,C2,1728216,1731656,3440,12.614795900866506,14.935277751936948
4526,C2_08560W_A,446,C2,1732007,1735522,3515,14.451842656291504,17.110247822890084
4528,C2_08570W_A,534,C2,1736690,1737976,1286,47.29486429273814,55.99471763183179
4530,C2_08580W_A,81,C2,1739575,1740807,1232,7.488382268588818,8.865864336843643
4532,C2_08590W_A,2686,C2,1746839,1748440,1601,191.08578096147647,226.23586108986527
4534,C2_08600W_A,509,C2,1749986,1751044,1058,54.79561553414112,64.8752262043759
4536,C2_08610W_A,2771,C2,1751816,1753162,1346,234.47965211997,277.6120009479306
4538,C2_08620W_A,3459,C2,1753778,1755259,1481,266.0168819616712,314.95047958159023
4540,C2_08630C_A,955,C2,1755545,1756948,1403,77.5281455252929,91.78938732835948
4542,C2_08640C_A,335,C2,1757291,1757896,605,63.06713865711616,74.66828954396712
4544,C2_08650W_A,1295,C2,1758955,1759428,473,311.8331795108017,369.1946492724094
4546,C2_08660C_A,256,C2,1759736,1761676,1940,15.029756016639714,17.79446789439856
4548,C2_08670C_A,593,C2,1762253,1763524,1271,53.140157592024806,62.915248067079304
4550,C2_08680W_A,377,C2,1764313,1767426,3113,13.793545910609184,16.330857905112158
4552,C2_08690C_A,493,C2,1767421,1768830,1409,39.85195409375709,47.18268991627671
4554,C2_08700C_A,929,C2,1769650,1770171,521,203.09147131829636,240.44998880877188
4556,C2_08710W_A,313,C2,1770912,1771637,725,49.17224379538775,58.21743962735289
4558,C2_08720W_A,926,C2,1772078,1773226,1148,91.87192025034112,108.77168820847861
4560,C2_08730W_A,765,C2,1774396,1776672,2276,38.28272755158275,45.324805377575984
4562,C2_08740W_A,354,C2,1776991,1778634,1643,24.54027322824932,29.054437317305325
4564,C2_08750W_A,87,C2,1778791,1779492,701,14.135622216523554,16.735858880263628
4566,C2_08760C_A,4456,C2,1779860,1783114,3254,155.9700921602311,184.66066876660648
4568,C2_08770C_A,111,C2,1783693,1784028,335,37.73912850540108,44.68121171151804
4570,C2_08780W_A,2915,C2,1784325,1785530,1205,275.5276622461724,326.21076046944154
4572,C2_08790W_A,858,C2,1785847,1787757,1910,51.16436821993034,60.57601378350846
4574,C2_08800C_A,995,C2,1787951,1789603,1652,68.60041341678563,81.21940587298904
4576,C2_08810C_A,6605,C2,1790255,1791121,866,868.6976069501313,1028.4938531072048
4578,C2_08820C_A,80,C2,1791402,1792331,929,9.808169628727478,11.612374769622313
4580,C2_08830W_A,1762,C2,1793219,1794115,896,223.98121162004398,265.1823805196041
4582,C2_08840W_A,237,C2,1794757,1795149,392,68.86142001485379,81.52842443086907
4584,C2_08850C_A,1103,C2,1795173,1796258,1085,115.78691143262527,137.08582333594447
4586,C2_08860W_A,2351,C2,1797497,1799881,2384,112.32077031533913,132.98208826794217
4588,C2_08870C_A,32037,C2,1800507,1801664,1157,3153.7856842854226,3733.9220971184996
4590,C2_08880W_A,4,C2,1807223,1807564,341,1.336039528605253,1.5818029561552978
4592,C2_08890W_A,35,C2,1809126,1810265,1139,3.499919177766395,4.143726576319903
4594,C2_08900W_A,522,C2,1812528,1812710,182,326.6726760587806,386.76385961752095
4596,C2_08910C_A,1140,C2,1812881,1814407,1526,85.0871570036052,100.73887306287851
4598,C2_08920W_A,2373,C2,1816047,1817795,1748,154.6215438030135,183.06405599258778
4600,C2_08930W_A,1673,C2,1818186,1819019,833,228.7518603819318,270.83058639432903
4602,C2_08940C_A,588,C2,1819068,1819814,746,89.77433438390823,106.28825306058526
4604,C2_08950W_A,489,C2,1820110,1820652,542,102.75980413071835,121.66238982285041
4606,C2_08960C_A,725,C2,1820603,1821982,1379,59.880778183363624,70.895800550307
4608,C2_08970C_A,212,C2,1822232,1823080,848,28.47434245339946,33.71217550305978
4610,C2_08980C_A,468,C2,1823866,1828080,4214,12.649257017741764,14.976077964339797
4612,C2_08990C_A,801,C2,1830609,1833755,3146,28.999298544403008,34.333696856898776
4614,C2_09000C_A,138,C2,1839535,1840146,611,25.724774196851886,30.456826313729948
4616,C2_09010W_A,1180,C2,1842875,1844386,1511,88.94698635343842,105.30871500624893
4618,C2_09020W_A,919,C2,1844929,1847274,2345,44.63611209326073,52.84689004232314
4620,C2_09030W_A,265,C2,1847640,1848216,576,52.4006996538254,62.03976741882529
4622,C2_09040W_A,614,C2,1848596,1849177,581,120.36658358958532,142.50792260845924
4624,C2_09050C_A,1606,C2,1849370,1850905,1535,119.1655869189825,141.0860035385381
4626,C2_09060C_A,3839,C2,1851749,1853470,1721,254.06856636513777,300.8042806653027
4628,C2_09070C_A,1090,C2,1854294,1856705,2411,51.49238203932877,60.964365488735226
4630,C2_09080C_A,6,C2,1858791,1859419,628,1.0881914313401069,1.2883633950213929
4632,C2_09100C_A,502,C2,1860193,1862481,2288,24.98972012518624,29.5865596198182
4634,C2_09110C_A,45,C2,1862511,1862975,464,11.046081124163585,13.077999117566293
4636,C2_09120C_A,139,C2,1863726,1864559,833,19.005683558331455,22.501764201322015
4638,C2_09130C_A,671,C2,1865856,1869113,3257,23.464886443022458,27.781233973046497
4640,C2_09140C_A,3496,C2,1872612,1875896,3284,121.25006238378138,143.55391663665893
4642,C2_09150W_A,9034,C2,1880424,1882058,1634,629.7116517111646,745.546618101939
4644,C2_09160W_A,316,C2,1882409,1883422,1013,35.52968298232667,42.065340410530666
4646,C2_09170W_A,517,C2,1883670,1884461,791,74.44366649005067,88.13752078423214
4648,C2_09180W_A,225,C2,1884891,1885955,1064,24.085440045168717,28.51593792552049
4650,C2_09200W_A,11,C2,1888032,1888123,91,13.767813933511826,16.300392550930002
4652,C2_09210W_A,9,C2,1889155,1889655,500,2.050152656644761,2.427276636220304
4654,C2_09220W_A,52594,C2,1889869,1890507,638,9389.213586169852,11116.352090331824
4656,C2_09230C_A,1460,C2,1891008,1892246,1238,134.3216154506081,159.02997167840803
4658,C2_09240C_A,182,C2,1892523,1893164,641,32.33903479886866,38.28777498631438
4660,C2_09250W_A,343,C2,1893408,1894058,650,60.10276591702164,71.1586227541508
4662,C2_09260C_A,1245,C2,1894128,1894934,806,175.93328215623987,208.29607196679615
4664,C2_09270C_A,2034,C2,1895205,1896446,1241,186.6778809031894,221.01713125938304
4666,C2_09280C_A,608,C2,1896700,1898205,1505,46.01302381838372,54.47708360361553
4668,C2_09290W_A,178,C2,1898815,1899127,312,64.9799097013475,76.93291332749541
4670,C2_09300W_A,574,C2,1899244,1900299,1055,61.96880594597646,73.36791938864953
4672,C2_09310C_A,197,C2,1900351,1900848,497,45.146442360721885,53.45109516380504
4674,C2_09320C_A,2076,C2,1901073,1902836,1763,134.118513745337,158.7895095731188
4676,C2_09330C_A,4,C2,1903115,1903606,491,0.9278808131453998,1.098563763847162
4678,C2_09340W_A,3,C2,1903774,1904226,452,0.7559559943380388,0.8950135089307907
4680,C2_09350W_A,361,C2,1904445,1905677,1232,33.3741481353156,39.51329661235253
4682,C2_09360W_A,401,C2,1906142,1908715,2573,17.75081433939088,21.016062769882584
4684,C2_09370C_A,486,C2,1908759,1910822,2063,26.831857357929497,31.767556557415514
4686,C2_09380W_A,527,C2,1911130,1911897,767,78.25803636475368,92.65354101753587
4688,C2_09390W_A,1067,C2,1912239,1913105,866,140.33313347703105,166.14730374949093
4690,C2_09400C_A,3078,C2,1913246,1914592,1346,260.4577297817639,308.36872570109364
4692,C2_09410W_A,16,C2,1917972,1918328,356,5.118982912970689,6.060615820774792
4694,C2_09420W_A,1035,C2,1919179,1921308,2129,55.37049213577913,65.55585090778182
4696,C2_09430W_A,7203,C2,1921832,1923001,1169,701.7987637017496,830.8940980275094
4698,C2_09460C_A,497,C2,1930208,1933412,3204,17.667600748239114,20.91754210364633
4700,C2_09470C_A,295,C2,1936516,1939248,2732,12.298581293928024,14.560895715084385
4702,C2_09480W_A,301,C2,1939565,1940335,770,44.52351729077007,52.71358351387529
4704,C2_09490W_A,150,C2,1940851,1941816,965,17.70425437517065,20.960938136617482
4706,C2_09500W_A,371,C2,1942008,1943411,1403,30.118263863752535,35.65849497258782
4708,C2_09510C_A,627,C2,1943575,1945293,1718,41.567899227663474,49.214281817039534
4710,C2_09520C_A,1391,C2,1946179,1947759,1580,100.2729376017181,118.71806613862317
4712,C2_09530W_A,667,C2,1951210,1953171,1961,38.74020686673623,45.866437655361295
4714,C2_09540W_A,9,C2,1953454,1953601,147,6.973308355934561,8.25604298034117
4716,C2_09550C_A,2,C2,1953891,1954005,114,1.9981994704139971,2.3657667019691075
4718,C2_09560C_A,652,C2,1954790,1957033,2243,33.10792916561115,39.19810687114575
4720,C2_09570C_A,390,C2,1957829,1958539,710,62.563343982117125,74.07182223207501
4722,C2_09580W_A,767,C2,1960675,1961838,1163,75.11546229323262,88.93289290059104
4724,C2_09590C_A,1259,C2,1962052,1963068,1016,141.13857145208632,167.1009014108357
4726,C2_09600C_A,259,C2,1965926,1966426,500,58.99883756344368,69.85162764233986
4728,C2_09610W_A,247,C2,1967507,1968607,1100,25.57513667632606,30.27966308820278
4730,C2_09620W_A,536,C2,1968951,1971164,2213,27.586529697283524,32.66105028403081
4732,C2_09630C_A,67,C2,1971151,1971660,509,14.992384631652367,17.75022207233796
4734,C2_09640W_A,556,C2,1972394,1973719,1325,47.79391518215879,56.58556854249429
4736,C2_09650W_A,4791,C2,1974605,1975096,491,1111.3692439449028,1315.804748147938
4738,C2_09660W_A,572,C2,1977647,1978303,656,99.31295050819813,117.5814901692085
4740,C2_09670C_A,513,C2,1978366,1979250,884,66.09655058187296,78.2549594256546
4742,C2_09680W_A,411,C2,1979666,1980118,452,103.56597122431131,122.61685072351831
4744,C2_09690C_A,546,C2,1980286,1982229,1943,32.00615744633269,37.893665104828905
4746,C2_09700W_A,197,C2,1982608,1983588,980,22.895695768651812,27.10734111878684
4748,C2_09710C_A,946,C2,1983621,1985015,1394,77.29333704710442,91.51138601404462
4750,C2_09720W_A,3307,C2,1985611,1987776,2165,173.9762595720869,205.9790566071477
4752,C2_09730C_A,1502,C2,1987847,1988899,1052,162.61772762359692,192.53113158021213
4754,C2_09740W_A,1866,C2,1989824,1990711,887,239.60822105092848,283.68396612721335
4756,C2_09750W_A,4121,C2,1992136,1993851,1715,273.6857498552984,324.0300297331996
4758,C2_09760W_A,315,C2,1994315,1994887,572,62.72320190783797,74.26108589834845
4760,C2_09770C_A,989,C2,1994898,1997858,2960,38.055573900556844,45.05586698990016
4762,C2_09780C_A,350,C2,1998133,1998852,719,55.443782245840396,65.64262267633337
4764,C2_09790W_A,342,C2,1999375,2000892,1517,25.6775876573833,30.400959847189043
4766,C2_09800C_A,3,C2,2001195,2002058,863,0.39593523689547344,0.4687672144110282
4768,C2_09810C_A,466,C2,2003065,2004369,1304,40.70258767878573,48.189796884741895
4770,C2_09820W_A,110,C2,2009284,2011107,1823,6.872578540590106,8.136783994155953
4772,C2_09830C_A,308,C2,2012619,2012861,242,144.96028885367,171.6256207428498
4774,C2_09840W_A,106,C2,2013163,2014107,944,12.789323305340435,15.14190933612007
4776,C2_09850C_A,51,C2,2014219,2015478,1259,4.613793376086965,5.462497063243999
4778,C2_09860C_A,195,C2,2015889,2017409,1520,14.611833627402355,17.2996690081491
4780,C2_09870W_A,568,C2,2018704,2019741,1037,62.38544460378359,73.86119840207503
4782,C2_09880C_A,6121,C2,2020316,2021494,1178,591.8215625034231,700.6866765848181
4784,C2_09890W_A,617,C2,2024080,2025381,1301,54.015893293612514,63.95207466683438
4786,C2_09900C_A,658,C2,2025549,2026205,656,114.24461789229784,135.25982610373984
4788,C2_09910C_A,177,C2,2026825,2027007,182,110.76832119234514,131.14406734157322
4790,C2_09920W_A,104,C2,2027268,2027756,488,24.27320996027495,28.73824796982145
4792,C2_09930W_A,895,C2,2028006,2029757,1751,58.21710221768708,68.92609269043633
4794,C2_09940W_A,3794,C2,2031192,2032163,971,445.03256547146265,526.8959582228993
4796,C2_09950W_A,1301,C2,2034730,2036274,1544,95.97181225873756,113.62575214891393
4798,C2_09960W_A,445,C2,2036718,2037725,1007,50.33200552835257,59.59053862507091
4800,C2_09970C_A,1798,C2,2038151,2039194,1043,196.3446509346586,232.46209608629522
4802,C2_09980W_A,3149,C2,2041560,2042537,977,367.10626155887377,434.6351715829488
4804,C2_09990C_A,7371,C2,2042831,2047297,4466,187.98421694940208,222.56376680076457
4806,C2_10000C_A,95,C2,2048493,2049189,696,15.546336396970968,18.40607283213034
4808,C2_10010C_A,335,C2,2049481,2050200,719,53.06762014959009,62.82936741877622
4810,C2_10020C_A,34,C2,2050568,2051806,1238,3.128037620082655,3.70343769662046
4812,C2_10030C_A,11995,C2,2053448,2054584,1136,1202.6399215793188,1423.8645956309933
4814,C2_10040W_A,7,C2,2056151,2056465,314,2.5391133397935826,3.006181255049917
4816,C2_10050W_A,4085,C2,2057988,2062139,4151,112.08642632824552,132.7046368874962
4818,C2_10060C_A,101,C2,2062293,2063261,968,11.883919784270022,14.069957544665446
4820,C2_10070W_A,29,C2,2064740,2065882,1142,2.8923149952664953,3.424354079119908
4822,C2_10080W_A,367,C2,2066873,2068165,1292,32.35320024890898,38.30454615982334
4824,C2_10090C_A,422,C2,2068477,2071431,2954,16.271052830513977,19.264100287462732
4826,C2_10100W_A,291,C2,2071601,2073547,1946,17.031929401725066,20.164939509538325
4828,C2_10110W_A,1315,C2,2074655,2074987,332,451.12964248458184,534.1145877894411
4830,C2_10120W_A,252,C2,2075721,2076518,797,36.01271918823922,42.637230749164694
4832,C2_10130W_A,185,C2,2076975,2080109,3134,6.7233610132468415,7.960118019229175
4834,C2_10140W_A,219,C2,2081130,2082971,1841,13.548899505256886,16.041208984617253
4836,C2_10150W_A,715,C2,2084376,2085581,1205,67.58225677736303,80.01396011514603
4838,C2_10160W_A,2620,C2,2088696,2089952,1256,237.58846250925663,281.29267457967075
4840,C2_10170C_A,1482,C2,2090445,2091293,848,199.05177130159433,235.66718912988017
4842,C2_10180W_A,519,C2,2093231,2094343,1112,53.15893429249755,62.93747872693534
4844,C2_10190C_A,552,C2,2094546,2095355,809,77.71489262930285,92.01048641626205
4846,C2_10200W_A,340,C2,2095699,2096214,515,75.19438007111313,89.02632754206077
4848,C2_10210C_A,1406,C2,2096599,2097471,872,183.6464471994479,217.42806769404612
4850,C2_10220C_A,1300,C2,2099020,2100465,1445,102.46822197763129,121.31717136049195
4852,C2_10230W_A,928,C2,2102788,2104539,1751,60.36365458995934,71.4675016946647
4854,C2_10240W_A,605,C2,2107703,2108914,1211,56.90165874254888,67.36867441569336
4856,C2_10250C_A,897,C2,2109181,2111715,2534,40.31805079826253,47.734524745453236
4858,C2_10260C_A,1202,C2,2112284,2113717,1433,95.53708200693973,113.11105360691656
4860,C2_10270W_A,739,C2,2114376,2116652,2276,36.981615242640075,43.78435447585444
4862,C2_10280C_A,5206,C2,2116936,2119164,2228,266.135416180247,315.0908180770722
4864,C2_10290W_A,2607,C2,2120835,2122465,1630,182.16591601475434,215.6751939545444
4866,C2_10300C_A,306,C2,2122695,2124740,2045,17.042833820518798,20.17784978765045
4868,C2_10310C_A,119,C2,2125311,2127308,1997,6.787074115081694,8.035551096372787
4870,C2_10320C_A,24,C2,2127689,2129014,1325,2.0630466985104516,2.4425425270141425
4872,C2_10330C_A,64,C2,2129274,2129768,494,14.755934550749517,17.47027718377187
4874,C2_10340W_A,133,C2,2131033,2131848,815,18.58693274258713,22.005984500156817
4876,C2_10350C_A,10154,C2,2132111,2134138,2027,570.554461315872,675.5075087480395
4878,C2_10360C_A,813,C2,2137302,2138324,1022,90.60524624114974,107.27201050484385
4880,C2_10420W_A,55,C2,2151459,2152997,1538,4.073052886702134,4.82228778327253
4882,C2_10430C_A,675,C2,2156597,2158927,2330,32.99601915200796,39.06561109796627
4884,C2_10440C_A,736,C2,2159273,2162185,2912,28.787247315524727,34.082638970126375
4886,C2_10450W_A,176,C2,2162387,2162893,506,39.61647645690359,46.90389635208317
4888,C2_10460C_A,1002,C2,2162911,2164833,1922,59.37833743664154,70.30093622074068
4890,C2_10470C_A,681,C2,2165301,2166059,758,102.32732037343024,121.15035101627288
4892,C2_10480W_A,1879,C2,2166474,2167502,1028,208.1840057196015,246.47929093482227
4894,C2_10490C_A,4,C2,2167627,2167722,95,4.795678728993593,5.677840084725858
4896,C2_10500W_A,1,C2,2168360,2168447,87,1.3091651702712395,1.5499850806004494
4898,C2_10530C_A,778,C2,2169608,2170894,1286,68.90525172237878,81.5803189467512
4900,C2_10540W_A,500,C2,2171151,2171960,809,70.39392448306418,83.34283189878809
4902,C2_10550C_A,2210,C2,2171966,2179213,7247,34.73343277053281,41.122620594321575
4904,C2_10560C_A,1247,C2,2179659,2180270,611,232.4550248077848,275.21494502334235
4906,C2_10570W_A,1364,C2,2181205,2184774,3569,43.52928339191578,51.53646106603927
4908,C2_10580W_A,293,C2,2184896,2185423,527,63.324344127863704,74.97280776012535
4910,C2_10590W_A,2193,C2,2186547,2187332,785,318.1871745238472,376.71745670425526
4912,C2_10600W_A,431,C2,2187377,2187721,344,142.70280927226938,168.95287955603217
4914,C2_10610W_A,1328,C2,2187993,2189639,1646,91.89289618010811,108.79652264413946
4916,C2_10620W_A,1928,C2,2189809,2190597,788,278.6727525388536,329.9343876644632
4918,C2_10630W_A,653,C2,2190690,2192378,1688,44.061008583103906,52.165996690753644
4920,C2_10640C_A,158,C2,2192388,2192990,602,29.893329618851258,35.39218424905944
4922,C2_10650W_A,53,C2,2193331,2193519,188,32.10936489425897,38.01585748217379
4924,C2_10660W_A,694,C2,2194521,2195870,1349,58.595088695802005,69.373609485911
4926,C2_10670W_A,2415,C2,2196056,2197075,1019,269.93341324812445,319.5874537385254
4928,C2_10680W_A,854,C2,2197235,2198446,1211,80.32068853906901,95.0956164479374
4930,C2_10690W_A,3356,C2,2198731,2201816,3085,123.90261688636447,146.6944064677713
4932,C2_10700C_A,530,C2,2201813,2202685,872,69.22661238670511,81.9607936542279
4934,C2_10710W_A,1317,C2,2202878,2203342,464,323.28197423385427,382.7494408407735
4936,C2_10720C_A,1088,C2,2203464,2204570,1106,112.04370556708359,132.65405767569274
4938,C2_10730W_A,145,C2,2204861,2205835,974,16.95597394555615,20.07501210654484
4940,C2_10740C_A,1073,C2,2205832,2208582,2750,44.44068283999654,52.61551173059367
4942,C2_10750C_A,1596,C2,2208732,2210936,2204,82.4774057270881,97.64906007782834
4944,C2_10760C_A,646,C2,2211080,2213146,2066,35.61360159708819,42.16469578891891
4946,C2_10770W_A,69,C2,2213264,2213599,335,23.459458260114182,27.774807280132833
4948,C2_10780C_A,70,C2,2213596,2215209,1613,4.942849278953409,5.852082542378636
4950,C2_10790C_A,149,C2,2215273,2215932,659,25.752212598218634,30.48931198759276
4952,C2_10800W_A,11,C2,2216095,2216185,90,13.920789643884179,16.481508023718114
4954,C2_10810W_A,231,C2,2216351,2217262,911,28.88067225789364,34.19324935765888
4956,C2_10820C_A,1217,C2,2217265,2220897,3632,38.16439952179201,45.1847109991451
4958,C2_10830W_A,283,C2,2221164,2221412,248,129.97159539212979,153.87976882848255
4960,C2_10840W_A,509,C2,2221521,2223911,2390,24.25680386406749,28.718823985033353
4962,C2_10850C_A,805,C2,2223908,2225521,1613,56.842766707964216,67.29894923735431
4964,C2_10860C_A,1133,C2,2225780,2226865,1085,118.93614746433767,140.8143588754534
4966,C2_10870W_A,249,C2,2227315,2228484,1169,24.260432064658566,28.723119590288743
4968,C3_00010C_A,96,C3,3828,4880,1052,10.393676332799805,12.30558497450091
4970,C3_00020W_A,1,C3,3999,4823,824,0.13822496336601678,0.16365133739349405
4972,C3_00030C_A,839,C3,4903,8097,3194,29.9185639554191,35.42206042212543
4974,C3_00040W_A,1,C3,5971,7002,1031,0.11047271562909586,0.13079408536589635
4976,C3_00050C_A,24,C3,12190,12501,311,8.789507638348388,10.406330701909127
4978,C3_00060W_A,16,C3,13756,14265,509,3.5802709568125057,4.238859002349363
4980,C3_00090W_A,2847,C3,15901,16308,407,796.7218964602287,943.2782669013385
4982,C3_00100W_A,282,C3,16407,17105,698,46.015842818674194,54.48042115680721
4984,C3_00110C_A,1681,C3,17074,19533,2459,77.86152039717689,92.1840862474884
4986,C3_00120W_A,1,C3,17482,18108,626,0.18194468021341506,0.215413262000382
4988,C3_00130C_A,765,C3,19602,21179,1577,55.251419091567755,65.41487447010967
4990,C3_00140W_A,1,C3,19605,20204,599,0.1901458594550882,0.22512304175665962
4992,C3_00150W_A,1,C3,20107,20643,536,0.21249509293581686,0.25158339927656553
4994,C3_00160C_A,749,C3,21254,22687,1433,59.531842282194546,70.48267816271256
4996,C3_00170C_A,347,C3,22745,23092,347,113.89736981359783,134.84870201223913
4998,C3_00180C_A,480,C3,23211,24971,1760,31.062919040072135,36.776918730610674
5000,C3_00190W_A,1,C3,24430,24810,380,0.29972992056209957,0.35486500529536613
5002,C3_00200C_A,3203,C3,25109,26203,1094,333.46734507582624,394.8084026921407
5004,C3_00210C_A,422,C3,26343,26975,632,76.05172478059856,90.04138014108374
5006,C3_00220W_A,10825,C3,28278,30170,1892,651.6591058309708,771.5312892613575
5008,C3_00230C_A,1,C3,29708,30205,497,0.22916975817625318,0.2713253561614469
5010,C3_00240C_A,2411,C3,30220,31575,1355,202.66166687866004,239.9411221782351
5012,C3_00250C_A,1250,C3,31718,32992,1274,111.75173647331027,132.30838109521108
5014,C3_00260C_A,1566,C3,33094,34464,1370,130.1921760059082,154.14092507384413
5016,C3_00270C_A,1079,C3,34558,36054,1496,82.14923932411234,97.2605277213944
5018,C3_00280C_A,1088,C3,36189,38813,2624,47.225738703199106,55.91287644409914
5020,C3_00290W_A,4214,C3,39195,40520,1325,362.23661614679344,428.8697587015666
5022,C3_00300W_A,1302,C3,40606,42942,2336,63.48218129165428,75.15967894689012
5024,C3_00310C_A,500,C3,42951,43340,389,146.39764757531856,173.32738047845646
5026,C3_00320W_A,8245,C3,45115,45879,764,1229.1672959595735,1455.271659804858
5028,C3_00330W_A,1794,C3,46161,48251,2090,97.76645045243757,115.75051263634305
5030,C3_00340W_A,196,C3,48422,48775,353,63.24046595882487,74.87350026741889
5032,C3_00350W_A,251,C3,48915,49538,623,45.88802539841582,54.329091821945454
5034,C3_00360W_A,484,C3,51706,52413,707,77.97217396008678,92.3150944468511
5036,C3_00370C_A,539,C3,52683,53342,659,93.1573328217439,110.29355141820469
5038,C3_00380C_A,413,C3,53465,55492,2027,23.206518861872674,27.475339877185377
5040,C3_00390W_A,93,C3,55651,56463,812,13.044895803774136,15.444494195983053
5042,C3_00400C_A,1268,C3,56493,59342,2849,50.69212528032365,60.016902124085355
5044,C3_00410C_A,41,C3,59698,60243,545,8.568425985977084,10.144581252296888
5046,C3_00420W_A,779,C3,59837,62410,2573,34.4835021705374,40.82671545570706
5048,C3_00430W_A,67,C3,62513,63145,632,12.07456293909977,14.29566935889244
5050,C3_00440W_A,95,C3,63282,63911,629,17.202305456743712,20.36665610677697
5052,C3_00450C_A,1651,C3,63988,65094,1106,170.02220394416824,201.29765553544917
5054,C3_00460W_A,5931,C3,65437,66054,617,1094.8546197154762,1296.252271693015
5056,C3_00470W_A,990,C3,66463,67896,1433,78.68694774282056,93.16135030852527
5058,C3_00480C_A,2727,C3,68046,68837,791,392.66514220187275,464.89558835319355
5060,C3_00490W_A,1767,C3,70068,71693,1625,123.85024766807838,146.63240397269325
5062,C3_00500C_A,339,C3,71714,72883,1169,33.02926293140263,39.10497004460998
5064,C3_00510W_A,223,C3,73019,74104,1085,23.409321169062046,27.71544751034961
5066,C3_00520W_A,411,C3,74279,74863,584,80.1572243037478,94.90208309422992
5068,C3_00530C_A,295,C3,74962,76422,1460,23.01350965411737,27.246826776445577
5070,C3_00540C_A,249,C3,77128,77889,761,37.267339137432145,44.12263705788113
5072,C3_00550C_A,2101,C3,78180,80270,2090,114.49682965472203,135.55843202282986
5074,C3_00560C_A,984,C3,81718,83028,1310,85.55344419586281,101.29093341988036
5076,C3_00570C_A,540,C3,83705,85030,1325,46.41855071648516,54.957206857818214
5078,C3_00580W_A,534,C3,88912,92647,3735,16.284121949253347,19.279573460384388
5080,C3_00590W_A,1,C3,90951,91517,566,0.2012321021441658,0.23824859012763094
5082,C3_00600W_A,15,C3,95652,97187,1535,1.1130036138136596,1.3177397590772555
5084,C3_00610W_A,194,C3,97647,98375,728,30.351771626151077,35.93495630545932
5086,C3_00620C_A,249,C3,98473,98888,415,68.3384218881587,80.90922120734348
5088,C3_00630W_A,1116,C3,99338,103045,3707,34.289038228210195,40.59648002310733
5090,C3_00640W_A,737,C3,103831,105315,1484,56.56493366079623,66.9700090182077
5092,C3_00650W_A,131,C3,107369,108898,1529,9.75837504616175,11.553420512494
5094,C3_00660W_A,369,C3,109086,112745,3659,11.486233796451929,13.599117530067296
5096,C3_00670C_A,605,C3,113161,115300,2139,32.215011097347684,38.140937221788064
5098,C3_00680C_A,1,C3,113161,113604,443,0.25710467226545786,0.30439887587412895
5100,C3_00690C_A,373,C3,116945,118288,1343,31.633446716658227,37.4523945275988
5102,C3_00700W_A,463,C3,118533,122573,4040,13.053089659330643,15.454195304867998
5104,C3_00710W_A,2525,C3,123503,126820,3317,86.7020979135769,102.65088109162008
5106,C3_00720W_A,6293,C3,133119,135806,2687,266.74958996537816,315.81796865017515
5108,C3_00730W_A,292,C3,137630,139981,2351,14.146334319681229,16.74854146642868
5110,C3_00740W_A,1,C3,138354,138815,461,0.24706587812060268,0.292513453388805
5112,C3_00750W_A,875,C3,140432,143014,2582,38.5980629693641,45.69814649911279
5114,C3_00760W_A,8324,C3,143568,144977,1409,672.8755900130507,796.6505291340515
5116,C3_00770C_A,1578,C3,145178,145921,743,241.89777868890633,286.39468610405567
5118,C3_00780W_A,510,C3,146262,147626,1364,42.586259974292446,50.41996922745011
5120,C3_00790W_A,197,C3,148259,150694,2435,9.21469480627465,10.909730717211954
5122,C3_00800W_A,1242,C3,155046,157730,2684,52.70511673192568,62.4001817806263
5124,C3_00810C_A,10327,C3,157966,160686,2720,432.43313899449447,511.97887708837993
5126,C3_00820W_A,836,C3,162847,165159,2312,41.18434306408642,48.76017079681311
5128,C3_00830C_A,526,C3,165325,167637,2312,25.912636903958678,30.67924621904748
5130,C3_00840C_A,114,C3,167936,168433,497,26.125352432092864,30.93109060240495
5132,C3_00850C_A,4824,C3,168880,171330,2450,224.26159672685552,265.51434224777205
5134,C3_00860W_A,388,C3,173043,173678,635,69.593983445159,82.39574233188783
5136,C3_00870W_A,6,C3,174371,174697,326,2.096270610066218,2.4818779511455054
5138,C3_00880W_A,13936,C3,175316,178306,2990,530.8607845225082,628.5122111179145
5140,C3_00890C_A,433,C3,178624,180774,2150,22.93840052525017,27.157901381999782
5142,C3_00900C_A,499,C3,181128,182009,881,64.51167711349072,76.37854972089367
5144,C3_00910W_A,343,C3,183121,185799,2678,14.58804997985962,17.271510377221066
5146,C3_00920W_A,1199,C3,187453,188250,797,171.346231375789,202.86523677876377
5148,C3_00930W_A,5341,C3,189352,190149,797,763.2695761285145,903.6724183781294
5150,C3_00940W_A,2269,C3,191169,192854,1685,153.37277869854807,181.58558152271252
5152,C3_00950C_A,276,C3,193060,194184,1124,27.967681555652142,33.11231472898398
5154,C3_00960W_A,310,C3,194324,195466,1142,30.917849949400466,36.60516429404039
5156,C3_00970W_A,2,C3,196070,196140,70,3.2542105661027954,3.8528200574925466
5158,C3_00980W_A,3759,C3,198697,201123,2426,176.47988999559536,208.94322789118172
5160,C3_00990C_A,83,C3,201335,202591,1256,7.5266574001024065,8.911180148897966
5162,C3_01000W_A,2239,C3,202840,206472,3632,70.21371448586056,83.12947241338198
5164,C3_01010W_A,6,C3,206574,206882,308,2.2187799314337244,2.6269227664721906
5166,C3_01020W_A,603,C3,209718,211511,1793,38.30458114757362,45.350678925476956
5168,C3_01030W_A,549,C3,211924,213378,1454,43.00526549357993,50.916050484676255
5170,C3_01040C_A,89,C3,213598,215352,1754,5.7792850133467555,6.842379976675759
5172,C3_01050C_A,1,C3,214825,215352,527,0.21612404139202626,0.2558798899662981
5174,C3_01060W_A,208,C3,216483,216692,209,113.35240632166676,134.20349291170209
5176,C3_01070C_A,209,C3,216964,219954,2990,7.961388057204665,9.425879170755175
5178,C3_01080W_A,362,C3,220263,220553,290,142.17533749145662,168.32837975320885
5180,C3_01090W_A,186,C3,221731,221955,224,94.57549457736249,111.97258292087713
5182,C3_01100W_A,117,C3,222887,223546,659,20.221536067057585,23.941271829183574
5184,C3_01110C_A,59,C3,223626,225776,2150,3.1255557297684993,3.7004992645219104
5186,C3_01120W_A,174,C3,226014,227075,1061,18.678739253125375,22.114678746587757
5188,C3_01130C_A,8129,C3,227408,230062,2654,348.85897483599734,413.03131072249124
5190,C3_01140W_A,474,C3,231342,232058,716,75.40133141291254,89.27134742151026
5192,C3_01150C_A,1279,C3,232663,233589,926,157.31612958055254,186.25430871884865
5194,C3_01160W_A,2601,C3,236495,238651,2156,137.4058714680742,162.68157418081353
5196,C3_01170W_A,646,C3,239217,240671,1454,50.603645735615,59.91214683624929
5198,C3_01180C_A,395,C3,240894,244154,3260,13.800448182935934,16.339029845041242
5200,C3_01190C_A,514,C3,248165,249589,1424,41.11183151979586,48.67432081059755
5202,C3_01200W_A,920,C3,249962,257464,7502,13.967685980873101,16.53703090525993
5204,C3_01210C_A,684,C3,257541,258550,1009,77.21090282705741,91.41378808361898
5206,C3_01220W_A,355,C3,259791,260798,1007,40.152498792281264,47.53851957730377
5208,C3_01230C_A,156,C3,260834,261466,632,28.113907738799472,33.285439104286866
5210,C3_01240C_A,24,C3,261805,261893,88,31.062919040072142,36.776918730610674
5212,C3_01250W_A,11853,C3,264875,268510,3635,371.3962928199657,439.714350743073
5214,C3_01260C_A,270,C3,269315,271492,2177,14.125994418774193,16.72446005663967
5216,C3_01270W_A,55,C3,273811,274278,467,13.414037130081118,15.881538780884693
5218,C3_01280W_A,359,C3,274498,275166,668,61.211311022577284,72.47108386585906
5220,C3_01290W_A,5,C3,275345,275761,416,1.368958771798051,1.6207776684163357
5222,C3_01300C_A,1875,C3,275604,276449,845,252.73085017810175,299.22049263070807
5224,C3_01310W_A,994,C3,277446,280040,2594,43.64455882602785,51.67294132620111
5226,C3_01320C_A,1750,C3,280383,282077,1694,117.66257212148538,139.30651034322224
5228,C3_01330W_A,609,C3,285386,288133,2747,25.25063640934878,29.895471250620176
5230,C3_01340W_A,69,C3,288691,290076,1385,5.674309398655777,6.718094179671118
5232,C3_01350C_A,320,C3,290231,291043,812,44.88566298072821,53.142345620586845
5234,C3_01360C_A,572,C3,291479,293269,1790,36.39625448792065,43.0913170675982
5236,C3_01370C_A,49,C3,294348,295271,923,6.046555927265758,7.158815166413561
5238,C3_01390C_A,1146,C3,296783,300166,3383,38.58302861554334,45.6803465876518
5240,C3_01400W_A,700,C3,301408,302595,1187,67.16778337785888,79.52324465759678
5242,C3_01410C_A,840,C3,302676,303515,839,114.03312353208844,135.00942752119292
5244,C3_01420C_A,1834,C3,304687,305070,383,545.398893572163,645.7245939698342
5246,C3_01430W_A,209,C3,306714,307373,659,36.1222310941456,42.76688728460998
5248,C3_01440C_A,46,C3,307532,307839,307,17.066055411809447,20.20534297251791
5250,C3_01450C_A,207,C3,307886,311137,3251,7.252154891238005,8.586183117974008
5252,C3_01460C_A,3217,C3,311442,312674,1232,297.4089599759288,352.11710582254324
5254,C3_01470W_A,521,C3,315066,315707,641,92.57492928687125,109.6040152080758
5256,C3_01480C_A,388,C3,315941,316663,722,61.20800483057613,72.46716950242212
5258,C3_01490W_A,2305,C3,317330,317890,560,468.80970967918404,555.0468895325199
5260,C3_01500C_A,1500,C3,318169,320031,1862,91.75405731492845,108.6321444781733
5262,C3_01510W_A,1155,C3,320814,322712,1898,69.3105701447342,82.06019537625721
5264,C3_01520C_A,638,C3,322839,323900,1061,68.48871059479306,81.0871554041551
5266,C3_01530C_A,1785,C3,324169,332661,8492,23.940980348242128,28.34490498019864
5268,C3_01540W_A,15344,C3,335765,336352,587,2977.242320987811,3524.9037200609832
5270,C3_01550C_A,6554,C3,336811,338214,1403,532.0622678248897,629.9347063351497
5272,C3_01560W_A,1201,C3,342573,344876,2303,59.39676124452063,70.32274907368614
5274,C3_01570W_A,241,C3,345322,347031,1709,16.06159515803223,19.016113039759876
5276,C3_01580W_A,158,C3,347678,349027,1349,13.340092239101896,15.793991784976857
5278,C3_01590W_A,288,C3,349149,350831,1682,19.50204667438536,23.089432924806697
5280,C3_01600W_A,999,C3,351734,352816,1082,105.16032573362685,124.50448549928548
5282,C3_01610W_A,4161,C3,353503,354663,1160,408.5577205123971,483.7115940283853
5284,C3_01620W_A,372,C3,354930,355490,560,75.66039566188999,89.57806633670171
5286,C3_01630W_A,3067,C3,355874,357804,1930,180.9964938954946,214.29065755001935
5288,C3_01640C_A,34,C3,358102,359031,929,4.1684720922091785,4.935259277089484
5290,C3_01660W_A,443,C3,360108,360458,350,144.16152807835383,170.67992854691983
5292,C3_01670W_A,939,C3,360537,361334,797,134.190251260939,158.8744431486732
5294,C3_01680C_A,406,C3,362632,363738,1106,41.81042689359921,49.5014222576574
5296,C3_01690W_A,1018,C3,365248,366450,1202,96.46216511667438,114.20630503199621
5298,C3_01700W_A,1222,C3,367274,369532,2258,61.63976346865214,72.97834980467502
5300,C3_01710C_A,228,C3,369832,371523,1691,15.356948738912067,18.181847462324377
5302,C3_01720C_A,3622,C3,372130,375795,3665,112.56105687990488,133.2665753583438
5304,C3_01730C_A,7836,C3,376289,377701,1412,632.0820041496833,748.3529950197634
5306,C3_01740C_A,10,C3,379671,380057,386,2.9507090625284413,3.4934896894362466
5308,C3_01750C_A,810,C3,381920,384757,2837,32.51916445153834,38.501039347872286
5310,C3_01760W_A,2074,C3,385547,387934,2387,98.96235651168911,117.16640468093169
5312,C3_01770C_A,284,C3,388103,389974,1871,17.28853716037509,20.46875006492566
5314,C3_01780C_A,86,C3,390197,390463,266,36.823961669057944,43.59770065057355
5316,C3_01790C_A,594,C3,390676,394428,3752,18.03172645769646,21.34864845289713
5318,C3_01800C_A,532,C3,395037,396632,1595,37.989592940961785,44.97774888433305
5320,C3_01810C_A,4282,C3,399010,400305,1295,376.6089092987073,445.8858239508941
5322,C3_01820W_A,329,C3,402434,405034,2600,14.412397949489883,17.06354729308718
5324,C3_01830C_A,1034,C3,405200,406585,1385,85.03240461174019,100.67404901130344
5326,C3_01840C_A,1,C3,407931,408004,73,1.5602379426520252,1.847242493318344
5328,C3_01850W_A,588,C3,408919,409974,1055,63.48024023734174,75.15738083715318
5330,C3_01860C_A,2228,C3,410208,411830,1622,156.45088775875215,185.22990633986976
5332,C3_01870C_A,1,C3,412026,412100,74,1.5391536461297004,1.8222797569221505
5334,C3_01880W_A,360,C3,412494,414257,1763,23.25754573618561,27.535753105165107
5336,C3_01890C_A,3596,C3,414635,416522,1887,217.05084358754522,256.9771767016491
5338,C3_01900C_A,820,C3,418351,420147,1796,52.00213989262262,61.56789290091095
5340,C3_01910C_A,668,C3,422590,422757,167,455.5894792543914,539.3948080489565
5342,C3_01920C_A,1,C3,423654,423768,114,0.9990997352069986,1.1828833509845538
5344,C3_01930W_A,2894,C3,425210,427384,2174,151.61866984386023,179.5088057145446
5346,C3_01940C_A,651,C3,427510,428097,587,126.31548168424565,149.55111586025157
5348,C3_01950C_A,248,C3,428436,429026,590,47.87550459961401,56.68216626955136
5350,C3_01960C_A,10474,C3,429483,431612,2129,560.3386808020779,663.4125433894751
5352,C3_01970C_A,22,C3,433673,434200,527,4.754728910624578,5.629357579258558
5354,C3_01980C_A,263,C3,435718,435888,170,176.205930946919,208.61887428952286
5356,C3_01990W_A,1231,C3,436119,437363,1244,112.7071239875715,133.43951139635558
5358,C3_02000W_A,879,C3,437485,441483,3998,25.041467750413332,29.647826180279683
5360,C3_02010C_A,54,C3,441503,442610,1107,5.555969259199895,6.577985464011665
5362,C3_02020W_A,909,C3,442844,445369,2525,41.003053132895225,48.54553272440608
5364,C3_02030W_A,703,C3,445556,446539,983,81.45457881888024,96.43808495890549
5366,C3_02040C_A,455,C3,446602,447222,620,83.58597300836617,98.96154744446581
5368,C3_02050C_A,1,C3,447502,447595,93,1.224702901221482,1.4499860431423561
5370,C3_02060W_A,381,C3,448127,449398,1271,34.14232722185742,40.4227816417491
5372,C3_02070C_A,73,C3,449448,450614,1166,7.130795880268132,8.442500211743958
5374,C3_02080W_A,775,C3,451391,453976,2585,34.14718050504384,40.42852768258619
5376,C3_02090C_A,597,C3,453985,454926,941,72.26007415379162,85.55225834357783
5378,C3_02100W_A,555,C3,456047,457429,1382,45.74026067043908,54.154145887693716
5380,C3_02110W_A,4201,C3,457757,458254,497,962.7421540984396,1139.8378212342386
5382,C3_02120W_A,1004,C3,459265,460465,1200,95.29413274404352,112.82341401690672
5384,C3_02130W_A,1169,C3,460854,463085,2231,59.679975487268436,70.6580603551356
5386,C3_02140C_A,4935,C3,463157,464374,1217,461.85991785546867,546.8186889321282
5388,C3_02150C_A,65341,C3,464995,466125,1130,6585.989416805573,7797.477024939572
5390,C3_02160C_A,1738,C3,467068,469592,2524,78.42853753408599,92.85540574376846
5392,C3_02170C_A,3699,C3,470417,471970,1553,271.2854932005785,321.18824774196554
5394,C3_02180C_A,416,C3,472269,473408,1139,41.59903937002345,49.251150164259414
5396,C3_02190C_A,1193,C3,473862,474284,422,321.98948385692466,381.21919786872337
5398,C3_02200W_A,46,C3,474569,474745,176,29.7686307467358,35.24454711683523
5400,C3_02210C_A,764,C3,474790,477275,2485,35.01713904933149,41.45851442146909
5402,C3_02220W_A,2686,C3,478901,480400,1499,204.08828240114997,241.63016251159056
5404,C3_02230C_A,885,C3,480639,484418,3779,26.67350417703998,31.580074432609585
5406,C3_02240C_A,797,C3,484858,486369,1511,60.07690518956815,71.12800496608509
5408,C3_02250C_A,5,C3,488396,488884,488,1.1669812480901418,1.3816465370106468
5410,C3_02260C_A,1532,C3,489073,490833,1760,99.14248326956357,117.37966561519906
5412,C3_02270W_A,182,C3,492474,492698,224,92.54161297354825,109.56457038494429
5414,C3_02280C_A,9479,C3,493362,495503,2141,504.2658423461438,597.0251501046308
5416,C3_02290W_A,618,C3,497382,498554,1172,60.058510703757214,71.10622682897933
5418,C3_02300W_A,111,C3,499465,502809,3344,3.7806842252719384,4.47613813497564
5420,C3_02310W_A,2326,C3,504690,506297,1607,164.8570517650458,195.18237764808228
5422,C3_02320W_A,2350,C3,507101,509152,2051,130.50161826521452,154.50728899500825
5424,C3_02330C_A,33,C3,509669,510601,932,4.032846785245417,4.774685800862545
5426,C3_02340W_A,166,C3,511298,512449,1151,16.426553769815154,19.448205503068365
5428,C3_02350W_A,1397,C3,512751,514754,2003,79.43815558142595,94.05074224218575
5430,C3_02360C_A,176,C3,514904,516670,1766,11.351040253223793,13.43905524017785
5432,C3_02370C_A,1601,C3,517634,520423,2789,65.38174581268201,77.40866687758867
5434,C3_02390W_A,288,C3,524126,525751,1625,20.186118465425338,23.899339187399917
5436,C3_02400C_A,1624,C3,526430,526759,329,562.2168041862702,665.6361461029675
5438,C3_02410C_A,646,C3,527091,528625,1534,47.964602933236115,56.78765417203812
5440,C3_02420C_A,231,C3,529159,531802,2643,9.95470769085929,11.785868393805234
5442,C3_02430W_A,1024,C3,532621,534945,2324,50.185415959175636,59.41698401916216
5444,C3_02440C_A,195,C3,535056,535970,914,24.29976708276978,28.76969025425233
5446,C3_02450W_A,414,C3,536423,536868,445,105.96294629849328,125.45474749003819
5448,C3_02460C_A,137,C3,537128,538135,1007,15.495471364908544,18.345851217156664
5450,C3_02470C_A,1976,C3,538836,539411,575,391.41078739420755,463.41049595858175
5452,C3_02480C_A,1273,C3,539890,540990,1100,131.8103197933728,156.05672514689127
5454,C3_02490C_A,1267,C3,542174,546082,3908,36.92629671285273,43.71886014572849
5456,C3_02500W_A,505,C3,547221,547778,557,103.26422218288494,122.25959518165307
5458,C3_02510C_A,47,C3,548135,549352,1217,4.398665884337796,5.20779703744884
5460,C3_02520W_A,1,C3,550994,551065,71,1.6041883072337724,1.8992774931301286
5462,C3_02530W_A,205,C3,551544,551732,188,124.19660006269977,147.04246761972882
5464,C3_02540C_A,845,C3,552298,553335,1037,92.80933220105128,109.88153635519966
5466,C3_02550C_A,107,C3,553678,554376,698,17.459911991482763,20.671649162334653
5468,C3_02560W_A,247,C3,554571,556037,1466,19.190075268730332,22.720074622798816
5470,C3_02570W_A,1460,C3,556571,558802,2231,74.53615415860727,88.2470214871668
5472,C3_02580C_A,112,C3,558799,559533,734,17.37943517591684,20.576368699415234
5474,C3_02590W_A,1026,C3,559817,563116,3299,35.42246178501103,41.938395957731835
5476,C3_02600C_A,343,C3,563328,564209,881,44.34369789564593,52.500686481496054
5478,C3_02610C_A,4857,C3,565145,565855,710,779.1542608234433,922.4790784133033
5480,C3_02620C_A,177,C3,567608,567961,353,57.11001262608163,67.61535483333236
5482,C3_02630C_A,1656,C3,568695,569963,1268,148.74924638116565,176.11155404752992
5484,C3_02640C_A,2840,C3,570176,572692,2516,128.56459867671617,152.21395616643844
5486,C3_02650W_A,41,C3,572852,573178,326,14.324515835452488,16.95949933282762
5488,C3_02660W_A,165,C3,576543,577301,758,24.79296308607341,29.35360927707052
5490,C3_02670W_A,240,C3,577678,578433,755,36.20578643081256,42.865812560181965
5492,C3_02680C_A,6253,C3,578561,580315,1754,406.04347402760965,480.73485386689345
5494,C3_02690C_A,1174,C3,580798,582558,1760,75.9747228188431,89.95021372861859
5496,C3_02700W_A,309,C3,583141,586854,3713,9.47866611160833,11.222259337942873
5498,C3_02710W_A,4379,C3,588383,589213,830,600.9115450768012,711.4487543513194
5500,C3_02720W_A,378,C3,590432,591784,1352,31.84408712244082,37.701782071469225
5502,C3_02730C_A,1,C3,591928,592015,87,1.3091651702712395,1.5499850806004494
5504,C3_02740C_A,2,C3,592024,592096,72,3.1638158281554953,3.7457972781177538
5506,C3_02750W_A,245,C3,593790,595292,1502,18.578465781845185,21.995960048600924
5508,C3_02760C_A,1235,C3,595659,599300,3641,38.63313697330221,45.7396723386749
5510,C3_02770C_A,636,C3,599619,600962,1343,53.93799493778722,63.85984696931056
5512,C3_02780W_A,4310,C3,601266,602642,1376,356.75702318067346,422.38219889008036
5514,C3_02790W_A,195,C3,603064,603378,314,70.73244303710695,83.74362067639053
5516,C3_02800W_A,21,C3,604119,604895,776,3.082274183099942,3.6492561111559554
5518,C3_02810C_A,5206,C3,605101,607257,2156,275.02305531057067,325.6133314822435
5520,C3_02820C_A,1230,C3,609991,610995,1004,139.53562238120054,165.20309111061167
5522,C3_02830W_A,821,C3,612045,615218,3173,29.470450872033982,34.89151728712522
5524,C3_02840W_A,136,C3,615473,616045,572,27.080493522114175,32.061929149763145
5526,C3_02850C_A,375,C3,616015,617427,1412,30.24894736550934,35.81321760240061
5528,C3_02860W_A,370,C3,618110,619654,1544,27.294058828388085,32.314779627285276
5530,C3_02870C_A,359,C3,619691,621118,1427,28.653928355348018,33.92479609137621
5532,C3_02880W_A,6,C3,621776,622186,410,1.6667907777599686,1.9733956392034993
5534,C3_02890C_A,1,C3,622287,622697,410,0.2777984629599947,0.3288992732005832
5536,C3_02900W_A,3,C3,622956,624053,1097,0.31147867770354926,0.36877493713465576
5538,C3_02910W_A,5,C3,624195,624851,656,0.8681201967499835,1.0278102287518225
5540,C3_02920W_A,1516,C3,625101,625490,389,443.87766744836586,525.5286176106799
5542,C3_02930W_A,104,C3,625968,626501,533,22.223877036799582,26.31194185604666
5544,C3_02940C_A,2254,C3,626532,627116,584,439.59704034220806,520.4605724924435
5546,C3_02950C_A,3471,C3,628092,629936,1844,214.391415739153,253.82854917813557
5548,C3_02960C_A,876,C3,630423,634766,4343,22.973542702443407,27.199507935234045
5550,C3_02970C_A,760,C3,634951,635871,920,94.08913158514603,111.39675383619753
5552,C3_02980C_A,11,C3,636147,636803,656,1.9098644328499637,2.26118250325401
5554,C3_02990C_A,1,C3,636945,638042,1097,0.10382622590118308,0.12292497904488524
5556,C3_03000W_A,1,C3,638299,638709,410,0.2777984629599947,0.3288992732005832
5558,C3_03010C_A,222,C3,638810,639382,572,44.20492324933343,52.33638434740749
5560,C3_03020W_A,16,C3,639381,639884,503,3.6229779662377046,4.289421932794883
5562,C3_03030C_A,698,C3,639619,641031,1412,56.303374029668056,66.66033569726835
5564,C3_03040W_A,1756,C3,641788,643371,1583,126.34477662203273,149.58579957895884
5566,C3_03050C_A,474,C3,644041,646302,2261,23.877644091837848,28.269918068908154
5568,C3_03060W_A,259,C3,651582,652064,482,61.20211365502457,72.46019464973014
5570,C3_03070W_A,734,C3,652782,654299,1517,55.109208598009765,65.24650446735895
5572,C3_03080W_A,317,C3,654514,655764,1250,28.884372984728415,34.197630830303844
5574,C3_03090W_A,265,C3,656093,657952,1859,16.23604249629017,19.222649829609125
5576,C3_03100C_A,550,C3,658005,659477,1472,42.556761818939414,50.38504490946434
5578,C3_03110W_A,899,C3,660875,662410,1535,66.70601658789867,78.9765362273635
5580,C3_03120C_A,76,C3,663210,664787,1577,5.489029870534837,6.498732627095862
5582,C3_03130C_A,1,C3,665661,667181,1520,0.07493248014052489,0.08871625132384153
5584,C3_03140C_A,32,C3,667510,669222,1712,2.128922800254165,2.520536486210077
5586,C3_03150W_A,1125,C3,670712,673711,2999,42.72575559863207,50.58512496291064
5588,C3_03160C_A,154,C3,673704,674318,614,28.567092754550604,33.82198714964955
5590,C3_03170W_A,1081,C3,674583,675479,896,137.41412585770007,162.69134695896258
5592,C3_03180C_A,660,C3,675607,676530,923,81.44340636725306,96.4248573435296
5594,C3_03190C_A,549,C3,676936,678345,1409,44.37874806789583,52.542184105549524
5596,C3_03200C_A,121,C3,678753,678989,236,58.396532828158215,69.13852942152938
5598,C3_03210W_A,4157,C3,680030,681031,1001,472.998367947179,560.0060482166614
5600,C3_03220C_A,2,C3,681177,681266,89,2.5594914564853446,3.030307910387396
5602,C3_03230C_A,404,C3,681408,683057,1649,27.904510251481824,33.037523112762045
5604,C3_03240C_A,14,C3,684502,684936,434,3.6741087036644466,4.349958129427068
5606,C3_03250W_A,843,C3,685105,689544,4439,21.629980345317186,25.608798332128313
5608,C3_03260W_A,1028,C3,689950,692745,2795,41.891411867040645,49.59730435369653
5610,C3_03270W_A,149,C3,693052,693507,455,37.29825956533204,44.15924527433765
5612,C3_03280C_A,372,C3,693795,694196,401,105.66040291934762,125.09655149265075
5614,C3_03290C_A,425,C3,694449,696431,1982,24.422998068001558,28.91558948294734
5616,C3_03300C_A,1042,C3,696906,698273,1367,86.81862424708775,102.78884235314788
5618,C3_03310C_A,203,C3,698460,699125,665,34.768670785203554,41.164340614262464
5620,C3_03320W_A,251,C3,699327,699560,233,122.6963082541333,145.2661983050301
5622,C3_03330C_A,669,C3,699627,701732,2105,36.198261475200454,42.856903394863636
5624,C3_03340C_A,583,C3,702202,702486,284,233.81044577932232,276.8196946237162
5626,C3_03350W_A,1,C3,703089,703182,93,1.224702901221482,1.4499860431423561
5628,C3_03360W_A,334,C3,704145,705725,1580,24.077038935279543,28.505991438030293
5630,C3_03370C_A,3695,C3,708490,709062,572,735.7531144427344,871.0943250615796
5632,C3_03380W_A,378,C3,714210,716651,2441,17.637527976050794,20.881937468507328
5634,C3_03390C_A,200,C3,716811,717320,509,44.75338696015632,52.98573752936704
5636,C3_03400C_A,603,C3,717691,718467,776,88.50530154329833,104.7857826203353
5638,C3_03410C_A,8961,C3,718781,721924,3143,324.73252653504625,384.4668211045735
5640,C3_03420C_A,3080,C3,722858,724582,1724,203.48254003821424,240.91299431420907
5642,C3_03430C_A,200,C3,725582,726181,599,38.02917189101764,45.02460835133193
5644,C3_03440C_A,306,C3,726384,728315,1931,18.048987655598623,21.36908483466865
5646,C3_03450C_A,421,C3,728899,730854,1955,24.52725968875943,29.039029947392667
5648,C3_03460C_A,2196,C3,733522,734337,815,306.8940173136943,363.346932047702
5650,C3_03470W_A,267,C3,737492,738967,1475,20.617354400156355,24.409900635435825
5652,C3_03480C_A,2434,C3,739106,740668,1562,177.48156090031827,210.12915537630602
5654,C3_03490W_A,1521,C3,743259,744101,842,205.7457238556797,243.59248902685948
5656,C3_03500W_A,2325,C3,745852,748008,2156,122.8253176329383,145.418938858282
5658,C3_03510C_A,794,C3,748403,750508,2105,42.96176324560413,50.86454603217001
5660,C3_03520C_A,1739,C3,750831,751586,755,262.3410941799293,310.59853350898516
5662,C3_03530W_A,84,C3,752036,752503,467,20.486893071396615,24.25544104716935
5664,C3_03540W_A,574,C3,752749,754380,1631,40.084052895772636,47.457483111603466
5666,C3_03550C_A,341,C3,754424,755479,1055,36.81422095396859,43.58616813855312
5668,C3_03560W_A,381,C3,755825,757297,1472,29.48022955093803,34.90309474637439
5670,C3_03570C_A,94,C3,757464,758735,1271,8.42356629620629,9.973074735759619
5672,C3_03580C_A,173,C3,759278,760178,900,21.89360553083603,25.920917164574856
5674,C3_03590W_A,496,C3,761498,762349,851,66.38436595481144,78.59571821159884
5676,C3_03600C_A,216,C3,762417,763243,826,29.784300096534057,35.263098831287714
5678,C3_03610W_A,64,C3,763787,765499,1712,4.25784560050833,5.041072972420154
5680,C3_03620C_A,1,C3,765496,765804,308,0.369796655238954,0.43782046107869843
5682,C3_03630W_A,1,C3,765830,767350,1520,0.07493248014052489,0.08871625132384153
5684,C3_03640W_A,303,C3,768366,769943,1577,21.883895404895462,25.909420868553237
5686,C3_03650W_A,1032,C3,770431,771831,1400,83.95863260545212,99.40275748330768
5688,C3_03660W_A,2048,C3,772084,774000,1916,121.74416147090207,144.13890486485687
5690,C3_03670W_A,534,C3,774527,776536,2009,30.274363106252487,35.843308548798255
5692,C3_03680W_A,1324,C3,777344,779113,1769,85.24596813635021,100.926897379426
5694,C3_03690W_A,212,C3,779861,780721,860,28.077026047072955,33.24177305417987
5696,C3_03700C_A,18,C3,781934,782260,326,6.288811830198654,7.445633853436515
5698,C3_03710W_A,362,C3,782645,783583,938,43.95612779586612,52.041823164638124
5700,C3_03720W_A,1509,C3,784714,785540,826,208.07642984106434,246.3519265574683
5702,C3_03730C_A,544,C3,785608,786459,851,72.80865943430932,86.20175545788258
5704,C3_03740W_A,235,C3,787084,787413,329,81.35526415256989,96.32050143731367
5706,C3_03750C_A,1812,C3,787516,789564,2048,100.77247758898403,119.3094961162975
5708,C3_03760W_A,1685,C3,791640,793373,1733,110.74268213266726,131.11371199689725
5710,C3_03770C_A,342,C3,793475,794341,866,44.98025459151324,53.25433728427919
5712,C3_03780W_A,1,C3,793920,794360,440,0.2588576586672678,0.30647432275508896
5714,C3_03790W_A,863,C3,794780,795814,1034,95.06134443823494,112.54780448410287
5716,C3_03800W_A,3097,C3,797737,799467,1730,203.89604295532513,241.402560769887
5718,C3_03810W_A,354,C3,799968,802067,2099,19.208989477853088,22.7424680859136
5720,C3_03820C_A,416,C3,802124,803323,1199,39.51735266259942,46.786538813253934
5722,C3_03830W_A,401,C3,803446,804522,1076,42.446882244658674,50.25495307333447
5724,C3_03840C_A,822,C3,804528,805997,1469,63.73290536880696,75.45652352216511
5726,C3_03850C_A,619,C3,806218,806934,716,98.46713954555456,116.58009294074863
5728,C3_03860W_A,129,C3,807802,808329,527,27.88000133957139,33.00850580565246
5730,C3_03870C_A,15763,C3,808654,810288,1634,1098.7541250745062,1300.8690880164781
5732,C3_03880C_A,926,C3,811840,812883,1043,101.12077128225465,119.72185816235228
5734,C3_03890W_A,2333,C3,813612,817613,4001,66.41403743442234,78.6308477367043
5736,C3_03900C_A,1670,C3,817866,818258,392,485.22603976711326,574.4829907154065
5738,C3_03910W_A,696,C3,818804,819202,398,199.17731002578918,235.81582060431765
5740,C3_03920W_A,315,C3,819467,819682,215,166.8728906571317,197.56902852955963
5742,C3_03930W_A,471,C3,819740,820771,1031,52.032649061304156,61.60401420733717
5744,C3_03940C_A,1,C3,822151,822279,128,0.8898232016687331,1.0535054844706182
5746,C3_03970W_A,1,C3,826066,826155,89,1.2797457282426723,1.515153955193698
5748,C3_03980C_A,258,C3,826496,828007,1511,19.44773091456535,23.02512582340019
5750,C3_03990C_A,678,C3,828580,830493,1913,40.36718072849939,47.79269208797602
5752,C3_04000C_A,7931,C3,832411,835089,2678,337.3114413710398,399.35961749778505
5754,C3_04010C_A,5,C3,835704,835800,96,5.932154677791554,7.023369896470788
5756,C3_04020C_A,1049,C3,836183,839419,3236,36.92161339136716,43.71331533091435
5758,C3_04030C_A,535,C3,841090,843573,2483,24.540915364589146,29.05519757412321
5760,C3_04040W_A,3,C3,844399,845358,959,0.3563004269455616,0.4218416121342204
5762,C3_04050W_A,1,C3,845662,845734,72,1.5819079140777477,1.8728986390588769
5764,C3_04060C_A,5526,C3,846209,847180,971,648.1945062718245,767.4293793199108
5766,C3_04070C_A,3682,C3,848680,853218,4538,92.412982735493,109.41227871508691
5768,C3_04080W_A,3025,C3,854961,855487,526,655.0181438899875,775.5082197471927
5770,C3_04090W_A,4131,C3,856852,857700,848,554.8467390329866,656.9103632223582
5772,C3_04100W_A,127,C3,858695,859174,479,30.19825880235266,35.75320491765004
5774,C3_04110C_A,934,C3,859230,861788,2558,41.58723354413619,49.23717266592312
5776,C3_04120C_A,300,C3,862452,863414,962,35.51893029530078,42.05260977512655
5778,C3_04130W_A,926,C3,863945,864979,1034,102.00093273442127,120.76392462604781
5780,C3_04140C_A,1652,C3,865042,865578,536,351.04189352996946,415.6157756048862
5782,C3_04150W_A,1691,C3,865874,866186,312,617.3091421628012,730.8626766112062
5784,C3_04160W_A,164,C3,867053,868633,1580,11.822258638879775,13.996953879751402
5786,C3_04170W_A,52,C3,869575,869979,404,14.66005750076012,17.356763625337706
5788,C3_04180W_A,2595,C3,870556,871371,815,362.6548155414557,429.3648855481724
5790,C3_04190W_A,414,C3,872065,872355,290,162.59831414768794,192.50814701057584
5792,C3_04200W_A,1125,C3,872655,873911,1256,102.01794668813501,120.78406828325558
5794,C3_04210W_A,63,C3,874795,875313,518,13.852382815167305,16.400517812299352
5796,C3_04220C_A,605,C3,875584,877221,1637,42.09401877655876,49.83718064594055
5798,C3_04230W_A,475,C3,877509,880106,2597,20.832210497288788,24.664279343786514
5800,C3_04240C_A,5,C3,881322,881645,323,1.7631171797770562,2.0874412076198006
5802,C3_04250W_A,1169,C3,883024,884100,1076,123.74165921198502,146.50384075493264
5804,C3_04260W_A,1205,C3,885203,886766,1563,87.80955254343277,103.96205113547545
5806,C3_04270C_A,169,C3,886986,887941,955,20.155660207851348,23.863278157139696
5808,C3_04290C_A,783,C3,890865,892955,2090,42.67064141820436,50.519872572049394
5810,C3_04300C_A,611,C3,893246,897658,4412,15.77318516684231,18.674650256001385
5812,C3_04310C_A,108,C3,898103,898993,890,13.82125386502086,16.363662716091937
5814,C3_04320W_A,581,C3,899511,900371,860,76.94694402523297,91.10127426640804
5816,C3_04330C_A,2126,C3,900521,900976,455,532.1885895026572,630.084264786858
5818,C3_04340W_A,1444,C3,901780,903258,1478,111.27726793696567,131.7466344422688
5820,C3_04350C_A,215,C3,903462,904355,893,27.422099115255918,32.466372824895195
5822,C3_04360W_A,493,C3,905118,907424,2306,24.350131534303443,28.82931920730004
5824,C3_04370C_A,843,C3,907472,910834,3362,28.559037106740924,33.8124496717185
5826,C3_04380C_A,875,C3,911155,911535,380,262.26368049183714,310.5068796334453
5828,C3_04390W_A,1366,C3,912024,912804,780,199.46641944278804,236.1581114727162
5830,C3_04400C_A,794,C3,913107,915428,2321,38.96359829039065,46.13092175687974
5832,C3_04410C_A,1412,C3,915591,918926,3335,48.22281444581714,57.09336349063917
5834,C3_04420W_A,1804,C3,919600,922284,2684,76.55396987471332,90.63601282789844
5836,C3_04430W_A,5041,C3,922611,923421,810,708.835359543638,839.2250701774042
5838,C3_04440C_A,64,C3,923719,925423,1704,4.277835485956726,5.064739981680343
5840,C3_04450C_A,25,C3,925625,926464,839,3.3938429622645363,4.018137723845028
5842,C3_04460W_A,883,C3,927344,930337,2993,33.60219764296923,39.783295648782875
5844,C3_04470W_A,1979,C3,931012,934305,3293,68.4491025997905,81.04026154941428
5846,C3_04480C_A,461,C3,934439,935401,962,54.58075622044554,64.62084368777779
5848,C3_04490W_A,967,C3,939148,940800,1652,66.6699495216399,78.93383465244263
5850,C3_04500C_A,6150,C3,941278,942286,1008,694.9095479698677,822.7376164437209
5852,C3_04510W_A,306,C3,942851,943153,302,115.40594424821504,136.63477753558004
5854,C3_04520C_A,1620,C3,943416,945122,1706,108.15576734937193,128.0509362601567
5856,C3_04530C_A,930,C3,949762,951993,2231,47.478509155825186,56.212143824017204
5858,C3_04540C_A,652,C3,958062,960341,2279,32.58494300941895,38.57891782008771
5860,C3_04550C_A,3218,C3,960570,961817,1247,293.9228035767104,347.9896736771335
5862,C3_04560W_A,2109,C3,962464,965664,3200,75.06548529277433,88.87372266994134
5864,C3_04570C_A,89,C3,965801,967807,2006,5.053273137293225,5.982818783195056
5866,C3_04580C_A,811,C3,968946,970256,1310,70.51203581589913,83.48266971902741
5868,C3_04590W_A,1279,C3,973774,975360,1586,91.85040100352563,108.7462105130226
5870,C3_04600C_A,197,C3,975446,975751,305,73.56649787960254,87.09899769315118
5872,C3_04610W_A,186,C3,976463,978352,1889,11.21488130509751,13.277849959913434
5874,C3_04620C_A,353,C3,978529,978939,410,98.06285742487815,116.10144343980588
5876,C3_04630W_A,597,C3,980490,981581,1091,62.32514186866903,73.78980302594569
5878,C3_04640W_A,932,C3,985016,988408,3392,31.29491411151922,37.05158911421193
5880,C3_04650W_A,224,C3,989048,990181,1133,22.518103122900193,26.660290600831036
5882,C3_04660C_A,59,C3,990298,991251,953,7.051358676812459,8.348450596770313
5884,C3_04670C_A,1934,C3,991751,992554,803,274.3181982808197,324.77881655251616
5886,C3_04680W_A,1676,C3,993011,993346,335,569.8268412166865,674.6460435000381
5888,C3_04690C_A,386,C3,993464,994486,1022,43.017988990262985,50.93111445863434
5890,C3_04700W_A,276,C3,994723,995823,1100,28.57788551686637,33.834765232161814
5892,C3_04710W_A,68,C3,995983,996873,890,8.702270952050172,10.303046895317147
5894,C3_04720C_A,767,C3,996870,999467,2597,33.638537792464206,39.82632054038791
5896,C3_04730C_A,25,C3,1000090,1001517,1427,1.9953989105395555,2.3624509812936076
5898,C3_04740C_A,206,C3,1004284,1006173,1889,12.420782520699396,14.705575762054663
5900,C3_04750W_A,303,C3,1006868,1008700,1832,18.83782917768567,22.303033138487148
5902,C3_04760C_A,1166,C3,1008831,1014887,6056,21.929381308232344,25.96327386827457
5904,C3_04770C_A,484,C3,1015233,1017383,2150,25.640152088270398,30.35663803438313
5906,C3_04780C_A,676,C3,1018054,1019091,1037,74.24746576084102,87.90522908415973
5908,C3_04790W_A,539,C3,1019402,1020850,1448,42.396880061829584,50.19575302803653
5910,C3_04800C_A,736,C3,1020896,1022662,1766,47.467986513481314,56.19968554983465
5912,C3_04810C_A,4811,C3,1023134,1024411,1277,429.09964461489375,508.0321890218343
5914,C3_04820C_A,2667,C3,1024767,1030286,5519,55.03973279450362,65.16424864407351
5916,C3_04830C_A,26262,C3,1030626,1036280,5654,529.0365627953142,626.3524252291163
5918,C3_04840C_A,1102,C3,1037259,1038575,1316,95.37606499588512,112.92041764246773
5920,C3_04850C_A,1,C3,1038960,1039044,84,1.355921069209498,1.6053416906218942
5922,C3_04860W_A,3501,C3,1041331,1042668,1337,298.24584272057297,353.10793249427763
5924,C3_04870W_A,23,C3,1043577,1045197,1620,1.6170614232794753,1.9145186088157407
5926,C3_04880W_A,3765,C3,1045564,1046421,857,500.3775931717572,592.4216605321824
5928,C3_04890W_A,2075,C3,1047887,1052386,4499,52.53101630656047,62.194055718025375
5930,C3_04900W_A,989,C3,1052736,1055264,2528,44.558741592424155,52.75528729830083
5932,C3_04910C_A,6437,C3,1056652,1057164,512,1431.9479872854088,1695.3537008843423
5934,C3_04920C_A,1778,C3,1059572,1060321,749,270.373195632279,320.10813374867973
5936,C3_04930C_A,3196,C3,1060721,1062967,2246,162.07301599477233,191.8862206728033
5938,C3_04940W_A,1206,C3,1064140,1065189,1049,130.94397330333555,155.03101489681637
5940,C3_04950W_A,4220,C3,1066127,1066672,545,881.9209185566659,1044.1495825534846
5942,C3_04960W_A,2382,C3,1067838,1068640,802,338.2837093466211,400.5107334079222
5944,C3_04970C_A,1571,C3,1068899,1072126,3227,55.4486420753524,65.64837646768753
5946,C3_04980W_A,9,C3,1072322,1072663,341,3.0060889393618195,3.5590566513494197
5948,C3_04990W_A,1042,C3,1073082,1074314,1232,96.33202868974753,114.05223011100094
5950,C3_05000W_A,1799,C3,1075012,1075623,611,335.35412159519234,397.04225027826215
5952,C3_05010C_A,356,C3,1076055,1078643,2588,15.667489819799396,18.549512332440933
5954,C3_05020W_A,195,C3,1078882,1080726,1844,12.044461558379382,14.260030852704245
5956,C3_05030W_A,1070,C3,1081001,1081912,911,133.77627409500516,158.38431520647183
5958,C3_05040C_A,913,C3,1082115,1084973,2858,36.38498902722702,43.077979334210745
5960,C3_05050W_A,2504,C3,1087547,1088407,860,331.626760480522,392.62924399842643
5962,C3_05060W_A,602,C3,1089895,1091235,1340,51.16881837894471,60.581282545796974
5964,C3_05070W_A,349,C3,1091284,1092609,1325,30.000137407506152,35.518639246997324
5966,C3_05080W_A,123,C3,1093188,1094402,1214,11.539848836138827,13.662595014419614
5968,C3_05090C_A,376,C3,1094445,1096175,1730,24.754572861221263,29.30815720034792
5970,C3_05100C_A,3044,C3,1096555,1097574,1019,340.23905172972707,402.8257594948536
5972,C3_05110W_A,628,C3,1097924,1098925,1001,71.45609215078866,84.60038447920697
5974,C3_05120C_A,300,C3,1099004,1099615,611,55.92342216706931,66.21049198636945
5976,C3_05130C_A,98,C3,1099836,1100900,1064,10.490547219673486,12.420275185337815
5978,C3_05140C_A,524,C3,1101306,1102724,1418,42.089013950864086,49.83125518646918
5980,C3_05150W_A,1082,C3,1103435,1104862,1427,86.36086484815198,102.24687847038733
5982,C3_05160C_A,1549,C3,1104957,1107683,2726,64.72011219415373,76.6253262718116
5984,C3_05170W_A,545,C3,1118725,1120065,1340,46.323930260008076,54.84518104229129
5986,C3_05180W_A,374,C3,1126468,1127022,554,76.8910041701906,91.03504431873183
5988,C3_05190C_A,2928,C3,1127463,1128809,1346,247.76485796004047,293.34101002365236
5990,C3_05200W_A,2389,C3,1130252,1131056,804,338.43385134911097,400.6884939144767
5992,C3_05210C_A,1363,C3,1131286,1143771,12485,12.434290352898186,14.721568349433873
5994,C3_05220W_A,49904,C3,1146045,1150550,4505,1261.6946377753134,1493.7823807366885
5996,C3_05230W_A,76,C3,1151651,1152847,1196,7.237625506549697,8.568981064322887
5998,C3_05240C_A,3075,C3,1153146,1153934,788,444.4599139299662,526.2179678777098
6000,C3_05250C_A,1282,C3,1154421,1156208,1787,81.71036827142274,96.74092668141608
6002,C3_05270C_A,1452,C3,1158476,1160710,2234,74.02819201850674,87.64562010822344
6004,C3_05280C_A,1133,C3,1161511,1162572,1061,121.62650329764973,143.9996035625513
6006,C3_05290C_A,253,C3,1163817,1166642,2825,10.200366216934603,12.076715613839466
6008,C3_05300C_A,255,C3,1168301,1170169,1868,15.548088491684931,18.40814722329817
6010,C3_05310W_A,1785,C3,1171323,1174715,3392,59.93714773504486,70.96253923698315
6012,C3_05320W_A,779,C3,1178238,1181699,3461,25.635958129093535,30.351672599692073
6014,C3_05330C_A,65,C3,1181872,1182843,971,7.624437732115201,9.026947096596851
6016,C3_05340W_A,42,C3,1183239,1184501,1262,3.790562228344778,4.487833188996865
6018,C3_05350C_A,288,C3,1184605,1186257,1652,19.856200064356038,23.508732554191806
6020,C3_05360C_A,3112,C3,1186862,1190638,3776,93.86880690146093,111.13590059906996
6022,C3_05370C_A,4576,C3,1193027,1194203,1176,443.19248662161885,524.7173983061277
6024,C3_05380W_A,502,C3,1195336,1197177,1841,31.05729475634227,36.77025986428247
6026,C3_05390C_A,118,C3,1197250,1199196,1946,6.906418107916005,8.176848323455404
6028,C3_05400C_A,35,C3,1199156,1199485,329,12.116741469531684,14.345606597046713
6030,C3_05410W_A,2453,C3,1201743,1204085,2342,119.29557991150963,141.23990864048787
6032,C3_05420W_A,352,C3,1205701,1207458,1757,22.81836890972478,27.01579004456925
6034,C3_05430W_A,150,C3,1207783,1209570,1787,9.560495507576762,11.319141187373177
6036,C3_05440C_A,198,C3,1209706,1210995,1289,17.49548426927259,20.71376493283425
6038,C3_05450C_A,1229,C3,1216080,1217252,1172,119.43674701442983,141.40704332170807
6040,C3_05460W_A,446,C3,1226660,1228948,2288,22.202022262615664,26.286066913224932
6042,C3_05470W_A,643,C3,1229344,1232046,2702,27.104370388654115,32.09019814725009
6044,C3_05480C_A,1,C3,1232492,1232565,73,1.5602379426520252,1.847242493318344
6046,C3_05490C_A,6,C3,1232581,1232654,73,9.361427655912152,11.083454959910064
6048,C3_05500W_A,54,C3,1233522,1233619,97,63.40678319519879,75.07041142949394
6050,C3_05510W_A,369,C3,1233917,1236124,2207,19.043103516636886,22.546067531724617
6052,C3_05520C_A,2152,C3,1236311,1238911,2600,94.27197686110098,111.61323335782254
6054,C3_05530W_A,928,C3,1240041,1241453,1412,74.85606174718046,88.62577582674072
6056,C3_05540C_A,106,C3,1241446,1241769,323,37.378084211273595,44.25375360153977
6058,C3_05550C_A,369,C3,1241895,1242686,791,53.132907030616444,62.90666377056414
6060,C3_05560W_A,1326,C3,1243106,1243750,644,234.51539188327754,277.6543150127781
6062,C3_05570W_A,1389,C3,1245025,1246539,1514,104.49369000732324,123.71522265191554
6064,C3_05580C_A,7278,C3,1246780,1248546,1766,469.3913122895612,555.7354774887182
6066,C3_05590C_A,3331,C3,1250579,1251688,1109,342.10292051316,405.032485484913
6068,C3_05600W_A,148,C3,1252997,1253842,845,19.94888844072483,23.618470884983893
6070,C3_05610W_A,756,C3,1254541,1256598,2057,41.86019036416138,49.56033967975341
6072,C3_05620W_A,129,C3,1257308,1258150,842,17.449834567641474,20.65971800425041
6074,C3_05630W_A,13,C3,1258947,1259750,803,1.8439175685887572,2.1831047648307704
6076,C3_05640W_A,28,C3,1260221,1261498,1277,2.497358147831433,2.9567452281461986
6078,C3_05650W_A,3363,C3,1263720,1265207,1487,257.59035284675826,304.9738970189376
6080,C3_05660C_A,9,C3,1266051,1267238,1187,0.863585786286757,1.0224417170262443
6082,C3_05670C_A,57,C3,1269469,1269789,320,20.287968998047113,24.019925045930094
6084,C3_05680W_A,1048,C3,1269788,1270519,731,163.28925248242209,193.32618291221146
6086,C3_05700W_A,4160,C3,1275033,1277288,2255,210.11665562065056,248.76745027535023
6088,C3_05710W_A,32464,C3,1279081,1279656,575,6430.546458484592,7613.440455870141
6090,C3_05720C_A,670,C3,1279891,1282809,2918,26.151897798187303,30.962518967854763
6092,C3_05730C_A,486,C3,1283574,1284857,1283,43.14428817568866,51.080646280551996
6094,C3_05740C_A,827,C3,1286414,1287718,1304,72.23399143853175,85.52137773322221
6096,C3_05750C_A,183,C3,1288112,1288444,332,62.78077914424218,74.32925442240891
6098,C3_05760W_A,1243,C3,1289599,1290645,1046,135.34840409015501,160.24563728605472
6100,C3_05770C_A,185,C3,1290741,1292264,1523,13.835202505263034,16.38017719780974
6102,C3_05780C_A,4277,C3,1292710,1294905,2195,221.93123038394438,262.7553068366044
6104,C3_05790C_A,221,C3,1298064,1298540,476,52.88092169917043,62.60832593425388
6106,C3_05800W_A,622,C3,1298785,1300203,1418,49.96062343022416,59.150841080121815
6108,C3_05810C_A,723,C3,1300265,1302478,2213,37.210934647641764,44.05585700625797
6110,C3_05820W_A,75,C3,1305719,1305824,105,81.35526415256989,96.32050143731367
6112,C3_05830W_A,3685,C3,1306093,1308315,2222,188.88920241364,223.63522363415893
6114,C3_05840W_A,110,C3,1309841,1311451,1610,7.781807875463207,9.21326535487348
6116,C3_05850W_A,383,C3,1312151,1313869,1718,25.391555668572742,30.062312497489863
6118,C3_05860C_A,267,C3,1313895,1314956,1061,28.66220333669239,33.93459324907431
6120,C3_05870C_A,882,C3,1315290,1317704,2414,41.61453197000551,49.2694926159051
6122,C3_05880C_A,1374,C3,1318841,1320373,1532,102.15077423229988,120.94132935040246
6124,C3_05890W_A,233,C3,1321857,1323116,1259,21.078703071142414,24.95611403403631
6126,C3_05900W_A,340,C3,1323692,1324687,995,38.91970425791283,46.07895345141839
6128,C3_05910W_A,566,C3,1325453,1328761,3308,19.4878812921694,23.072661831598353
6130,C3_05920W_A,944,C3,1329263,1332589,3326,32.326854210473954,38.273353788200154
6132,C3_05930W_A,2384,C3,1333825,1336875,3050,89.02666545430074,105.40305101546821
6134,C3_05940C_A,96,C3,1336989,1337603,614,17.808057821018558,21.083836145236088
6136,C3_05950W_A,254,C3,1337786,1340074,2288,12.644201019516542,14.97009191919088
6138,C3_05960W_A,245,C3,1340442,1343162,2720,10.259138089827747,12.146298526837715
6140,C3_05970C_A,993,C3,1343332,1344948,1616,69.98767835699422,82.86185711519396
6142,C3_05980C_A,743,C3,1345603,1347867,2264,37.37886297327879,44.25467561620745
6144,C3_05990C_A,338,C3,1349838,1352354,2516,15.30099801152467,18.11560464234373
6146,C3_06000W_A,1508,C3,1362512,1364386,1874,91.65273942310863,108.51218923930449
6148,C3_06010W_A,3313,C3,1366624,1368091,1467,257.22016782034746,304.5356167461133
6150,C3_06020W_A,818,C3,1368673,1369779,1106,84.23874186936983,99.73439262749693
6152,C3_06030W_A,2007,C3,1370186,1372108,1922,118.9344543266862,140.81235428645365
6154,C3_06040W_A,524,C3,1373713,1375218,1505,39.65596131715965,46.95064442153708
6156,C3_06050C_A,311,C3,1375404,1376279,875,40.48237944231877,47.92908151520728
6158,C3_06060W_A,974,C3,1376548,1378191,1643,67.52041278055039,79.94073996343329
6160,C3_06070C_A,1219,C3,1378314,1379951,1637,84.81422956797542,100.41574083868021
6162,C3_06080W_A,1015,C3,1380538,1385430,4892,23.63160882273136,27.978624804256484
6164,C3_06090C_A,685,C3,1385507,1386664,1157,67.43275568047927,79.83695840828331
6166,C3_06100C_A,5531,C3,1387874,1389892,2018,312.1736136962387,369.5977060603046
6168,C3_06110C_A,1438,C3,1391037,1392815,1778,92.11722035542952,109.06211107626538
6170,C3_06120C_A,1681,C3,1393714,1395513,1799,106.42661403927625,126.00370654951304
6172,C3_06130W_A,7,C3,1395597,1395914,317,2.5150838760100473,2.9777315901756274
6174,C3_06140W_A,153,C3,1397002,1398207,1205,14.461657743967196,17.121868388276006
6176,C3_06150W_A,609,C3,1399074,1402343,3269,21.218567823946497,25.12170679885397
6178,C3_06160C_A,1,C3,1402376,1403161,785,0.14509219084534755,0.17178178600285235
6180,C3_06170C_A,1,C3,1404228,1405019,791,0.14399161796915022,0.1704787636058649
6182,C3_06180C_A,1,C3,1405934,1406524,590,0.1930463895145726,0.22855712205464257
6184,C3_06190C_A,187,C3,1407764,1411864,4100,5.194831257351901,6.150416408850906
6186,C3_06200C_A,236,C3,1416009,1416827,818,32.8603658630918,38.90500449252864
6188,C3_06210C_A,1137,C3,1417168,1419369,2201,58.837487268541906,69.66059708674051
6190,C3_06220C_A,62,C3,1419828,1420880,1052,6.712582631599873,7.947356962698503
6192,C3_06230W_A,1381,C3,1421438,1424542,3104,50.67405531977404,59.99550820840922
6194,C3_06240C_A,180,C3,1424631,1424843,212,96.70531399267742,114.49418095378793
6196,C3_06250W_A,724,C3,1425217,1425864,647,127.4523890958962,150.89715650210377
6198,C3_06260C_A,556,C3,1425861,1427921,2060,30.741231852602137,36.396057436313086
6200,C3_06270C_A,223,C3,1428461,1429165,704,36.07828617675045,42.71485873399052
6202,C3_06280W_A,692,C3,1429597,1430595,998,78.97492977055082,93.50230640528004
6204,C3_06290W_A,1771,C3,1431324,1433579,2255,89.45110507311831,105.90556597058779
6206,C3_06300W_A,838,C3,1434184,1438215,4031,23.677994518430907,28.033543112442665
6208,C3_06310C_A,439,C3,1438401,1441571,3170,15.773168879548722,18.674630972672865
6210,C3_06320W_A,414,C3,1446503,1451209,4706,10.019870612585956,11.863017984077134
6212,C3_06330W_A,1,C3,1452363,1452953,590,0.1930463895145726,0.22855712205464257
6214,C3_06340W_A,19,C3,1453205,1453747,542,3.9927122259379324,4.727168520724249
6216,C3_06350W_A,17,C3,1453866,1454657,791,2.4478575054755543,2.8981389812997027
6218,C3_06360C_A,2027,C3,1454762,1455369,607,380.34591204639673,450.31024543461064
6220,C3_06370C_A,421,C3,1455629,1456801,1172,40.91364564123267,48.43967879449886
6222,C3_06380W_A,1,C3,1456914,1457699,785,0.14509219084534755,0.17178178600285235
6224,C3_06390W_A,1,C3,1457202,1457699,497,0.22916975817625318,0.2713253561614469
6226,C3_06400C_A,468,C3,1457924,1458991,1067,49.95685948712633,59.14638476263159
6228,C3_06410C_A,314,C3,1459414,1460436,1022,34.993908142338285,41.43101020728286
6230,C3_06420C_A,581,C3,1460652,1461866,1214,54.509367266639494,64.53632279168939
6232,C3_06430W_A,1094,C3,1462286,1463470,1184,105.23963055411828,124.59837837955202
6234,C3_06440W_A,3139,C3,1463534,1466824,3290,108.66986135102846,128.65959745179896
6236,C3_06450W_A,466,C3,1467909,1468994,1085,48.91813302593234,57.91658538037183
6238,C3_06460C_A,4,C3,1469508,1469605,97,4.696798755199911,5.560771216999552
6240,C3_06470W_A,2483,C3,1477198,1479036,1838,153.86679502021948,182.17047176082139
6242,C3_06480C_A,780,C3,1479207,1479679,472,188.2202297767083,222.84319400327652
6244,C3_06490W_A,943,C3,1481888,1482811,923,116.36535182472673,137.77066738628548
6246,C3_06500W_A,6858,C3,1483052,1486117,3065,254.84768749809265,301.72672052200187
6248,C3_06510C_A,48,C3,1486242,1490213,3971,1.376749874352228,1.6300019381988107
6250,C3_06520C_A,279,C3,1490884,1491810,926,34.31681012742311,40.62936054148457
6252,C3_06530W_A,226,C3,1492058,1492954,896,28.72857765387624,34.013177070051384
6254,C3_06540C_A,95,C3,1492993,1493760,767,14.107236156834151,16.702251227070033
6256,C3_06550C_A,546,C3,1493769,1494794,1025,60.67118431046285,71.83160126700736
6258,C3_06560W_A,2361,C3,1496301,1497788,1487,180.84175529919605,214.1074549098161
6260,C3_06570C_A,195,C3,1498396,1499073,677,32.80648022695949,38.84120663572619
6262,C3_06580W_A,235,C3,1501918,1503543,1625,16.47131194227415,19.50119690638535
6264,C3_06590W_A,3525,C3,1504006,1505340,1334,300.9656886003991,356.3280918989077
6266,C3_06600C_A,445,C3,1505399,1507120,1721,29.450511079053477,34.86790958480326
6268,C3_06610W_A,551,C3,1508187,1509278,1091,57.522869630882134,68.10415656163498
6270,C3_06620W_A,911,C3,1510924,1514895,3971,26.12956532364332,30.936078452064933
6272,C3_06630W_A,137,C3,1515330,1517540,2210,7.060606183014889,8.35939917451437
6274,C3_06640W_A,111,C3,1517766,1518587,821,15.399035382837225,18.23167591152076
6276,C3_06650C_A,606,C3,1518671,1520230,1559,44.27312771458646,52.417134970761325
6278,C3_06660C_A,102,C3,1520428,1521507,1079,10.76694320758756,12.74751399930342
6280,C3_06670C_A,589,C3,1523520,1524584,1064,63.05032971824166,74.64838861391807
6282,C3_06680C_A,1100,C3,1525242,1526126,884,141.72749637438645,167.79815861251475
6284,C3_06690C_A,333,C3,1526530,1526895,365,103.91184698062489,123.02635005500171
6286,C3_06700C_A,7420,C3,1527476,1529317,1841,459.0540380319913,543.4966697071235
6288,C3_06710W_A,1358,C3,1533041,1535032,1991,77.68590065638669,91.97616139257696
6290,C3_06720W_A,989,C3,1535326,1537980,2654,42.443292669799646,50.250703198984354
6292,C3_06730W_A,570,C3,1538299,1539096,797,81.45734102101727,96.44135526596776
6294,C3_06740W_A,732,C3,1539368,1541332,1964,42.450547201402046,50.25929219600766
6296,C3_06750W_A,312,C3,1541633,1541839,206,172.504754280789,204.23686906708062
6298,C3_06760W_A,344,C3,1542502,1543329,827,47.376898689090275,56.091842191306235
6300,C3_06770W_A,201,C3,1543770,1544822,1052,21.761759821799586,25.76481854036128
6302,C3_06780C_A,208,C3,1544843,1546036,1193,19.85804938912687,23.510922060809502
6304,C3_06790W_A,322,C3,1548990,1550393,1403,26.140379957219178,30.948882429038484
6306,C3_06800C_A,352,C3,1550697,1551773,1076,37.26010611002457,44.114073520732504
6308,C3_06810W_A,359,C3,1552208,1554631,2423,16.875425407792665,19.979646728185656
6310,C3_06820C_A,850,C3,1554678,1556225,1547,62.58097242505376,74.0926934133182
6312,C3_06830C_A,926,C3,1556453,1560565,4112,25.649067229424027,30.367193108787312
6314,C3_06840C_A,1,C3,1560848,1560943,95,1.1989196822483983,1.4194600211814645
6316,C3_06850W_A,1971,C3,1568451,1570004,1553,144.55358396819148,171.1441028114123
6318,C3_06860C_A,2494,C3,1572462,1573310,848,334.9764626357465,396.59512124825983
6320,C3_06870W_A,39781,C3,1574865,1575872,1007,4499.455082973918,5327.126330435833
6322,C3_06880W_A,60,C3,1576153,1576956,803,8.510388778101955,10.075868145372786
6324,C3_06890W_A,2920,C3,1577290,1579599,2309,144.0365179106564,170.53192285653455
6326,C3_06900W_A,502,C3,1580008,1580706,698,81.91472728714344,96.98287737842986
6328,C3_06910C_A,1081,C3,1580822,1582753,1931,63.76129299249056,75.49013302704842
6330,C3_06920W_A,656,C3,1584075,1585043,968,77.1866473116944,91.38507078515379
6332,C3_06940W_A,2470,C3,1585276,1587105,1829,153.8143813229014,182.1084166048281
6334,C3_06950W_A,1128,C3,1591959,1594790,2831,45.38192622738904,53.7298961037816
6336,C3_06960C_A,3,C3,1595078,1595193,115,2.97123573426777,3.517792226406238
6338,C3_06970W_A,405,C3,1595830,1597650,1820,25.345293832146773,30.007540832393868
6340,C3_06980W_A,130,C3,1597909,1599021,1112,13.315339996193993,15.764686386322918
6342,C3_06990W_A,134,C3,1599406,1600539,1133,13.470650975306363,15.948566698711424
6344,C3_07000W_A,925,C3,1600835,1602568,1733,60.79346051793306,71.97637008731748
6346,C3_07010W_A,1263,C3,1603060,1604628,1568,91.74258805776407,108.61856546011352
6348,C3_07020W_A,4796,C3,1607932,1611174,3242,168.49222258667962,199.4862353024981
6350,C3_07030C_A,508,C3,1611520,1614048,2528,22.887604377099564,27.0977613220797
6352,C3_07040C_A,440,C3,1614394,1615095,701,71.49050316402717,84.64112537144823
6354,C3_07050W_A,199,C3,1615420,1615779,359,63.135310843749224,74.74900195107405
6356,C3_07060W_A,2129,C3,1616538,1617209,671,361.38226577220536,427.8582512430061
6358,C3_07070C_A,2359,C3,1617559,1618656,1097,244.9260669008909,289.9800255668843
6360,C3_07080W_A,1046,C3,1620223,1621497,1274,93.51385308086604,110.71565330047261
6362,C3_07090W_A,4343,C3,1622261,1622671,410,1206.478724635257,1428.4095435101328
6364,C3_07100C_A,1239,C3,1623757,1626420,2663,52.9924300409492,62.740346148390636
6366,C3_07110W_A,446,C3,1628166,1631963,3797,13.378516443735748,15.83948409203546
6368,C3_07120W_A,212,C3,1632270,1633007,737,32.762879783558674,38.789585924823186
6370,C3_07130W_A,129,C3,1633324,1633997,673,21.831739533364225,25.84767096519888
6372,C3_07140C_A,287,C3,1634324,1636125,1801,18.15021939839122,21.488938077463978
6374,C3_07150C_A,2019,C3,1636561,1636992,431,533.5470757625384,631.6926435329717
6376,C3_07160W_A,119,C3,1637897,1639189,1292,10.490547219673484,12.420275185337815
6378,C3_07170C_A,928,C3,1639579,1641591,2012,52.53318051044672,62.1966180255258
6380,C3_07180C_A,454,C3,1643662,1645716,2054,25.174978527445678,29.80589616044623
6382,C3_07200C_A,140,C3,1649675,1651255,1580,10.092172008799809,11.948619165641443
6384,C3_07210W_A,210,C3,1652454,1653311,857,27.90950718886295,33.043439232870725
6386,C3_07220C_A,815,C3,1653321,1654661,1340,69.2734002970763,82.01618816416037
6388,C3_07230W_A,1645,C3,1655226,1659188,3962,47.289544003878966,55.98841867999327
6390,C3_07240W_A,29,C3,1660226,1660924,698,4.732125679934581,5.602596501941167
6392,C3_07250W_A,741,C3,1661263,1662765,1502,56.190380181009324,66.52655671842156
6394,C3_07260C_A,2399,C3,1662823,1668402,5579,48.97648148105777,57.98566698823475
6396,C3_07270C_A,12393,C3,1668585,1669274,689,2048.6648825833354,2425.515187282553
6398,C3_07280C_A,878,C3,1670305,1671261,956,104.60448817608672,123.84640205726562
6400,C3_07290W_A,1432,C3,1673212,1675362,2150,75.86094584794051,89.81550757280297
6402,C3_07300W_A,595,C3,1675626,1676816,1190,56.948684906798924,67.42435100611956
6404,C3_07310C_A,10156,C3,1677116,1680709,3593,321.9431360497911,381.16432441867533
6406,C3_07320W_A,1607,C3,1682965,1687116,4151,44.09373001456318,52.2047372039673
6408,C3_07330W_A,449,C3,1687597,1688466,869,58.84915885650798,69.67441565419489
6410,C3_07340W_A,2147,C3,1688903,1689790,887,275.69070235602544,326.4037916801323
6412,C3_07350W_A,786,C3,1690050,1690943,893,100.25009257949372,118.69101879240755
6414,C3_07360W_A,470,C3,1691219,1692820,1601,33.43645459862023,39.58706430090718
6416,C3_07370W_A,2143,C3,1693663,1694244,581,420.1068218770055,497.3851435666582
6418,C3_07380W_A,922,C3,1694611,1695268,657,159.8377092361297,189.2397309821681
6420,C3_07390C_A,713,C3,1695339,1696043,704,115.35344414360124,136.5726200777365
6422,C3_07400W_A,289,C3,1696236,1697117,881,37.36247432023811,44.23527228324302
6424,C3_07410C_A,3597,C3,1697167,1698951,1784,229.64621032483828,271.88945131055164
6426,C3_07420W_A,1133,C3,1699250,1700236,986,130.8780121691748,154.9529202635567
6428,C3_07430W_A,1041,C3,1700498,1701494,996,119.04333531722426,140.9412638501415
6430,C3_07440W_A,5291,C3,1701963,1702709,746,807.8163320157456,956.4135152101303
6432,C3_07450C_A,267,C3,1702725,1703696,971,31.318844222688593,37.079921150636295
6434,C3_07460W_A,937,C3,1704278,1706584,2306,46.28006743943676,54.79324969014227
6436,C3_07470W_A,173,C3,1707692,1708939,1247,15.80131914815752,18.707959461200772
6438,C3_07480W_A,542,C3,1709297,1710637,1340,46.0689361484851,54.543280963159404
6440,C3_07490W_A,986,C3,1710784,1712634,1850,60.70421980335539,71.87071361300961
6442,C3_07500W_A,1116,C3,1713090,1714644,1554,81.79502233717837,96.84115279643427
6444,C3_07510C_A,25,C3,1714800,1714923,123,23.149871913332895,27.40827276671527
6446,C3_07520W_A,1,C3,1715652,1715724,72,1.5819079140777477,1.8728986390588769
6448,C3_07530W_A,1,C3,1715733,1715820,87,1.3091651702712395,1.5499850806004494
6450,C3_07540C_A,441,C3,1715989,1716855,866,58.00085460484602,68.67006649814948
6452,C3_07550C_A,933,C3,1719339,1721228,1889,56.25529170782784,66.60340866988835
6454,C3_07560W_A,3831,C3,1729949,1732195,2246,194.27463212639952,230.01129893539095
6456,C3_07570C_A,215,C3,1732312,1733178,866,28.27706063501563,33.47860384830417
6458,C3_07580W_A,395,C3,1733433,1733702,269,167.24706719840574,198.01203455328795
6460,C3_07590W_A,138,C3,1733947,1734279,332,47.34288263336296,56.0515689087018
6462,C3_07600W_A,268,C3,1734635,1735285,650,46.96076170776034,55.599157137353984
6464,C3_07610W_A,1439,C3,1735459,1739046,3587,45.69230977467725,54.097374462116555
6466,C3_07620C_A,431,C3,1739081,1740394,1313,37.387483922056866,44.26488238177841
6468,C3_07630C_A,1009,C3,1740463,1741461,998,115.15275164521063,136.33501035105138
6470,C3_07640C_A,7647,C3,1741637,1743169,1532,568.52035702649,673.0992325637027
6472,C3_07650C_A,192,C3,1743425,1745305,1880,11.63207181075042,13.771782333164845
6474,C3_07660W_A,496,C3,1745619,1747748,2129,26.53503777714633,31.41613724662781
6476,C3_07670W_A,609,C3,1748233,1748973,740,93.73445704929877,110.97683719655895
6478,C3_07680W_A,1049,C3,1749088,1753920,4832,24.72647784239738,29.27489412475969
6480,C3_07690C_A,289,C3,1753937,1754744,807,40.78852524923144,48.2915426041352
6482,C3_07700W_A,420,C3,1754845,1755624,779,61.40808128589358,72.70404986539208
6484,C3_07710W_A,1044,C3,1755737,1757161,1424,83.50340876783437,98.8637955763888
6486,C3_07720C_A,5,C3,1757860,1758168,308,1.84898327619477,2.189102305393492
6488,C3_07730W_A,1193,C3,1761811,1763016,1205,112.76312214740433,133.50581037394295
6490,C3_07740W_A,1604,C3,1763210,1765186,1976,92.45515241953996,109.46220547957063
6492,C3_07750W_A,1173,C3,1765306,1766643,1337,99.9264134565073,118.30779914761143
6494,C3_07760C_A,612,C3,1766636,1767562,926,75.27558350531521,89.12246828454681
6496,C3_07770C_A,272,C3,1767841,1768743,902,34.34599178414481,40.663910141163015
6498,C3_07780C_A,2077,C3,1768864,1771416,2552,92.6978201813647,109.74951178660683
6500,C3_07790W_A,883,C3,1772206,1773213,1007,99.8722716438996,118.24369799087104
6502,C3_07800C_A,491,C3,1773215,1773838,623,89.76502179530745,106.27722742858653
6504,C3_07810C_A,3214,C3,1773915,1775354,1439,254.38926100132278,301.18396682928187
6506,C3_07820W_A,162,C3,1775574,1775900,326,56.599306471787884,67.01070468092864
6508,C3_07830W_A,628,C3,1776048,1777043,995,71.88698315873312,85.11053755144339
6510,C3_07840C_A,1,C3,1776123,1776815,692,0.16459157487514137,0.19486806649167504
6512,C3_07850W_A,378,C3,1777118,1778428,1310,32.865042587435106,38.91054149666137
6514,C3_07860C_A,465,C3,1778415,1780547,2132,24.841593322384146,29.411185007359844
6516,C3_07870W_A,1,C3,1778544,1778849,305,0.37343399938884536,0.4421268918434069
6518,C3_07880C_A,78,C3,1780559,1781017,458,19.39736865821099,22.9654994693333
6520,C3_07890W_A,160,C3,1781080,1781346,266,68.5096961284799,81.11200121036939
6522,C3_07900C_A,189,C3,1781343,1782407,1064,20.23176963794172,23.95338785743721
6524,C3_07910W_A,1,C3,1782289,1783212,923,0.12339910055644403,0.1460982687023176
6526,C3_07920W_A,403,C3,1782289,1784314,2025,22.66698273327404,26.83655649922586
6528,C3_07930C_A,1,C3,1783243,1783560,317,0.3592976965728638,0.4253902271679467
6530,C3_07940W_A,421,C3,1784362,1785075,713,67.25216366272747,79.62314662994764
6532,C3_07950C_A,2952,C3,1785089,1786177,1088,309.0303636854236,365.8762576655605
6534,C3_07970C_A,67,C3,1787605,1788114,509,14.992384631652367,17.75022207233796
6536,C3_07980C_A,159,C3,1795809,1796210,401,45.16130124778568,53.46868733153621
6538,C4_00010W_A,257,C4,983,1660,677,43.23725855553124,51.190718489136565
6540,C4_00020W_A,1837,C4,2845,3891,1046,200.02817241642376,236.8231984670012
6542,C4_00030C_A,470,C4,3894,4904,1010,53.00174634890197,62.75137618391326
6544,C4_00040W_A,1716,C4,5033,7435,2402,81.36881207332802,96.33654148751138
6546,C4_00050W_A,596,C4,7507,8355,848,80.05050991616075,94.77573867841335
6548,C4_00060W_A,124,C4,8369,8995,626,22.56114034646347,26.711244488047367
6550,C4_00070C_A,4332,C4,8937,11315,2378,207.48671405908573,245.65373301809078
6552,C4_00080C_A,832,C4,11383,12630,1247,75.99247127900033,89.97122700415633
6554,C4_00090W_A,795,C4,12793,14309,1516,59.728501980085944,70.71551325839717
6556,C4_00100C_A,802,C4,14306,15706,1400,65.24692185036105,77.24904215272556
6558,C4_00110C_A,3615,C4,15792,17456,1664,247.4392980024977,292.95556356625264
6560,C4_00120W_A,2197,C4,17803,18462,659,379.71551059252573,449.56388212578054
6562,C4_00130W_A,9660,C4,19713,20438,725,1517.5842653784212,1796.742705432041
6564,C4_00140C_A,3176,C4,21178,23694,2516,143.77505823846852,170.22236788190438
6566,C4_00150C_A,3096,C4,23853,25631,1778,198.3274785955562,234.80966334639612
6568,C4_00160C_A,4861,C4,25876,27186,1310,422.6374921098466,500.3813286118277
6570,C4_00170W_A,2148,C4,27530,27943,413,592.3766352532886,701.3438545333889
6572,C4_00180W_A,1067,C4,28147,29691,1544,78.71016424294618,93.18883746571187
6574,C4_00190W_A,361,C4,29746,30663,917,44.83855016653088,53.08656644102325
6576,C4_00200C_A,2797,C4,30660,31982,1322,240.97650784314158,285.30394820592494
6578,C4_00210W_A,82,C4,32585,33277,692,13.496509139761592,15.979181452317352
6580,C4_00220C_A,2752,C4,33383,34763,1380,227.1344650195806,268.9156724186102
6582,C4_00230W_A,304,C4,34782,35390,608,56.94868490679893,67.42435100611956
6584,C4_00240C_A,354,C4,35411,36235,824,48.93163703156994,57.932573437296895
6586,C4_00250W_A,1,C4,35436,35975,539,0.21131237442225942,0.25018312061639914
6588,C4_00260W_A,1636,C4,36910,39081,2171,85.82961631278032,101.61790718195448
6590,C4_00270W_A,40573,C4,39465,41389,1924,2401.849264785398,2843.6675606770154
6592,C4_00280W_A,1232,C4,41651,43041,1390,100.95076230960616,119.52057617199898
6594,C4_00290C_A,140,C4,43184,44714,1530,10.421981551571044,12.339096916152599
6596,C4_00300C_A,881,C4,45136,48099,2963,33.86553587775218,40.095074746129825
6598,C4_00310C_A,623,C4,48304,49311,1007,70.46480773969361,83.42675407509928
6600,C4_00320C_A,557,C4,49530,50508,978,64.86792943371574,76.80033437711369
6602,C4_00330C_A,1420,C4,50924,51205,281,575.566779840957,681.4418393501052
6604,C4_00340W_A,1548,C4,51516,52568,1052,167.5980308663968,198.42755771382713
6606,C4_00350W_A,427,C4,52677,54014,1337,36.37559978340036,43.06686294631721
6608,C4_00360C_A,1655,C4,54076,55311,1235,152.63169800931533,180.70817961964028
6610,C4_00370W_A,248,C4,56577,58400,1823,15.494540709694057,18.344749368642514
6612,C4_00380W_A,501,C4,58581,59564,983,58.04942245840541,68.7275683704291
6614,C4_00390W_A,725,C4,59710,60150,440,187.67180253376918,222.19388399743946
6616,C4_00400W_A,1444,C4,60939,63332,2393,68.72870957410584,81.37130200822119
6618,C4_00410W_A,752,C4,63553,64113,560,152.94789660683136,181.08254270214968
6620,C4_00420C_A,2423,C4,64264,66699,2435,113.33606860712426,134.1841498873328
6622,C4_00430W_A,898,C4,67988,69430,1442,70.92915263010462,83.97651484534724
6624,C4_00440C_A,218,C4,69499,71742,2243,11.069829076845444,13.106115487591676
6626,C4_00450C_A,1441,C4,72788,73540,752,218.2528057199395,258.40023882930393
6628,C4_00460C_A,848,C4,74264,77572,3308,29.19739105257889,34.56822832720036
6630,C4_00470C_A,794,C4,78356,80167,1811,49.93622950413953,59.12195991039087
6632,C4_00480W_A,231,C4,81574,83547,1973,13.335171022271213,15.788165314154707
6634,C4_00490W_A,60,C4,84041,85630,1589,4.300718809827483,5.091832675100281
6636,C4_00500W_A,964,C4,86313,89231,2918,37.627506682765016,44.549057141808944
6638,C4_00510C_A,442,C4,89384,90013,629,80.03598959874444,94.75854735995182
6640,C4_00520W_A,351,C4,90446,90919,473,84.52003552763814,100.06743003445229
6642,C4_00530C_A,22,C4,91405,92481,1076,2.328756631876536,2.7571295950457815
6644,C4_00540C_A,1505,C4,93725,96778,3053,56.14659075318203,66.4747122595545
6646,C4_00550C_A,1,C4,97323,97393,70,1.6271052830513977,1.9264100287462733
6648,C4_00560C_A,483,C4,97569,98888,1319,41.70767977253052,49.37977488393594
6650,C4_00570C_A,1049,C4,99126,100499,1373,87.01991328074591,103.02715834729705
6652,C4_00580W_A,94,C4,100978,101433,455,23.53044563182021,27.85885272340764
6654,C4_00590C_A,1511,C4,101589,103595,2006,85.79208663427036,101.57347394840144
6656,C4_00600C_A,3320,C4,104411,107074,2663,141.99747194184934,168.11779597470294
6658,C4_00610W_A,371,C4,107335,108391,1056,40.01507973564849,47.37582239255749
6660,C4_00620C_A,180,C4,108410,108919,509,40.27804826414069,47.68716377643034
6662,C4_00630C_A,374,C4,109388,110002,614,69.37722526105145,82.1391116491489
6664,C4_00640W_A,16,C4,110378,110908,530,3.4384111641840858,4.070904211690237
6666,C4_00650W_A,567,C4,111275,112444,1169,55.24363446048758,65.40565786222376
6668,C4_00660W_A,605,C4,112691,113431,740,93.11879559084689,110.24792529379009
6670,C4_00670W_A,680,C4,113645,115870,2225,34.80908380820069,41.21218758126859
6672,C4_00680W_A,475,C4,116219,117580,1361,39.75110261679573,47.0632868889152
6674,C4_00690C_A,68,C4,117577,119166,1589,4.874147984471148,5.770743698446986
6676,C4_00700C_A,511,C4,119423,120388,965,60.312493238081345,71.40692925207688
6678,C4_00710W_A,328,C4,121067,123004,1937,19.28669968965415,22.834473030466924
6680,C4_00720W_A,66,C4,124043,124867,824,9.122847582157108,10.80098826797061
6682,C4_00730C_A,18,C4,125251,125643,392,5.229981266950921,6.192032235255878
6684,C4_00740W_A,177,C4,126005,126508,503,40.079193751504604,47.45173013154339
6686,C4_00750C_A,179,C4,126564,127100,536,38.03662163551122,45.033428470505235
6688,C4_00760W_A,2444,C4,131930,133819,1889,147.36112854655008,174.46809302165826
6690,C4_00770C_A,629,C4,134409,135143,734,97.60414933617581,115.55835635653733
6692,C4_00780C_A,950,C4,135543,138761,3218,33.62414584304474,39.809281203115965
6694,C4_00790C_A,150,C4,140612,142765,2153,7.935255676748572,9.394939759329247
6696,C4_00800W_A,99,C4,142969,144084,1115,10.112860638158013,11.973113452207778
6698,C4_00810C_A,190,C4,144138,145490,1352,16.00628717794644,18.950631199944848
6700,C4_00820W_A,329,C4,146312,147412,1100,34.065667880612445,40.33202087456969
6702,C4_00830W_A,704,C4,148156,149028,872,91.95383984951017,108.8686768539178
6704,C4_00840W_A,1617,C4,150338,152152,1814,101.5281405670274,120.20416270881513
6706,C4_00850C_A,194,C4,152453,154591,2138,10.334934398427494,12.236037507191016
6708,C4_00860C_A,3770,C4,155846,156343,497,863.9699883244746,1022.8965927286549
6710,C4_00870W_A,1,C4,157051,157121,70,1.6271052830513977,1.9264100287462733
6712,C4_00880W_A,853,C4,157302,158897,1595,60.9118849222564,72.11657856830092
6714,C4_00890W_A,2852,C4,159230,163885,4655,69.78201905658025,82.61836694713341
6716,C4_00900C_A,1,C4,164078,164148,70,1.6271052830513977,1.9264100287462733
6718,C4_00910C_A,579,C4,165104,166809,1705,38.678344353122085,45.793195580695865
6720,C4_00920C_A,237,C4,166683,167584,901,29.959685511456925,35.47074625627156
6722,C4_00930W_A,1,C4,168204,168274,70,1.6271052830513977,1.9264100287462733
6724,C4_00940W_A,79,C4,168441,169364,923,9.748528943959078,11.54176322748309
6726,C4_00950C_A,584,C4,169418,171475,2057,32.33644335009292,38.28470684256084
6728,C4_00960W_A,547,C4,174413,175678,1265,49.250483231650605,58.31007114679431
6730,C4_00970C_A,2185,C4,176031,191138,15107,16.473538958278365,19.503833580243757
6732,C4_00980C_A,95,C4,192152,192757,605,17.884710962465775,21.174589572169776
6734,C4_00990W_A,1010,C4,195174,196907,1733,66.37988661958097,78.59041490615206
6736,C4_01000C_A,280,C4,197113,197757,644,49.52059557112949,58.629870440103964
6738,C4_01010C_A,4787,C4,199443,200198,755,722.1545818512488,854.9943530232963
6740,C4_01020C_A,2283,C4,202398,206000,3602,72.18980990684173,85.46906904329315
6742,C4_01030W_A,7,C4,206759,207076,317,2.5150838760100473,2.9777315901756274
6744,C4_01050C_A,1338,C4,208446,208604,158,964.5232962695817,1141.9466031163033
6746,C4_01060W_A,2803,C4,209074,214572,5498,58.06735678201433,68.74880169885526
6748,C4_01070W_A,445,C4,217108,218946,1838,27.575804987514164,32.6483527722777
6750,C4_01080W_A,1188,C4,219421,222327,2906,46.56231085290924,55.127411559029625
6752,C4_01090C_A,282,C4,222373,223518,1145,28.051579290335887,33.211645386420464
6754,C4_01100C_A,6440,C4,223819,225525,1706,429.9525566234292,509.04199352803045
6756,C4_01110W_A,1,C4,227751,227822,71,1.6041883072337724,1.8992774931301286
6758,C4_01120C_A,390,C4,227963,228964,1001,44.37559862867448,52.53845532944382
6760,C4_01130C_A,297,C4,229219,229929,710,47.644392724843044,56.408541545964816
6762,C4_01140C_A,248,C4,230555,231097,542,52.11540168592669,61.70198911261126
6764,C4_01150W_A,653,C4,231131,232915,1784,41.690012605537774,49.35885785537677
6766,C4_01160W_A,153,C4,233630,233860,230,75.76651122382813,89.70370177335907
6768,C4_01170C_A,103,C4,234375,236723,2348,4.996349697955954,5.915424321661256
6770,C4_01180W_A,13,C4,240271,240573,302,4.902866912505868,5.804745450857975
6772,C4_01190W_A,2791,C4,241362,243827,2465,128.96047024330693,152.68264799844192
6774,C4_01200C_A,315,C4,244110,245339,1229,29.19257240950636,34.56252329849904
6776,C4_01210C_A,1,C4,245658,245739,81,1.4061403680691091,1.6647987902745571
6778,C4_01220C_A,205,C4,246083,248236,2153,10.844849424889716,12.839751004416637
6780,C4_01230C_A,221,C4,248784,249194,410,61.39346031415884,72.68673937732889
6782,C4_01240C_A,301,C4,249999,250601,602,56.948684906798924,67.42435100611956
6784,C4_01250W_A,213,C4,250907,251518,611,39.705629738619216,47.00944931032231
6786,C4_01260W_A,714,C4,253002,254807,1805,45.05413963817666,53.34181342755608
6788,C4_01270W_A,5141,C4,255598,256733,1135,515.8998926975388,610.7992749294461
6790,C4_01280C_A,1131,C4,256997,258274,1277,100.87543089990537,119.43138760833394
6792,C4_01290W_A,4116,C4,258895,261285,2390,196.15128625638857,232.23316212651724
6794,C4_01300W_A,5222,C4,263831,265333,1502,395.98672780732886,468.8281770358939
6796,C4_01310W_A,106,C4,266046,267944,1898,6.360970073889026,7.531065549682479
6798,C4_01320C_A,366,C4,267976,270813,2837,14.693844678102506,17.39676592755711
6800,C4_01330W_A,30,C4,272019,272348,329,10.38577840245573,12.29623422604004
6802,C4_01340W_A,65,C4,273215,273544,329,22.502519871987417,26.641840823086756
6804,C4_01350W_A,1,C4,274641,274952,311,0.36622948493118274,0.43359711257954703
6806,C4_01360W_A,594,C4,278189,278608,419,161.46787033240363,191.16975893859197
6808,C4_01370W_A,1076,C4,280487,281395,908,134.97089198175252,159.7986821202305
6810,C4_01380W_A,306,C4,283161,286751,3590,9.708243777983549,11.494067636697817
6812,C4_01390W_A,152,C4,287625,288733,1108,15.624909938327503,18.49909991503641
6814,C4_01400W_A,84,C4,291217,291654,437,21.893315936709886,25.92057429983544
6816,C4_01410W_A,1103,C4,292031,293929,1898,66.19009425943015,78.36571038962053
6818,C4_01420W_A,986,C4,294718,301869,7151,15.704489810684866,18.593318442744756
6820,C4_01430C_A,262,C4,302002,303258,1256,23.758846250925664,28.129267457967078
6822,C4_01440W_A,755,C4,303565,304920,1355,63.463110117539756,75.13709964519596
6824,C4_01450W_A,1138,C4,305252,307093,1841,70.40478373051295,83.35568869632164
6826,C4_01460C_A,293,C4,307183,307857,674,49.51324830175693,58.62117164627012
6828,C4_01470W_A,126,C4,308173,309534,1361,10.544503009928968,12.484156101059611
6830,C4_01480C_A,6,C4,309391,309812,421,1.6232404248968815,1.9218342329535265
6832,C4_01490W_A,1907,C4,309930,312554,2624,82.77526076011092,98.00170531148628
6834,C4_01500W_A,457,C4,312956,314143,1187,43.85096714811644,51.917318297888194
6836,C4_01510W_A,1244,C4,314498,315304,806,175.79197028302198,208.12876588489513
6838,C4_01520C_A,3036,C4,315673,316191,518,667.5529242356815,790.3487631450926
6840,C4_01530C_A,17168,C4,317140,318105,965,2026.3109274195315,2399.0492395296596
6842,C4_01550C_A,929,C4,320143,321435,1292,81.89679300064427,96.96164409393974
6844,C4_01560C_A,533,C4,321752,324649,2897,20.955228895632604,24.809926880401605
6846,C4_01570C_A,14,C4,325276,325380,104,15.332338244138173,18.152709886262958
6848,C4_01580C_A,15,C4,325943,326036,93,18.370543518322233,21.749790647135338
6850,C4_01590C_A,45,C4,326188,326271,83,61.75158604351691,73.11074205482844
6852,C4_01600C_A,22,C4,326439,326531,92,27.236327564121222,32.24642874205718
6854,C4_01610C_A,36,C4,326607,326699,92,44.568536014016544,52.76688339609357
6856,C4_01620C_A,28,C4,326687,326779,92,34.66441689979065,41.04090930807277
6858,C4_01630C_A,4,C4,326950,327037,87,5.236660681084958,6.1999403224017975
6860,C4_01640C_A,11,C4,327198,327290,92,13.618163782060611,16.12321437102859
6862,C4_01650C_A,394,C4,327629,329125,1496,29.997034563206917,35.514965636913246
6864,C4_01660W_A,695,C4,329466,332810,3344,23.671851680756728,28.02627030457721
6866,C4_01670C_A,384,C4,332863,334044,1181,37.03352244574223,43.84580996841645
6868,C4_01680W_A,427,C4,334467,334859,392,124.06677783266909,146.8887646919033
6870,C4_01690C_A,938,C4,334947,336305,1358,78.67137914959851,93.14291788474247
6872,C4_01700C_A,1877,C4,337230,337508,278,769.0120976263422,910.4712722193267
6874,C4_01710C_A,1438,C4,340471,340899,428,382.67387334568616,453.06643339626135
6876,C4_01720C_A,3252,C4,340871,342028,1157,320.13331601885926,379.02158940691584
6878,C4_01730C_A,583,C4,342883,345000,2117,31.36616277814244,37.13594391739982
6880,C4_01740W_A,109,C4,345376,345705,329,37.734994862255824,44.67631768794548
6882,C4_01750C_A,9089,C4,345920,346999,1079,959.4190864094446,1135.90347783989
6884,C4_01760W_A,163,C4,348098,348634,536,34.636700148538154,41.008094082080184
6886,C4_01770W_A,411,C4,349059,349838,779,60.09219382976728,71.14610593970511
6888,C4_01780C_A,753,C4,349990,350946,956,89.7120496544343,106.21451110378248
6890,C4_01790W_A,887,C4,352073,355570,3497,28.889610244398426,34.203831479798716
6892,C4_01800W_A,102,C4,356483,357208,725,16.02418168411997,18.9718173865495
6894,C4_01820C_A,929,C4,357858,358832,974,108.63517100290801,128.61852584124244
6896,C4_01830C_A,882,C4,359054,360847,1793,56.02759630540619,66.33382887607078
6898,C4_01840C_A,2447,C4,361141,361872,731,381.2679397180218,451.40187937612734
6900,C4_01850C_A,226,C4,362365,364284,1919,13.413655850897921,15.881087365693613
6902,C4_01860C_A,294,C4,364597,365901,1304,25.679314973311172,30.40300490153244
6904,C4_01870C_A,743,C4,366373,367671,1298,65.19703064060339,77.18997349390884
6906,C4_01880W_A,534,C4,367892,369211,1319,46.111596270251134,54.593788380997495
6908,C4_01890C_A,396,C4,369339,369896,557,80.97550888004442,95.87089047907844
6910,C4_01900C_A,16440,C4,370410,371408,998,1876.2252101558604,2221.3553718248604
6912,C4_01910W_A,460,C4,372264,373781,1517,34.53710620583718,40.890179911423864
6914,C4_01920W_A,365,C4,374223,374501,278,149.54151072648637,177.04955480024202
6916,C4_01930C_A,591,C4,374618,375325,707,95.20982398845307,112.72359673158886
6918,C4_01940W_A,569,C4,379679,381481,1802,35.964263831263686,42.57986206712767
6920,C4_01950W_A,824,C4,382179,383054,875,107.25878025874815,126.98894909495431
6922,C4_01960C_A,1001,C4,383106,384434,1328,85.8518578188339,101.6442399956712
6924,C4_01970W_A,637,C4,385301,386614,1313,55.25713981055737,65.42164751088829
6926,C4_01980C_A,1524,C4,386687,387364,677,256.39526085069883,303.5589687838293
6928,C4_01990W_A,76,C4,387813,388049,236,36.6788140077688,43.425853190382085
6930,C4_02000C_A,6244,C4,388211,391741,3530,201.46605584025633,238.52557942334874
6932,C4_02010C_A,1068,C4,394832,396466,1634,74.44454771170287,88.13856410591885
6934,C4_02020W_A,10867,C4,398110,400008,1898,652.119450876906,772.0763144188633
6936,C4_02030W_A,417,C4,405052,408387,3335,14.241440243559309,16.86114205070576
6938,C4_02040W_A,487,C4,408951,410384,1433,38.70761974823597,45.827856161870514
6940,C4_02050W_A,321,C4,410516,411604,1088,33.60391149831334,39.78532476647864
6942,C4_02060C_A,3301,C4,411719,413545,1826,205.90099548449425,243.77632275049362
6944,C4_02070W_A,264,C4,414417,415787,1370,21.948106299846593,25.985443307467975
6946,C4_02080W_A,67,C4,416114,417043,929,8.214342064059263,9.72536386955869
6948,C4_02090C_A,276,C4,417123,417845,722,43.539714776389204,51.54881129553739
6950,C4_02100C_A,116,C4,418036,419232,1196,11.046902088944274,13.078971098177039
6952,C4_02110W_A,388,C4,419443,419976,533,82.91215663729075,98.16378307832792
6954,C4_02120W_A,821,C4,421020,421946,926,100.98244127101925,119.55808245361588
6956,C4_02130W_A,346,C4,422279,423034,755,52.19667543775478,61.79821310759568
6958,C4_02140C_A,714,C4,423169,423444,275,295.7189892614868,350.1162663154136
6960,C4_02150C_A,192,C4,423674,426985,3311,6.604740261012017,7.819677072289312
6962,C4_02160C_A,486,C4,427566,429880,2314,23.921400920228415,28.321723931697584
6964,C4_02170C_A,588,C4,430108,431778,1670,40.10278649724283,47.479662744429106
6966,C4_02180C_A,351,C4,432066,434558,2492,16.0425268076135,18.993537081178143
6968,C4_02190C_A,89,C4,435121,436770,1649,6.1472807237175315,7.278068210484706
6970,C4_02200C_A,211,C4,437154,437594,440,54.61896597879351,64.66608210132377
6972,C4_02210W_A,62,C4,437882,438676,794,8.893749280154996,10.529747512290712
6974,C4_02220C_A,260,C4,438733,441150,2417,12.252096049456119,14.50585954620694
6976,C4_02230C_A,94,C4,442010,442921,911,11.752308191523817,13.914136102250799
6978,C4_02240C_A,28,C4,443684,444265,581,5.489029870534836,6.498732627095862
6980,C4_02250C_A,6450,C4,444629,445555,926,793.3456104726848,939.2809157439982
6982,C4_02260C_A,490,C4,446282,447397,1115,50.053552653509364,59.26086456143244
6984,C4_02270C_A,2736,C4,447754,449142,1388,224.51239467579518,265.8112742834915
6986,C4_02280W_A,1070,C4,450086,450940,854,142.70513548073734,168.9556336687305
6988,C4_02290W_A,1319,C4,451427,452587,1160,129.50916446908238,153.3322740983995
6990,C4_02300W_A,1772,C4,453463,455604,2141,94.26722994380914,111.60761324880323
6992,C4_02310W_A,982,C4,457216,460641,3425,32.656121797650535,38.66318989080842
6994,C4_02320C_A,364,C4,460935,461644,709,58.47481327524629,69.23120949570527
6996,C4_02330C_A,305,C4,462582,463040,458,75.8486851378763,89.80099151470073
6998,C4_02340W_A,3118,C4,463583,463966,383,927.2375955060002,1097.8022268254872
7000,C4_02360W_A,15202,C4,464869,468336,3467,499.413849410532,591.2806368589728
7002,C4_02370C_A,7937,C4,471021,471362,341,2651.036434634974,3138.692515751149
7004,C4_02380W_A,8,C4,479420,479728,308,2.958373241911632,3.5025636886295874
7006,C4_02390W_A,25332,C4,480535,481176,641,4501.1671951919825,5329.1533843588795
7008,C4_02400C_A,340,C4,483122,485536,2414,16.041883072337722,18.992774931301284
7010,C4_02410C_A,7914,C4,486083,486613,530,1700.7241220845535,2013.5709957072838
7012,C4_02420C_A,302,C4,487547,488344,797,43.15809997955652,51.096998754951336
7014,C4_02430W_A,813,C4,488934,493196,4262,21.726551304189357,25.72313344344214
7016,C4_02440C_A,574,C4,493509,495056,1547,42.260562555271605,50.03436002264076
7018,C4_02450W_A,230,C4,496166,497164,998,26.248892842813127,31.07735617516533
7020,C4_02460W_A,129,C4,497492,498130,638,23.029405495225898,27.26564664510791
7022,C4_02470C_A,1387,C4,498333,499070,737,214.34959556507494,253.77903621570644
7024,C4_02480C_A,200,C4,499700,500026,326,69.87568700220726,82.72926503818351
7026,C4_02490W_A,801,C4,501463,504297,2834,32.19188187039233,38.113553391603226
7028,C4_02500C_A,6960,C4,504516,508772,4256,186.26073634930472,220.5232532906918
7030,C4_02510W_A,622,C4,512431,513978,1547,45.7945468804511,54.218418003628145
7032,C4_02520C_A,214,C4,514049,515524,1475,16.524770942447415,19.5644896478774
7034,C4_02530W_A,350,C4,517316,520240,2924,13.633406099438867,16.141260500781016
7036,C4_02540W_A,615,C4,523880,526963,3083,22.72036407244978,26.899757294040565
7038,C4_02550C_A,1343,C4,527399,529291,1892,80.84786874189318,95.71977103722892
7040,C4_02560C_A,53,C4,529895,531271,1376,4.3870353198551495,5.194027039715606
7042,C4_02570C_A,67,C4,531726,533546,1820,4.192925152478602,4.964210458692318
7044,C4_02580W_A,5,C4,533914,534252,338,1.684872334520678,1.9948032842047208
7046,C4_02590C_A,431,C4,534274,536604,2330,21.068569265948785,24.94411612329402
7048,C4_02600C_A,347,C4,536885,538603,1718,23.0048820287069,27.236612106080894
7050,C4_02610C_A,80,C4,539025,541505,2480,3.674108703664446,4.349958129427068
7052,C4_02620C_A,11484,C4,543678,545906,2228,587.0724393803221,695.0639559733187
7054,C4_02630C_A,687,C4,547040,547480,440,177.835211504413,210.54785973274608
7056,C4_02640C_A,462,C4,547908,549077,1169,45.01333178261951,53.293498998848996
7058,C4_02650C_A,4,C4,549182,549268,86,5.297552084353388,6.272032651732052
7060,C4_02660W_A,132,C4,550263,551270,1007,14.929943212904584,17.676294603391824
7062,C4_02670W_A,537,C4,551536,553089,1553,39.38370095937028,46.6283019836268
7064,C4_02680C_A,15,C4,553127,553465,338,5.054617003562034,5.984409852614162
7066,C4_02690W_A,164,C4,553837,555657,1820,10.263279477708815,12.151201719784185
7068,C4_02700W_A,322,C4,555825,557594,1769,20.732025483311762,24.545665374754662
7070,C4_02710C_A,912,C4,557744,558505,761,136.49724214192014,161.60580319995015
7072,C4_02720C_A,4679,C4,558858,559796,938,568.1511656266783,672.6621286943143
7074,C4_02730C_A,19,C4,566829,567131,302,7.165728564431653,8.48385873586935
7076,C4_02740W_A,7430,C4,571822,573321,1499,564.548003812563,668.396168079344
7078,C4_02750W_A,175,C4,577303,577749,446,44.69067201206193,52.91148621556468
7080,C4_02760C_A,1690,C4,578111,579133,1022,188.3430087915659,222.98855812200011
7082,C4_02770C_A,538,C4,579389,580426,1037,59.09043872682318,69.96007876816263
7084,C4_02780W_A,2176,C4,580679,582313,1634,151.67728073096018,179.57819802853874
7086,C4_02790C_A,765,C4,582403,584097,1694,51.43535295596361,60.89684595003714
7088,C4_02800W_A,372,C4,584380,585738,1358,31.200163159542264,36.939408798639874
7090,C4_02820W_A,35,C4,586325,588797,2472,1.612624572603529,1.9092656029240975
7092,C4_02830C_A,1096,C4,588794,591091,2297,54.34545812612244,64.34226269282284
7094,C4_02840C_A,220,C4,591385,592176,791,31.678155953213057,37.50532799329027
7096,C4_02850W_A,1040,C4,592423,594816,2393,49.499901632320004,58.60536986741692
7098,C4_02860W_A,1687,C4,595171,595815,644,298.3615883160552,353.2449694016264
7100,C4_02870C_A,1949,C4,595985,597268,1283,173.0210239802823,204.84810617447704
7102,C4_02880C_A,332,C4,597479,598246,767,49.30107793756778,58.36997270933949
7104,C4_02890C_A,1113,C4,598659,598856,197,643.4912314849462,761.8609408102647
7106,C4_02900C_A,6918,C4,599268,600629,1361,578.9434271641954,685.4396183105586
7108,C4_02910W_A,18,C4,602743,603063,320,6.406727052014878,7.58523948818845
7110,C4_02920W_A,2985,C4,603218,604786,1568,216.82630669234024,256.71133641998324
7112,C4_02930W_A,1450,C4,605437,605955,518,318.82468384115225,377.47223536244536
7114,C4_02940W_A,9686,C4,606493,608439,1946,566.9115745192748,671.1945157710936
7116,C4_02950C_A,136,C4,608655,608981,326,47.51546716150094,56.25590022596479
7118,C4_02960W_A,1587,C4,609369,615065,5696,31.733694855017514,37.57108323269373
7120,C4_02970C_A,2149,C4,615198,620561,5363,45.639650891184374,54.03502901814318
7122,C4_02980W_A,1621,C4,621466,622695,1229,150.22590436765023,177.85984211703794
7124,C4_02990C_A,1063,C4,622851,623510,659,183.7221610195061,217.51770901215505
7126,C4_03000C_A,581,C4,624273,624995,722,91.65425465609466,108.51398319821458
7128,C4_03010W_A,2,C4,627397,627468,71,3.2083766144675447,3.7985549862602572
7130,C4_03020W_A,1908,C4,627762,630455,2693,80.69668830462112,95.54078107662541
7132,C4_03030C_A,891,C4,630579,633098,2519,40.28684259782282,47.697575820923
7134,C4_03040W_A,260,C4,633412,633630,218,135.8408997776855,160.8287271705604
7136,C4_03050C_A,2499,C4,633876,635618,1742,163.3923806912635,193.44828147450377
7138,C4_03070W_A,951,C4,639668,640696,1028,105.36614658826026,124.74816693933793
7140,C4_03080W_A,1254,C4,641743,644179,2436,58.63189726857623,69.41718896689157
7142,C4_03090W_A,562,C4,644883,645710,827,77.40063099787422,91.63841660323868
7144,C4_03100W_A,152,C4,646818,647795,977,17.719959274991684,20.979531940491654
7146,C4_03110W_A,2778,C4,649167,654407,5240,60.382994912628774,71.49039965458022
7148,C4_03120C_A,404,C4,654505,657207,2702,17.029806589449862,20.16242620760348
7150,C4_03130W_A,580,C4,657550,659415,1865,35.42116594739236,41.93686175179554
7152,C4_03140C_A,178,C4,659489,660385,896,22.6269328424335,26.78913946225286
7154,C4_03150W_A,762,C4,660576,663860,3284,26.428074238112533,31.28949784815049
7156,C4_03160C_A,145,C4,664007,665035,1028,16.06529048927207,19.020488124294424
7158,C4_03170W_A,305,C4,665604,666623,1019,34.09096937502193,40.36197655910985
7160,C4_03180W_A,7962,C4,668228,670270,2042,444.0993430244202,525.7910702357727
7162,C4_03190W_A,554,C4,671287,672630,1343,46.98372515021087,55.62634468710385
7164,C4_03200C_A,297,C4,672797,673672,875,38.66002152530121,45.77150228301145
7166,C4_03230C_A,892,C4,674267,678610,4343,23.393150788332782,27.696302600717775
7168,C4_03250C_A,185,C4,679262,680179,917,22.978204378970123,27.20502712351607
7170,C4_03270W_A,649,C4,680862,681752,890,83.05549776294944,98.33349169207101
7172,C4_03280W_A,5231,C4,682502,686239,3737,159.4319351070191,188.7593150190053
7174,C4_03290W_A,1428,C4,686644,689340,2696,60.32842881818165,71.42579616968747
7176,C4_03300C_A,153,C4,690179,690361,182,95.74888781033225,113.36182092237684
7178,C4_03310C_A,76,C4,692297,692497,200,43.28100052916719,51.24250676465086
7180,C4_03320W_A,793,C4,697717,698832,1115,81.00503521272024,95.9058481575835
7182,C4_03330W_A,872,C4,699714,700799,1085,91.53779398843993,108.37609968172582
7184,C4_03340C_A,1674,C4,701061,702284,1223,155.89877111035386,184.57622826532156
7186,C4_03350C_A,386,C4,702676,704019,1343,32.735952902493494,38.757705865021826
7188,C4_03360C_A,2800,C4,704421,706550,2129,149.7945680967938,177.34916187612473
7190,C4_03370C_A,360,C4,707397,707855,458,89.52631688405071,105.99461293538445
7192,C4_03380C_A,309,C4,708487,709644,1157,30.418571540537364,36.01404401191174
7194,C4_03390W_A,1312,C4,710440,711150,710,210.46950590907093,249.1852070986729
7196,C4_03400W_A,570,C4,711401,711927,526,123.42490645199766,146.1288215721983
7198,C4_03410W_A,797,C4,712320,713195,875,103.74423284735713,122.82790343286239
7200,C4_03420C_A,56,C4,713275,713581,306,20.84396310314209,24.678193832305197
7202,C4_03430W_A,2766,C4,717205,717996,791,398.28081530266957,471.5442601338222
7204,C4_03440C_A,854,C4,718927,721134,2207,44.072656919262606,52.17978772924885
7206,C4_03450C_A,721,C4,721912,723741,1829,44.89885381935705,53.15796290367654
7208,C4_03460C_A,308,C4,723995,725866,1871,18.749540300688476,22.198503591539097
7210,C4_03470C_A,13,C4,726514,727329,815,1.816767862057389,2.150960890992771
7212,C4_03480C_A,3,C4,730527,731114,587,0.5820989939366159,0.6891756491255833
7214,C4_03490C_A,12,C4,733160,733684,524,2.6083367132885003,3.088138214020743
7216,C4_03500C_A,5,C4,734839,735390,551,1.0335514502141365,1.2236724320529866
7218,C4_03510C_A,10,C4,738442,741168,2726,0.41781867136316153,0.494676089553335
7220,C4_03520C_A,58,C4,745166,747331,2165,3.0512921243365705,3.6125749268867753
7222,C4_03530W_A,207,C4,750746,752716,1970,11.96789621899226,14.169381378951012
7224,C4_03540C_A,1564,C4,752869,754629,1760,101.21334453890172,119.83146019723976
7226,C4_03550W_A,840,C4,755288,758260,2972,32.19171959738297,38.113361268600556
7228,C4_03560W_A,758,C4,758441,760756,2315,37.29339365818884,44.153484287376784
7230,C4_03570W_A,16,C4,762835,764739,1904,0.9571207547361162,1.1331823698507488
7232,C4_03580W_A,98,C4,765642,766715,1073,10.40255567729039,12.316097667473842
7234,C4_03590C_A,1363,C4,766847,769381,2534,61.26366024306782,72.53306268456272
7236,C4_03600C_A,892,C4,770572,771981,1409,72.10536115949559,85.36908601484548
7238,C4_03610C_A,1,C4,772391,772477,86,1.324388021088347,1.568008162933013
7240,C4_03620C_A,207,C4,772928,774148,1220,19.325209468372748,22.88006665289631
7242,C4_03630C_A,3,C4,780195,780265,70,4.881315849154194,5.779230086238819
7244,C4_03640C_A,2,C4,780937,781008,71,3.2083766144675447,3.7985549862602572
7246,C4_03650W_A,1,C4,782464,782535,71,1.6041883072337724,1.8992774931301286
7248,C4_03660W_A,3,C4,782619,782690,71,4.812564921701318,5.697832479390384
7250,C4_03670W_A,673,C4,782815,785400,2585,29.652970941799357,35.10761178113614
7252,C4_03680C_A,399,C4,785391,787022,1631,27.863305061695613,32.98873826050485
7254,C4_03690C_A,104,C4,787445,787858,413,28.681177870736505,33.95705813383261
7256,C4_03700W_A,620,C4,788604,790349,1745,40.46783340081986,47.91185974073826
7258,C4_03710C_A,688,C4,790413,791915,1502,52.17136513432444,61.768246993622185
7260,C4_03720C_A,602,C4,792424,793434,1010,67.88734319582763,80.37516694194846
7262,C4_03730C_A,217,C4,793991,795340,1349,18.321519087880453,21.691748211012516
7264,C4_03740W_A,291,C4,795553,796467,914,36.2627293389026,42.9332300717304
7266,C4_03750C_A,169,C4,796578,797762,1184,16.257310387244964,19.247829932490212
7268,C4_03760W_A,14,C4,798718,799368,650,2.4531741190621075,2.9044335818020737
7270,C4_03770W_A,212,C4,800107,800601,494,48.87903319935778,57.87029317124432
7272,C4_03780C_A,799,C4,800718,802052,1334,68.21888941609046,80.76770083041909
7274,C4_03790W_A,866,C4,802327,803634,1307,75.46681121543668,89.34887218255477
7276,C4_03800C_A,904,C4,803672,806206,2534,40.632684416532136,48.10703497200638
7278,C4_03810W_A,508,C4,807342,809537,2195,26.359846863465922,31.20872010123803
7280,C4_03820C_A,511,C4,809585,810853,1268,45.90028073718336,54.34360152070519
7282,C4_03830W_A,529,C4,811967,816289,4322,13.940700747661559,16.505081759480447
7284,C4_03840C_A,183,C4,816382,817305,923,22.58203540182926,26.735983172524115
7286,C4_03850W_A,807,C4,817941,819719,1778,51.69582533159362,61.20523201567884
7288,C4_03860C_A,247,C4,819831,820904,1073,26.218686247864554,31.04159310067387
7290,C4_03870C_A,57,C4,821114,821753,639,10.159859279147225,12.028757456490814
7292,C4_03880W_A,262,C4,822133,823599,1466,20.355464455090473,24.099836239567974
7294,C4_03890W_A,10480,C4,826096,828363,2267,526.5304083134122,623.3852655881192
7296,C4_03900C_A,337,C4,828649,830406,1757,21.84599523459446,25.864548991533628
7298,C4_03910W_A,842,C4,832645,834441,1796,53.39731925559542,63.21971441776466
7300,C4_03920W_A,410,C4,835077,836783,1706,27.3727559341003,32.40795300411374
7302,C4_03930C_A,208,C4,836883,837323,440,53.84239300279171,63.74665913305849
7304,C4_03940C_A,10355,C4,837701,841234,3533,333.82600181709756,395.2330340607801
7306,C4_03950C_A,114,C4,844510,844815,305,42.57147593032837,50.402465670148395
7308,C4_03960W_A,694,C4,845566,845781,215,367.6501146541251,435.2790660302044
7310,C4_03970W_A,5,C4,847183,847515,332,1.7153218345421362,2.030853945967457
7312,C4_03990C_A,132,C4,849660,850721,1061,14.170078054095114,16.776652842238985
7314,C4_04000W_A,601,C4,854022,855179,1157,59.16362943644971,70.0467328516471
7316,C4_04010W_A,410,C4,858485,861013,2528,18.47227912324965,21.87024043711157
7318,C4_04020C_A,7,C4,861270,861698,428,1.8628074502223948,2.2054694254338174
7320,C4_04030W_A,823,C4,864733,866274,1541,60.82903008214862,72.01848264508293
7322,C4_04040W_A,4,C4,866778,867194,416,1.0951670174384407,1.2966221347330682
7324,C4_04050C_A,162,C4,867681,868295,614,30.05109757296881,35.57897349508589
7326,C4_04060W_A,1,C4,869126,869491,365,0.31204758853040504,0.3694484986636688
7328,C4_04070C_A,6,C4,871065,871898,833,0.8203892183452426,0.9712991741577849
7330,C4_04080C_A,178,C4,874032,875090,1058,19.16231741665446,22.68721073551849
7332,C4_04090C_A,1457,C4,876709,878454,1745,95.09940849192668,112.5928703907349
7334,C4_04100C_A,481,C4,878813,879406,593,92.38555629062489,109.37980719711133
7336,C4_04110W_A,197,C4,880335,880472,137,163.77942958597646,193.90652771102995
7338,C4_04120C_A,593,C4,880641,882536,1895,35.64176269100978,42.198037094067445
7340,C4_04130W_A,470,C4,882875,883537,662,80.863691559503,95.73850444977703
7342,C4_04140W_A,1188,C4,884123,885214,1091,124.02390040197456,146.83799999132913
7344,C4_04150C_A,3703,C4,885458,886597,1139,370.29144900768466,438.4062717746457
7346,C4_04160W_A,1293,C4,888267,889790,1523,96.69684778002757,114.48415738793511
7348,C4_04170C_A,489,C4,890261,893062,2801,19.884260563673454,23.541954760437317
7350,C4_04180C_A,393,C4,895669,896631,962,46.52979868684402,55.088918805415766
7352,C4_04190C_A,237,C4,897092,899638,2546,10.602386742271284,12.552687500746533
7354,C4_04200C_A,1,C4,897092,898435,1343,0.08480816814117485,0.10040856441715497
7356,C4_04210C_A,118,C4,901264,901704,440,30.545203722737604,36.163970085100495
7358,C4_04220W_A,98,C4,902114,902629,515,21.673674255791436,25.66052970329987
7360,C4_04230W_A,325,C4,903067,904563,1496,24.74374678437119,29.295339675118793
7362,C4_04240C_A,1614,C4,904889,907018,2129,86.3458688957947,102.22912402430904
7364,C4_04250W_A,766,C4,908843,910558,1715,50.87194476805595,60.22979926610797
7366,C4_04260C_A,2017,C4,910696,913320,2624,87.54992184223585,103.65466156962131
7368,C4_04270W_A,132,C4,913732,914373,641,23.454684579399245,27.769155484579663
7370,C4_04280C_A,176,C4,914401,915228,827,24.239343515348512,28.69815181880784
7372,C4_04290W_A,1139,C4,915401,918079,2678,48.44253331504404,57.35349947421223
7374,C4_04300C_A,171,C4,918145,918480,335,58.138657427239494,68.83321804206832
7376,C4_04310W_A,1095,C4,918716,919537,821,151.9094031009618,179.85301912716423
7378,C4_04320W_A,4418,C4,923039,925159,2120,237.3578206775827,281.01960636324173
7380,C4_04330C_A,1204,C4,925694,926599,905,151.5275505586429,179.40092510799548
7382,C4_04340C_A,259,C4,927322,927855,533,55.346001466645106,65.52685519919312
7384,C4_04350W_A,357,C4,928087,928719,632,64.33759655609879,76.17244718096418
7386,C4_04360W_A,98,C4,929018,930820,1802,6.194196582537508,7.333614204883149
7388,C4_04370C_A,725,C4,930996,933335,2339,35.30380210126483,41.797908917859495
7390,C4_04380C_A,296,C4,935018,935302,284,118.70993473529916,140.5465344916295
7392,C4_04390W_A,1106,C4,936830,937776,946,133.1611955748829,157.65609347308296
7394,C4_04400C_A,21,C4,940284,940559,275,8.6976173312202,10.297537244570986
7396,C4_04410C_A,498,C4,944103,946157,2054,27.61484428781486,32.694573321370534
7398,C4_04420W_A,780,C4,947592,949115,1523,58.33220515732523,69.06236872590053
7400,C4_04430W_A,331,C4,949398,950015,617,61.10215463257842,72.34184824319473
7402,C4_04440W_A,942,C4,950318,951124,806,133.11578457122724,157.6023291507807
7404,C4_04450C_A,1425,C4,951265,953769,2504,64.81779232602912,76.74097458763609
7406,C4_04460C_A,1841,C4,954686,958912,4226,49.617855614489734,58.745021392459115
7408,C4_04470W_A,954,C4,960912,962273,1361,79.83695136089078,94.52289619373704
7410,C4_04480C_A,5576,C4,962661,963667,1006,631.30391061692,747.4317717895083
7412,C4_04490C_A,1,C4,963317,963411,94,1.2116741469531684,1.4345606597046716
7414,C4_04500C_A,437,C4,964068,964820,752,66.18770027731684,78.3628760363677
7416,C4_04510W_A,1309,C4,965102,969301,4199,35.50646751274103,42.03785447345106
7418,C4_04520W_A,408,C4,969500,970330,830,55.98810467945532,66.28707279637779
7420,C4_04530C_A,4991,C4,970514,972160,1646,345.3595217130418,408.88813593140065
7422,C4_04540C_A,35,C4,973176,973508,332,12.007252841794953,14.215977621772197
7424,C4_04550C_A,1228,C4,974467,975477,1010,138.48115854564173,163.95465947626695
7426,C4_04560C_A,2329,C4,976498,977346,848,312.8148281790912,370.35687144635017
7428,C4_04570W_A,550,C4,979296,980141,845,74.13438271890983,87.77134450500772
7430,C4_04580W_A,3142,C4,982197,987134,4937,72.48643628809488,85.82025961564823
7432,C4_04590W_A,8085,C4,987763,988899,1136,810.6164039990656,959.7286582473179
7434,C4_04600C_A,537,C4,989215,990402,1187,51.52728524844317,61.00568911589925
7436,C4_04620C_A,1,C4,996059,997609,1550,0.07348217407328893,0.08699916258854136
7438,C4_04630C_A,67,C4,998774,999139,365,20.907188431537136,24.75304941046581
7440,C4_04640C_A,206,C4,999156,999992,836,28.065619834451144,33.228268677657006
7442,C4_04650W_A,209,C4,1000502,1001221,719,33.10785854108755,39.198023255296214
7444,C4_04660C_A,2739,C4,1001323,1004172,2849,109.49978796751297,129.64218842103298
7446,C4_04670C_A,1066,C4,1005037,1006539,1502,80.83528376917131,95.70487106860645
7448,C4_04680C_A,2,C4,1006665,1006750,85,2.6799381132611253,3.172910635582097
7450,C4_04690C_A,2,C4,1006761,1006843,82,2.7779846295999473,3.2889927320058323
7452,C4_04700W_A,3336,C4,1007560,1009182,1622,234.2550096782752,277.3460357045806
7454,C4_04710W_A,1517,C4,1009525,1011219,1694,101.99664109045332,120.75884353752465
7456,C4_04720W_A,700,C4,1011677,1012648,971,82.10932942277908,97.21327642488917
7458,C4_04730W_A,1242,C4,1013014,1015230,2216,63.83598073487749,75.57855952130008
7460,C4_04740W_A,1,C4,1015422,1015508,86,1.324388021088347,1.568008162933013
7462,C4_04750W_A,1136,C4,1015865,1017364,1499,86.31581861791005,102.19354602128328
7464,C4_04760C_A,518,C4,1017566,1018333,767,76.921561360422,91.0712224802345
7466,C4_04770C_A,676,C4,1018785,1020554,1769,43.52437648049302,51.530651532093636
7468,C4_04780W_A,832,C4,1022584,1025082,2498,37.93539298835605,44.913578892787406
7470,C4_04790W_A,25,C4,1027532,1030078,2546,1.1183952259779835,1.324123154087187
7472,C4_04800W_A,2798,C4,1033241,1034341,1100,289.7134915804062,343.0060620274955
7474,C4_04810C_A,366,C4,1034791,1035768,977,42.667796675308914,50.51650454092069
7476,C4_04820C_A,453,C4,1036182,1036958,776,66.48905737829874,78.71966754064991
7478,C4_04830W_A,483,C4,1037422,1039257,1835,29.979525678456543,35.49423600649128
7480,C4_04840C_A,528,C4,1039532,1041073,1541,39.02518576351698,46.20383819757446
7482,C4_04850C_A,321,C4,1042165,1044021,1856,19.69884467142506,23.32243175965989
7484,C4_04860W_A,274,C4,1048293,1049468,1175,26.559897301213457,31.445569660726402
7486,C4_04870C_A,2200,C4,1049786,1052143,2357,106.31065489601835,125.86641681244211
7488,C4_04880W_A,215,C4,1052921,1053868,947,25.85843137267533,30.615069622630845
7490,C4_04890C_A,2143,C4,1054051,1054518,467,522.659664904797,618.80250195338
7492,C4_04900W_A,1297,C4,1055341,1055842,501,294.86005718210856,349.0993343510462
7494,C4_04910C_A,132,C4,1055978,1056721,743,20.23479517549787,23.956969940263207
7496,C4_04920W_A,376,C4,1056993,1058111,1118,38.30537660993988,45.35162071252407
7498,C4_04930C_A,249,C4,1058295,1059131,836,33.92397737271036,40.16426650843007
7500,C4_04940W_A,149,C4,1059519,1060398,879,19.30683515611613,22.85831240025441
7502,C4_04950W_A,112,C4,1060449,1060895,446,28.60203008771964,33.86335117796139
7504,C4_04970C_A,692,C4,1062625,1062888,263,299.6843342623943,354.81103343144287
7506,C4_04980W_A,472,C4,1063814,1065475,1661,32.36577877905972,38.319438500768726
7508,C4_04990C_A,242,C4,1065570,1066970,1400,19.687973924921913,23.309561347829906
7510,C4_05000W_A,120,C4,1068053,1069351,1298,10.529803064431233,12.466752112071413
7512,C4_05010W_A,486,C4,1069560,1071119,1559,35.50617173150003,42.03750428348186
7514,C4_05020W_A,28,C4,1071272,1071643,371,8.596027910460215,10.177260529225594
7516,C4_05030C_A,1918,C4,1071853,1076304,4451,49.080016918103944,58.10824768804193
7518,C4_05040W_A,40,C4,1077190,1077411,221,20.614908563547118,24.407004889093056
7520,C4_05050C_A,351,C4,1077531,1078781,1250,31.982381443658273,37.86551552503674
7522,C4_05060W_A,654,C4,1080133,1082154,2021,36.857436842203356,43.63733355566769
7524,C4_05070C_A,542,C4,1082286,1083653,1367,45.159015683226066,53.46598133916138
7526,C4_05080C_A,542,C4,1083917,1085980,2063,29.9235940082259,35.428015749216485
7528,C4_05090C_A,535,C4,1086508,1091751,5243,11.62218059322427,13.760071633901951
7530,C4_05100C_A,4006,C4,1092126,1096076,3950,115.51211733500581,136.76048107874175
7532,C4_05110C_A,10155,C4,1097227,1099170,1943,595.2793569001988,704.7805295595924
7534,C4_05120C_A,11,C4,1104280,1104594,314,3.990035248247058,4.723999115078441
7536,C4_05130C_A,3373,C4,1104766,1106391,1625,236.41589438847112,279.90441346909694
7538,C4_05140C_A,4887,C4,1108501,1113084,4583,121.45242118242476,143.7934991782266
7540,C4_05150W_A,1683,C4,1115386,1117143,1757,109.10032634962161,129.1692461505967
7542,C4_05160C_A,344,C4,1117383,1118930,1547,25.32688766378646,29.985748863742895
7544,C4_05170C_A,443,C4,1119301,1120516,1215,41.52801220364102,49.167057606108585
7546,C4_05180C_A,1387,C4,1120763,1125010,4247,37.19699833563933,44.03935712054995
7548,C4_05190C_A,496,C4,1125094,1126632,1538,36.73153148735015,43.48826800914864
7550,C4_05200C_A,25,C4,1127004,1127477,473,6.019945550401577,7.127309831513696
7552,C4_05210W_A,675,C4,1128701,1129393,692,111.09931304072045,131.53594488188065
7554,C4_05220C_A,285,C4,1129531,1131927,2396,13.547892486175035,16.040016725161998
7556,C4_05230C_A,227,C4,1132118,1134427,2309,11.19735944031473,13.257104961792239
7558,C4_05240C_A,2417,C4,1134817,1137282,2465,111.67948999572656,132.222844934516
7560,C4_05250W_A,923,C4,1139061,1139768,707,148.6948689362812,176.0471739141396
7562,C4_05260W_A,512,C4,1143093,1144082,989,58.96405798236814,69.81045038449588
7564,C4_05270C_A,110,C4,1144171,1144818,647,19.36431326042622,22.926363556949465
7566,C4_05280W_A,1329,C4,1144988,1151416,6428,23.548476117341558,27.880199902654915
7568,C4_05290W_A,813,C4,1151631,1154099,2468,37.51967652287482,44.42139170824571
7570,C4_05300W_A,1142,C4,1154633,1156483,1850,70.30853855520472,83.24173929620382
7572,C4_05310W_A,92,C4,1156768,1158231,1463,7.162377322522898,8.479891035629528
7574,C4_05320W_A,1448,C4,1158925,1160073,1148,143.66149084502584,170.08790985515876
7576,C4_05330C_A,352,C4,1160202,1161677,1475,27.18093164365182,32.18084278529367
7578,C4_05340W_A,278,C4,1161917,1164274,2357,13.433800936860502,15.904938124481323
7580,C4_05350W_A,376,C4,1167102,1168889,1787,23.964975405659086,28.373313909682096
7582,C4_05360C_A,105,C4,1169089,1170171,1082,11.05288708911994,13.086057034459435
7584,C4_05370W_A,797,C4,1171023,1173812,2789,32.54793967064808,38.53510774605757
7586,C4_05380C_A,54,C4,1174198,1174446,248,24.80023374973501,29.362217373632713
7588,C4_05390W_A,470,C4,1174822,1175916,1094,48.932142424489015,57.93317179684862
7590,C4_05400C_A,1605,C4,1176257,1177441,1184,154.39635012738557,182.7974381162532
7592,C4_05420C_A,488,C4,1179358,1183830,4472,12.428872197906026,14.715153529063661
7594,C4_05430C_A,1375,C4,1184110,1185966,1856,84.37978636513847,99.90138214807585
7596,C4_05440C_A,3495,C4,1186514,1187842,1328,299.75249058623825,354.89172705781306
7598,C4_05450C_A,3361,C4,1188801,1189685,884,433.04192301301174,512.699646451511
7600,C4_05460C_A,784,C4,1190491,1192344,1853,48.18971286231015,57.0541728967056
7602,C4_05530W_A,178,C4,1204629,1206167,1538,13.181880251508725,15.606676825863827
7604,C4_05540W_A,501,C4,1210137,1211771,1634,34.92202097711905,41.34589945418103
7606,C4_05550C_A,1172,C4,1211998,1212963,965,138.32924085133334,163.77479664077126
7608,C4_05560C_A,1593,C4,1213411,1214982,1571,115.492367990491,136.73709885773195
7610,C4_05570C_A,216,C4,1215386,1216962,1576,15.610299416076861,18.481801798631757
7612,C4_05580C_A,52,C4,1217919,1218905,986,6.006757840068041,7.111696252166769
7614,C4_05590W_A,1276,C4,1221251,1229458,8207,17.708424988686595,20.965875931231526
7616,C4_05600W_A,793,C4,1230574,1233402,2828,31.937982412370253,37.81294932662858
7618,C4_05610C_A,3884,C4,1233748,1236879,3131,141.2894871785417,167.27957796727458
7620,C4_05620C_A,146,C4,1237338,1237799,461,36.07161820560799,42.70696419476553
7622,C4_05630W_A,1081,C4,1238032,1238988,956,128.78980833525029,152.48059296572228
7624,C4_05640C_A,258,C4,1239058,1239897,839,35.02445937057002,41.46718131008068
7626,C4_05650W_A,597,C4,1240101,1241087,986,68.962200586935,81.6477435104531
7628,C4_05660C_A,538,C4,1241123,1243357,2234,27.429178585369577,32.47475455800566
7630,C4_05670W_A,6338,C4,1245541,1247604,2063,349.91833731390363,414.28554210061634
7632,C4_05680W_A,786,C4,1249405,1251384,1979,45.2366511740717,53.5578978178979
7634,C4_05690W_A,3456,C4,1251904,1254192,2288,172.04078237578415,203.6875498926129
7636,C4_05700W_A,204,C4,1256166,1259081,2915,7.970862244244926,9.437096127100096
7638,C4_05720W_A,4,C4,1262625,1262957,332,1.372257467633709,1.6246831567739655
7640,C4_05730W_A,578,C4,1263841,1264554,713,92.33194916165434,109.31633907864546
7642,C4_05740C_A,2063,C4,1264732,1269063,4331,54.25312258726676,64.23294210372877
7644,C4_05750C_A,160,C4,1269674,1270375,701,25.99654660510079,30.778591044162997
7646,C4_05760W_A,529,C4,1270621,1271970,1349,44.66397971192977,52.87988388767568
7648,C4_05770C_A,722,C4,1272201,1274483,2282,36.035890011138314,42.66466382683464
7650,C4_05780C_A,256,C4,1276925,1279141,2216,13.157818895433685,15.578189402135926
7652,C4_05790W_A,431,C4,1282526,1286320,3794,12.938789243452996,15.318869416783095
7654,C4_05800C_A,920,C4,1287292,1287657,365,287.0837814479726,339.8926187705753
7656,C4_05810W_A,6263,C4,1288330,1289715,1385,515.0463733881322,609.7887514098582
7658,C4_05820W_A,372,C4,1290067,1290333,266,159.28504349871577,188.58540281410885
7660,C4_05830W_A,35,C4,1290546,1290887,341,11.690345875295966,13.840775866358854
7662,C4_05840W_A,272,C4,1291227,1293410,2183,14.191518364314527,16.802037080773722
7664,C4_05850C_A,474,C4,1293694,1294932,1238,43.60852446821113,51.63027847641465
7666,C4_05860W_A,71,C4,1295759,1296151,392,20.629370552973082,24.424127150175963
7668,C4_05870C_A,5,C4,1296699,1298390,1691,0.3367751916428085,0.3987247250509732
7670,C4_05880W_A,864,C4,1301849,1303915,2066,47.63181390074953,56.3936488570061
7672,C4_05890W_A,178,C4,1304386,1304892,506,40.06666368936842,47.436895174265935
7674,C4_05900C_A,2561,C4,1305122,1306300,1178,247.6155892127539,293.16428340691374
7676,C4_05910C_A,824,C4,1309161,1312463,3302,28.422602279347252,33.65091776441098
7678,C4_05920C_A,434,C4,1312804,1315008,2204,22.42806646964676,26.553691775549808
7680,C4_05940W_A,342,C4,1320918,1323974,3056,12.74636795688824,15.091052384877548
7682,C4_05950C_A,2,C4,1324904,1324975,71,3.2083766144675447,3.7985549862602572
7684,C4_05960W_A,647,C4,1325490,1326404,914,80.62538103872845,95.45635689487824
7686,C4_05970W_A,972,C4,1326856,1328934,2078,53.27634430164442,63.07648621554207
7688,C4_05980C_A,532,C4,1329067,1331142,2075,29.201638911245325,34.573257576149985
7690,C4_05990W_A,2,C4,1331478,1331559,81,2.8122807361382183,3.3295975805491143
7692,C4_06000W_A,533,C4,1331712,1333082,1370,44.311896431129675,52.46303516242588
7694,C4_06010C_A,177,C4,1333108,1334418,1310,15.389186608402149,18.220015462722383
7696,C4_06020C_A,975,C4,1334460,1337801,3341,33.2385320467698,39.35273405026433
7698,C4_06030W_A,2104,C4,1338043,1338714,671,357.1386975973321,422.8340820175128
7700,C4_06040W_A,192,C4,1339119,1340288,1169,18.70683918238733,22.147947635885295
7702,C4_06050W_A,152,C4,1340632,1341225,593,29.194604066891863,34.564928677673436
7704,C4_06060W_A,1994,C4,1341803,1351054,9251,24.549924917123995,29.065864426808435
7706,C4_06070C_A,171,C4,1351194,1352273,1079,18.050463612720325,21.37083229294985
7708,C4_06080W_A,55,C4,1352454,1352630,176,35.59292806674933,42.140219378824725
7710,C4_06090C_A,446,C4,1352664,1355066,2402,21.14830430344073,25.038518358642232
7712,C4_06100W_A,736,C4,1355313,1357805,2492,33.63903057095024,39.82690396509149
7714,C4_06110C_A,1719,C4,1357947,1360055,2108,92.87930678822329,109.96438271301663
7716,C4_06120W_A,22283,C4,1362406,1363776,1370,1852.5365631798547,2193.3092167435943
7718,C4_06130W_A,1756,C4,1364530,1376010,11480,17.421932177062526,20.62668299072229
7720,C4_06140C_A,158,C4,1376152,1377579,1427,12.610921114609992,14.9306902017756
7722,C4_06150C_A,30,C4,1378116,1378936,820,4.166976944399921,4.933489098008748
7724,C4_06160W_A,245,C4,1379310,1380818,1508,18.504546156718483,21.908442966179432
7726,C4_06170C_A,390,C4,1380823,1381377,554,80.18045889404902,94.9295916692658
7728,C4_06180C_A,11,C4,1382072,1382211,139,9.013460920500547,10.671480015357051
7730,C4_06190C_A,485,C4,1382397,1385960,3563,15.503851911197012,18.355773358387868
7732,C4_06200W_A,42,C4,1386049,1386258,209,22.888466661105788,27.09878222255523
7734,C4_06210C_A,1205,C4,1386346,1387926,1580,86.86476621859838,102.84347210427099
7736,C4_06220C_A,15,C4,1388385,1389065,680,2.512441981182305,2.9746037208582154
7738,C4_06230C_A,865,C4,1389377,1391464,2087,47.20710344454343,55.89081324417194
7740,C4_06240W_A,202,C4,1391701,1393017,1316,17.482726977467145,20.6986609471674
7742,C4_06250C_A,1170,C4,1393150,1395522,2372,56.18040585240703,66.51474761986499
7744,C4_06260W_A,281,C4,1396271,1396981,710,45.077691433269,53.369697556956616
7746,C4_06270C_A,2408,C4,1397074,1398126,1052,260.7080480143951,308.66508977706445
7748,C4_06280C_A,244,C4,1398542,1399618,1076,25.82802809899431,30.579073690507755
7750,C4_06290W_A,64,C4,1399953,1400249,296,24.626458338075206,29.156476110754408
7752,C4_06300C_A,54,C4,1400697,1401380,683,9.005062913520181,10.661537201553312
7754,C4_06310C_A,125,C4,1402334,1403224,890,15.996821603033405,18.939424439921225
7756,C4_06320C_A,137,C4,1403991,1404659,668,23.35919111446543,27.656096071372396
7758,C4_06340W_A,1859,C4,1407066,1409819,2753,76.91071939102012,91.05838613903107
7760,C4_06350C_A,948,C4,1410147,1411982,1835,58.841801952747005,69.66570545373443
7762,C4_06360C_A,45,C4,1412344,1413132,788,6.50429142336536,7.700750749429899
7764,C4_06370C_A,519,C4,1413404,1415089,1685,35.081741800152685,41.535000797835075
7766,C4_06380W_A,79,C4,1417018,1417860,842,10.686332797237801,12.65207536694405
7768,C4_06390W_A,3227,C4,1418728,1419573,845,434.9666418798583,514.9784158502906
7770,C4_06400C_A,840,C4,1419739,1420542,803,119.14544289342739,141.06215403521898
7772,C4_06410W_A,321,C4,1420866,1423403,2537,14.411137449808795,17.06205492547448
7774,C4_06420W_A,1461,C4,1426455,1429091,2636,63.1274875939554,74.73973962059232
7776,C4_06430C_A,441,C4,1429792,1431423,1631,30.796284541874094,36.46123702476852
7778,C4_06440C_A,438,C4,1431997,1433226,1229,40.591576874170755,48.05836572934153
7780,C4_06450W_A,228,C4,1433543,1433956,413,62.87796687046079,74.44431975494072
7782,C4_06460C_A,922,C4,1434027,1434701,674,155.80619431474364,184.4666220404814
7784,C4_06470W_A,4701,C4,1436216,1436827,611,876.3200253579762,1037.5184094264093
7786,C4_06480C_A,1697,C4,1437628,1438893,1265,152.79354669855775,180.89980024882988
7788,C4_06490C_A,63,C4,1442052,1443683,1631,4.3994692202677275,5.208748146395502
7790,C4_06500W_A,2667,C4,1444145,1447327,3182,95.46332033088167,113.02372352817152
7792,C4_06510C_A,505,C4,1447546,1448538,992,57.98202797970455,68.64777673002092
7794,C4_06520W_A,2,C4,1449260,1449321,61,3.7343399938884536,4.421268918434069
7796,C4_06530C_A,929,C4,1449989,1451764,1775,59.611637496806985,70.57715164471557
7798,C4_06540W_A,3312,C4,1457328,1460318,2990,126.16324040890838,149.3708699212495
7800,C4_06550C_A,1753,C4,1461105,1465031,3926,50.856365074691034,60.211353700319705
7802,C4_06560W_A,75,C4,1466574,1467071,497,17.18773186321899,20.34940171210852
7804,C4_06570C_A,17320,C4,1468068,1469771,1703,1158.3690224142777,1371.450099149725
7806,C4_06580W_A,1010,C4,1471030,1472064,1034,111.25371712933638,131.71875148197438
7808,C4_06590W_A,452,C4,1472403,1473227,824,62.47768344143959,73.97040450185932
7810,C4_06600W_A,943,C4,1473575,1477960,4385,24.49377873072355,28.999390193281982
7812,C4_06610C_A,6308,C4,1478187,1480112,1925,373.22836819957155,441.8834349575088
7814,C4_06620C_A,147,C4,1481276,1481707,431,38.846666734568174,45.99248073271264
7816,C4_06630C_A,2,C4,1482004,1482513,509,0.4475338696015632,0.5298573752936704
7818,C4_06640C_A,4,C4,1482851,1483333,482,0.9452063884945878,1.1190763652467979
7820,C4_06650W_A,1586,C4,1484245,1486263,2018,89.51497944715865,105.98118998583313
7822,C4_06660W_A,1,C4,1486939,1488489,1550,0.07348217407328893,0.08699916258854136
7824,C4_06670W_A,171,C4,1489544,1490743,1199,16.24391179159736,19.231966675640443
7826,C4_06680C_A,1292,C4,1490891,1493611,2720,54.10125066145898,64.05313345581358
7828,C4_06690C_A,805,C4,1494219,1494736,517,177.34503423587287,209.96751473859283
7830,C4_06700W_A,6,C4,1494984,1495313,329,2.0771556804911464,2.4592468452080087
7832,C4_06710W_A,437,C4,1495684,1496802,1118,44.5198127088929,52.7091974770559
7834,C4_06720W_A,2299,C4,1497789,1498739,950,275.63163494890676,326.33385886961867
7836,C4_06730C_A,1785,C4,1498921,1500297,1376,147.75203860266873,174.93091067721423
7838,C4_06740C_A,1968,C4,1500722,1502503,1781,125.8562738872322,149.00743714771846
7840,C4_06750C_A,4,C4,1502546,1502986,440,1.0354306346690711,1.2258972910203558
7842,C4_06760W_A,3304,C4,1507097,1509049,1952,192.78530218449143,228.24800791415882
7844,C4_06770W_A,481,C4,1509593,1511473,1880,29.140763234223705,34.501183865897346
7846,C4_06780C_A,1222,C4,1511588,1512886,1298,107.22849453945804,126.95309234126054
7848,C4_06790W_A,737,C4,1513766,1514587,821,102.2440457400994,121.05175807919639
7850,C4_06800W_A,1105,C4,1514782,1516158,1376,91.46554770641397,108.29056375256121
7852,C4_06810C_A,1487,C4,1516294,1518216,1922,88.11934907014566,104.32883449125889
7854,C4_06820C_A,1101,C4,1518979,1520136,1157,108.3846189842448,128.32188497448166
7856,C4_06830C_A,1774,C4,1527753,1529432,1679,120.3418308810736,142.47861665855402
7858,C4_06840W_A,179,C4,1529634,1530410,776,26.2727180368995,31.10556399509124
7860,C4_06850C_A,902,C4,1530448,1531563,1115,92.1393969254397,109.0883670090042
7862,C4_06860C_A,200,C4,1531811,1532457,646,35.262343595541125,41.74882415239601
7864,C4_06870W_A,2926,C4,1532681,1533973,1292,257.94404340138334,305.3926486747768
7866,C4_06880C_A,472,C4,1534066,1534347,281,191.31515498938856,226.50742829102086
7868,C4_06890W_A,130,C4,1535338,1536519,1181,12.537390411318984,14.843633583057649
7870,C4_06900W_A,19,C4,1536828,1537565,737,2.936295829658561,3.476425153639814
7872,C4_06910W_A,62,C4,1538056,1539795,1739,4.060745789788998,4.807716805496737
7874,C4_06920C_A,17,C4,1539950,1540393,443,4.370779428512784,5.174780889860192
7876,C4_06930C_A,384,C4,1541258,1541980,722,60.576994471498026,71.72008528074768
7878,C4_06940C_A,302,C4,1542377,1543543,1166,29.500004874533914,34.92650772529692
7880,C4_06950W_A,149,C4,1543701,1544444,743,22.84079152385744,27.04233728105468
7882,C4_06960W_A,110,C4,1544730,1545158,428,29.272688503494773,34.657376685388556
7884,C4_06970C_A,56,C4,1545215,1546621,1406,4.536452851750696,5.37092980987581
7886,C4_06980W_A,88,C4,1547130,1548029,899,11.149019514567975,13.199872944468344
7888,C4_06990W_A,1611,C4,1548591,1550669,2078,88.30060768513287,104.54343548687065
7890,C4_07000W_A,55,C4,1550811,1551437,626,10.00695741173783,11.847729410021008
7892,C4_07010C_A,211,C4,1551459,1551986,527,45.602172733717545,53.99065678288891
7894,C4_07020C_A,35,C4,1552509,1552955,446,8.938134402412386,10.582297243112935
7896,C4_07030W_A,445,C4,1553710,1554468,758,66.86587014122827,79.16579471694779
7898,C4_07040W_A,326,C4,1554645,1556204,1559,23.816897087384795,28.197996700442562
7900,C4_07050W_A,1039,C4,1556544,1557434,890,132.96558116441366,157.42449594462522
7902,C4_07060W_A,1938,C4,1557803,1562149,4346,50.78994539778017,60.13271617572928
7904,C4_07070W_A,225,C4,1562275,1562916,641,39.97957598761235,47.33378775780624
7906,C4_07080C_A,297,C4,1562962,1566078,3116,10.8560715130419,12.853037386917528
7908,C4_07090C_A,376,C4,1566664,1567773,1109,38.61624080244616,45.71966813038945
7910,C4_07100C_A,1314,C4,1568024,1573987,5963,25.09829681956525,29.715108912306256
7912,C4_07110C_A,7550,C4,1574155,1575360,1205,713.6308233134139,844.9026557613322
7914,C4_07120C_A,1074,C4,1575583,1578204,2621,46.67141365120339,55.25658373183702
7916,C4_07130W_A,1079,C4,1578444,1582748,4304,28.553731884031613,33.806168557436344
7918,C4_07140W_A,468,C4,1583035,1583619,584,91.27391964514348,108.06368585912313
7920,C4_07150W_A,115,C4,1583826,1584365,539,24.300923058559835,28.7710588708859
7922,C4_07160W_A,50,C4,1584493,1584672,179,31.814907769161405,37.66723519894948
7924,C4_07170C_A,59,C4,1584704,1584946,242,27.76836702067055,32.87633644100045
7926,C4_07180W_A,4802,C4,1585323,1585904,581,941.3686227967243,1114.5326455469403
7928,C4_07190W_A,1173,C4,1586083,1588440,2357,56.68290826955887,67.10968496408846
7930,C4_07200C_A,280,C4,1588433,1589635,1202,26.531833234448747,31.412343230804453
7932,C4_07210W_A,185,C4,1589707,1590588,881,23.917154841674915,28.31669679031128
7934,C4_07220C_A,1292,C4,1590581,1593721,3140,46.86477764304726,55.48551687892132
7936,C4_07230C_A,1298,C4,1594317,1596377,2060,71.76640097963593,84.96777437470212
7938,C4_07240W_A,428,C4,1596552,1596950,398,122.48259869401979,145.0131770382873
7940,C4_07250C_A,44,C4,1597159,1597812,653,7.674554780701845,9.086283137118716
7942,C4_07260W_A,2,C4,1602903,1603258,355,0.6416753228935089,0.7597109972520514
7944,C5_00010W_A,9,C5,1918,2427,509,2.0139024132070342,2.3843581888215164
7946,C5_00030W_A,721,C5,3999,4808,809,101.50803910457856,120.18036359805241
7948,C5_00040C_A,929,C5,4830,6473,1643,64.40088652272209,76.24737928750466
7950,C5_00050W_A,161,C5,6532,7230,698,26.27145636101612,31.104070234914754
7952,C5_00060C_A,315,C5,7209,8807,1598,22.451609193544005,26.581565165115975
7954,C5_00070W_A,887,C5,8946,10154,1208,83.63159521909047,99.01556182521199
7956,C5_00080C_A,893,C5,10151,11086,935,108.78112432464478,128.79132716249148
7958,C5_00090C_A,828,C5,11157,11819,662,142.457737470784,168.6627269881178
7960,C5_00100C_A,1516,C5,11839,12441,602,286.8246057099906,339.58576785806395
7962,C5_00110C_A,3788,C5,12554,14674,2120,203.51096078014558,240.94664302941595
7964,C5_00120W_A,75,C5,14763,15059,296,28.859130864931885,34.16774544229032
7966,C5_00130C_A,366,C5,15077,15475,398,104.73979234114776,124.00659531778771
7968,C5_00140C_A,463,C5,15563,15979,416,126.76558226849951,150.0840120953527
7970,C5_00150C_A,2287,C5,16398,18029,1631,159.70771598019516,189.08582556835736
7972,C5_00160W_A,259,C5,18148,18882,734,40.189943844307685,47.58285261739773
7974,C5_00170W_A,553,C5,19011,20093,1082,58.21187200269834,68.91990038148634
7976,C5_00180W_A,1108,C5,21297,23504,2207,57.180917876514,67.69930304918937
7978,C5_00190C_A,25621,C5,23548,29661,6113,477.37027842208255,565.1821682080122
7980,C5_00200C_A,2202,C5,30720,32849,2129,117.8027281961214,139.47244801829524
7982,C5_00210C_A,1998,C5,33839,35884,2045,111.27967965162274,131.74948978995292
7984,C5_00220W_A,1446,C5,36656,39271,2615,62.981107743962696,74.5664333115479
7986,C5_00230C_A,157,C5,39266,40126,860,20.79289193108705,24.6177281580483
7988,C5_00240W_A,792,C5,40891,42570,1679,53.72645437306104,63.60939368296211
7990,C5_00250C_A,161,C5,42567,43190,623,29.434151749581467,34.84854096945505
7992,C5_00260W_A,2691,C5,43421,44635,1214,252.46937575650065,298.9109201935218
7994,C5_00270W_A,4016,C5,45823,46218,395,1158.004651066858,1371.0187019776008
7996,C5_00280C_A,406,C5,46404,47366,962,48.06895233297372,56.91119856233793
7998,C5_00290W_A,310,C5,47854,48873,1019,34.64983772543212,41.023648305980494
8000,C5_00300C_A,1243,C5,48904,53010,4106,34.479890569484205,40.822439503461574
8002,C5_00310C_A,479,C5,53247,53780,533,102.35804904449037,121.18673220236874
8004,C5_00320W_A,243,C5,54029,54322,293,94.46095858260846,111.83697811936555
8006,C5_00330C_A,1016,C5,54415,63318,8903,12.997835306145726,15.38877695658036
8008,C5_00340W_A,336,C5,63667,64644,977,39.170436292086876,46.3758074474026
8010,C5_00350C_A,697,C5,64733,66052,1319,60.18685880218172,71.25818445984129
8012,C5_00360C_A,3,C5,66383,66464,81,4.218421104207328,4.994396370823671
8014,C5_00370W_A,2628,C5,67605,68261,656,456.2839754117914,540.2170562319579
8016,C5_00380W_A,814,C5,69038,71404,2366,39.1853165799952,46.39342495264694
8018,C5_00390C_A,4634,C5,71613,72101,488,1081.5582207299435,1280.5100105014671
8020,C5_00400C_A,1448,C5,74018,76453,2435,67.73034558114566,80.18928973869497
8022,C5_00410W_A,26,C5,77014,77355,341,8.684256935934147,10.281719215009435
8024,C5_00420C_A,488,C5,77777,78136,359,154.8242798580383,183.30408518655346
8026,C5_00430W_A,152,C5,78890,79492,602,28.758139886489825,34.04817725225971
8028,C5_00440C_A,722,C5,79518,80225,707,116.31386280822862,137.70970700542665
8030,C5_00450C_A,1201,C5,80483,81598,1115,122.68227905482603,145.24958844547012
8032,C5_00460C_A,683,C5,82117,83979,1862,41.778680764064084,49.46383645239491
8034,C5_00470C_A,17,C5,84369,86237,1868,1.0365392327789953,1.2272098148865445
8036,C5_00480C_A,2512,C5,87345,88250,905,316.14385963730143,374.29827564060184
8038,C5_00490C_A,1093,C5,89881,93594,3713,33.528097281514256,39.695564583726735
8040,C5_00500W_A,1662,C5,95043,98102,3059,61.88212769865957,73.26529674545321
8042,C5_00510W_A,8,C5,103156,104601,1445,0.6305736737085001,0.746567208372258
8044,C5_00520W_A,9,C5,105031,105504,473,2.1671803981445676,2.5658315393449307
8046,C5_00530W_A,6,C5,105626,107950,2324,0.2940551716357948,0.3481463907372782
8048,C5_00540C_A,133,C5,109830,110891,1061,14.277427130262499,16.903748697104433
8050,C5_00550C_A,353,C5,121532,121855,323,124.47607289226019,147.37334925795793
8052,C5_00560W_A,1021,C5,122290,122799,509,228.46604043159806,270.49219008741875
8054,C5_00570W_A,2857,C5,125110,130260,5150,63.1853952538736,74.80829934931401
8056,C5_00580W_A,1418,C5,130820,132904,2084,77.49830633190102,91.75405923865405
8058,C5_00590W_A,30520,C5,134735,135640,905,3841.047211835366,4547.604845760815
8060,C5_00600C_A,221,C5,137588,138895,1307,19.25885136098326,22.80150202349261
8062,C5_00610C_A,338,C5,139506,141368,1862,20.675247581630543,24.478443222415052
8064,C5_00620W_A,58,C5,141650,142261,611,10.811861618966736,12.80069511736476
8066,C5_00630C_A,274,C5,142316,144415,2099,14.867974906586856,17.60292727553765
8068,C5_00640C_A,591,C5,144757,146283,1526,44.11097349923743,52.22515261417649
8070,C5_00650C_A,245,C5,146706,147779,1073,26.006389193225974,30.790244168684605
8072,C5_00660C_A,16294,C5,148115,149701,1586,1170.1410742388166,1385.3876107108601
8074,C5_00670C_A,1508,C5,151171,153228,2057,83.49889823962351,98.85845534003724
8076,C5_00680W_A,624,C5,156800,158155,1355,52.45163008390042,62.10006646172487
8078,C5_00690C_A,423,C5,158181,159323,1142,42.18790493095612,49.948337085093826
8080,C5_00700C_A,794,C5,159620,160765,1145,78.98210622881807,93.51080296743918
8082,C5_00710W_A,106,C5,164508,166652,2144,5.631119962799147,6.666960080828987
8084,C5_00730W_A,1063,C5,171023,174772,3749,32.29471968841145,38.23530814590829
8086,C5_00740W_A,15,C5,175545,176033,488,3.500943744270425,4.1449396110319405
8088,C5_00750C_A,2267,C5,176142,178124,1982,130.27514498861063,154.23915613609793
8090,C5_00760W_A,842,C5,180036,181850,1814,52.86746713508786,62.59239641361926
8092,C5_00770C_A,756,C5,181901,184267,2366,36.39324242564665,43.08775093882196
8094,C5_00780C_A,431,C5,184660,185712,1052,46.663276035799115,55.24694920843636
8096,C5_00790C_A,1778,C5,186133,188229,2096,96.61713908806153,114.38978634435169
8098,C5_00800C_A,2124,C5,189505,190827,1322,182.993958762543,216.65555451890762
8100,C5_00810C_A,10,C5,190881,191756,875,1.3016842264411181,1.5411280229970186
8102,C5_00820W_A,699,C5,194339,195190,851,93.5537737951879,110.76291739900722
8104,C5_00830C_A,791,C5,195364,196608,1244,72.4218806451414,85.74382901260542
8106,C5_00840W_A,255,C5,196711,197904,1193,24.345204779939188,28.823486180319343
8108,C5_00850C_A,158,C5,197983,198300,317,56.769036058512484,67.21165589253557
8110,C5_00860W_A,356,C5,198637,199125,488,83.08906486401811,98.37323343515804
8112,C5_00870C_A,50,C5,199539,201137,1598,3.563747491038731,4.219296057954916
8114,C5_00880C_A,3550,C5,202590,204197,1607,251.6089998993605,297.89227886960106
8116,C5_00890C_A,409,C5,206335,207939,1604,29.042409135761545,34.38473760785897
8118,C5_00900C_A,862,C5,210200,211276,1076,91.24491893988971,108.02935049679378
8120,C5_00910C_A,115,C5,211600,211956,356,36.79268968697683,43.560676211818816
8122,C5_00920W_A,153,C5,212567,213013,446,39.07241610197415,46.259756519893685
8124,C5_00930C_A,4429,C5,213091,213870,779,647.5628381314825,766.6815163186226
8126,C5_00940C_A,653,C5,214536,215582,1046,71.10418975934932,84.18374991777452
8128,C5_00950C_A,1082,C5,215856,217277,1421,86.72551311633559,102.67860350263386
8130,C5_00960W_A,1,C5,217451,217544,93,1.224702901221482,1.4499860431423561
8132,C5_00970W_A,2,C5,217558,217651,93,2.449405802442964,2.8999720862847123
8134,C5_00980W_A,299,C5,218210,219694,1484,22.948324510960752,27.16965087712904
8136,C5_00990W_A,1,C5,220201,220272,71,1.6041883072337724,1.8992774931301286
8138,C5_01000C_A,883,C5,220477,221181,704,142.85707037699842,169.1355168704647
8140,C5_01010W_A,257,C5,221837,222652,815,35.91610311913454,42.52284222962632
8142,C5_01020C_A,53,C5,222660,222935,275,21.95112945498431,25.989022569631537
8144,C5_01030W_A,2,C5,223245,223308,63,3.6157895178919945,4.280911174991718
8146,C5_01040W_A,50,C5,223535,223858,323,17.631171797770563,20.874412076198006
8148,C5_01050C_A,720,C5,223927,224533,606,135.32360769932419,160.21627961850191
8150,C5_01060C_A,582,C5,224788,225603,815,81.33529967056927,96.2968645044456
8152,C5_01070C_A,800,C5,225952,227454,1502,60.66437806316795,71.82354301583973
8154,C5_01080C_A,4189,C5,229537,231060,1523,313.27385564619914,370.9003366574325
8156,C5_01090C_A,2295,C5,234850,236442,1592,164.19250233806974,194.39558487317134
8158,C5_01100C_A,1643,C5,244200,245597,1397,133.95374273710897,158.59442906664916
8160,C5_01110W_A,797,C5,253333,254304,971,93.48733649993561,110.68425901519525
8162,C5_01120W_A,12,C5,254730,255237,507,2.6957957352330855,3.191685254727553
8164,C5_01130W_A,627,C5,261873,262667,794,89.94162578479326,106.48631758397221
8166,C5_01140C_A,1313,C5,262791,265052,2261,66.14208162992215,78.3088658744228
8168,C5_01150C_A,3,C5,265331,265415,84,4.067763207628495,4.816025071865683
8170,C5_01160C_A,9,C5,265434,265534,100,10.250763283223804,12.13638318110152
8172,C5_01170W_A,173,C5,266063,266791,728,27.06627057383575,32.04508990126012
8174,C5_01180W_A,1072,C5,266959,268119,1160,105.25687968980765,124.61880048027616
8176,C5_01190W_A,758,C5,268261,269373,1112,77.63867474703882,91.92024831409825
8178,C5_01200W_A,294,C5,269467,269937,470,71.2464398408463,84.35216679063468
8180,C5_01210W_A,9125,C5,270287,272368,2081,499.4298412057089,591.2995703323795
8182,C5_01220W_A,482,C5,273044,274345,1301,42.197180822562764,49.95931926971503
8184,C5_01230C_A,1138,C5,274465,275364,899,144.17709326793585,170.69835694096565
8186,C5_01240W_A,1517,C5,276990,278405,1415,122.10763958107981,144.56924448944645
8188,C5_01250W_A,1015,C5,280816,283287,2471,46.78503859198778,55.39110989171295
8190,C5_01260W_A,204,C5,283848,286220,2372,9.79555794349661,11.59744317474569
8192,C5_01270W_A,701,C5,286734,288617,1883,42.401516855726015,50.20124275654786
8194,C5_01280C_A,701,C5,288699,290108,1409,56.66576028341525,67.08938261929
8196,C5_01290C_A,1796,C5,290422,291162,740,276.43199484489423,327.2814443432182
8198,C5_01300C_A,538,C5,291456,292550,1094,56.01168643484062,66.31499239724373
8200,C5_01310W_A,272,C5,293743,294381,638,48.55812631551507,57.49035571681667
8202,C5_01320W_A,2212,C5,294646,296502,1856,135.74406359249915,160.7140780447591
8204,C5_01330W_A,4,C5,296701,297147,446,1.0215010745614155,1.2094053992129068
8206,C5_01340W_A,619,C5,297628,299091,1463,48.19034307219212,57.05491903320302
8208,C5_01350W_A,816,C5,299565,301415,1850,50.23797500967342,59.479211265938986
8210,C5_01360W_A,325,C5,303368,305500,2132,17.362403934999673,20.55620457503645
8212,C5_01380W_A,90,C5,308742,310874,2132,4.808050320461448,5.692487420779325
8214,C5_01390C_A,176,C5,311113,311721,608,32.97029126183095,39.03515058249027
8216,C5_01400W_A,269,C5,313333,315318,1985,15.434958428139959,18.274206972943237
8218,C5_01410C_A,1149,C5,315377,317962,2585,50.62594890360694,59.93855265456972
8220,C5_01420W_A,867,C5,318343,318662,319,309.5580552614086,366.5010176947063
8222,C5_01430C_A,389,C5,319484,320866,1382,32.05938991135279,37.95668964020334
8224,C5_01440C_A,512,C5,321017,322234,1217,47.91738154853089,56.73174645050651
8226,C5_01450W_A,1521,C5,322718,324214,1496,115.80073495085716,137.10218967955595
8228,C5_01460W_A,358,C5,324412,328203,3791,10.755805432146671,12.734327438771196
8230,C5_01470C_A,201,C5,328259,329767,1508,15.18128072449149,17.973865453885985
8232,C5_01480W_A,181,C5,330456,330884,428,48.16687835575049,57.027138000502994
8234,C5_01490C_A,588,C5,330986,332797,1811,36.980482302813655,43.78301313263203
8236,C5_01500C_A,1066,C5,333128,336385,3257,37.27804612259604,44.13531358460144
8238,C5_01510W_A,335,C5,338274,338594,320,119.23630902361023,141.16973491906282
8240,C5_01520C_A,1545,C5,338743,340293,1550,113.52995894323139,134.4137061992964
8242,C5_01530C_A,418,C5,340759,342204,1445,32.94747445126913,39.00813663745049
8244,C5_01540W_A,99,C5,342887,343737,850,13.26569366064257,15.70590764613138
8246,C5_01550C_A,456,C5,343387,343875,488,106.42868982582092,126.00616417537098
8248,C5_01560C_A,561,C5,344089,344778,689,92.73791649554192,109.79698378645304
8250,C5_01570C_A,103,C5,345209,347536,2327,5.041439231113269,5.968808039218148
8252,C5_01580C_A,17912,C5,347886,351038,3152,647.2492665295573,766.3102634654908
8254,C5_01590W_A,190,C5,353407,355008,1601,13.516864624974135,16.003281313132685
8256,C5_01600C_A,450,C5,355185,357080,1895,27.046868821170992,32.02211921134966
8258,C5_01610W_A,249,C5,357144,358613,1469,19.305953086171453,22.857268074232497
8260,C5_01620C_A,127,C5,358644,359429,785,18.42670823735914,21.81628682236225
8262,C5_01640W_A,832,C5,360948,362516,1568,60.435339084766206,71.55237249629015
8264,C5_01650C_A,1174,C5,362665,368511,5846,22.872992158940107,27.080461197805118
8266,C5_01670W_A,150,C5,375462,377102,1640,10.417442360999802,12.333722745021872
8268,C5_01680C_A,319,C5,377647,379728,2081,17.459519928177663,20.671184979290864
8270,C5_01690C_A,994,C5,382476,384125,1649,68.65614650983399,81.28539102496403
8272,C5_01700W_A,407,C5,384426,385058,632,73.34846442109861,86.84085715028691
8274,C5_01710C_A,132,C5,385279,387495,2216,6.784500367957994,8.032503910476338
8276,C5_01720C_A,257,C5,387749,390304,2555,11.456604321759158,13.56403773665184
8278,C5_01730W_A,109,C5,390706,393267,2561,4.8476428386107635,5.739362951711856
8280,C5_01740C_A,267,C5,393493,394455,962,31.611847962817695,37.426822699862626
8282,C5_01750C_A,21,C5,394560,395220,660,3.62400722134175,4.290640518571244
8284,C5_01760C_A,620,C5,395335,398205,2870,24.60500671931382,29.131078483480227
8286,C5_01770C_A,1954,C5,398770,400071,1301,171.06491976615695,202.53217811830535
8288,C5_01780W_A,804,C5,400477,402144,1667,54.933104577164166,65.03800624945426
8290,C5_01790C_A,64,C5,402452,402754,302,24.137190953875038,28.57720837345465
8291,C5_01800C_A,1724,C5,402802,404601,1799,109.14900809263072,129.22688286220136
8293,C5_01810W_A,466,C5,407947,409146,1199,44.267034473008,52.40992088215465
8295,C5_01820W_A,1424,C5,409928,411697,1769,91.6844853671924,108.54977482500198
8297,C5_01830C_A,1143,C5,411944,414976,3032,42.936904253608944,50.83511424801758
8299,C5_01840C_A,2078,C5,416400,419345,2945,80.36629353910232,95.14961045209945
8301,C5_01850C_A,2625,C5,420926,423694,2768,108.01322101181152,127.88216863516173
8303,C5_01860W_A,6,C5,424381,424716,335,2.0399528921838423,2.415200633055029
8305,C5_01870W_A,2177,C5,424739,427087,2348,105.60245915000107,125.02794901219957
8307,C5_01880C_A,459,C5,427195,427842,647,80.80199805941486,95.66546247854367
8309,C5_01890W_A,629,C5,428107,428781,674,106.2929460129867,125.84545039421128
8311,C5_01900C_A,82,C5,428854,429018,164,56.94868490679892,67.42435100611956
8313,C5_01910W_A,1845,C5,429592,430119,527,398.7488563682885,472.0983969878201
8315,C5_01920C_A,366,C5,430841,432214,1373,30.361571268591995,35.94655858447161
8317,C5_01930W_A,444,C5,432413,433954,1541,32.81663348295746,38.85322757523307
8319,C5_01940W_A,709,C5,434181,435950,1769,45.649087166670924,54.04620108913372
8321,C5_01950C_A,613,C5,435968,437557,1589,43.93901050707078,52.0215571639412
8323,C5_01960C_A,968,C5,438134,440017,1883,58.5515953157529,69.32211553257964
8325,C5_01970C_A,1165,C5,440800,443334,2534,52.364023612013206,61.99634484777371
8327,C5_01980C_A,502,C5,444832,445512,680,84.08305830356782,99.55007119138828
8329,C5_01990W_A,206,C5,446199,446600,401,58.510868283294656,69.27389679431735
8331,C5_02000C_A,18395,C5,446964,448538,1574,1331.094102745319,1575.9478230718796
8333,C5_02010C_A,1292,C5,451345,453531,2186,67.3172011890066,79.70014775837737
8335,C5_02020C_A,933,C5,453808,454866,1058,100.44068623448656,118.9166720013413
8337,C5_02030W_A,2110,C5,455201,456193,992,242.26154264787445,286.8253641590973
8339,C5_02040W_A,938,C5,456436,457821,1385,77.13771327447998,91.32713537002186
8341,C5_02050W_A,1164,C5,458157,463166,5009,26.46766589399639,31.336372358204496
8343,C5_02060W_A,277,C5,463382,464368,986,31.997536955747062,37.88345888173452
8345,C5_02070C_A,652,C5,464404,465366,962,77.19447517512037,91.3943385779417
8347,C5_02080C_A,77,C5,466337,466720,383,22.898426829365626,27.110574555985412
8349,C5_02090W_A,4,C5,467461,467754,293,1.5549128984791514,1.8409379114298858
8351,C5_02110W_A,32,C5,473498,473881,383,9.516229331684414,11.266732283006924
8353,C5_02120C_A,584,C5,474334,476817,2483,26.788587986766466,31.71632781922982
8355,C5_02130W_A,1,C5,474758,475336,578,0.1970542730339063,0.23330225261633067
8357,C5_02140C_A,370,C5,477228,477779,551,76.4828073158461,90.551759971921
8359,C5_02150C_A,713,C5,477990,479684,1694,47.93909367006805,56.75745249983854
8361,C5_02160W_A,253,C5,480236,482263,2027,14.216099932333623,16.831140409026393
8363,C5_02170C_A,2861,C5,482348,483952,1604,203.1548472797403,240.52502272881304
8365,C5_02180C_A,1119,C5,484150,487104,2954,43.145279898922134,51.081820430499526
8367,C5_02190C_A,769,C5,487795,488164,369,237.3633533513733,281.0261567680539
8369,C5_02200W_A,62,C5,488648,489742,1094,6.454878362379403,7.642248194477903
8371,C5_02210W_A,993,C5,489943,490926,983,115.05604092055205,136.22050976414388
8373,C5_02220C_A,612,C5,491075,491653,578,120.59721509675066,142.78097860119436
8375,C5_02230W_A,2226,C5,492351,493187,836,303.2721832596516,359.0588644488568
8377,C5_02240W_A,93,C5,498691,499884,1193,8.87883939033076,10.512094959881173
8379,C5_02260C_A,844,C5,501453,502862,1409,68.22525203880524,80.77523385261165
8381,C5_02270W_A,1931,C5,503291,504823,1532,143.56124093345787,169.96921905067475
8383,C5_02280C_A,290,C5,504892,506283,1391,23.745677387450307,28.113676192343167
8385,C5_02290W_A,259,C5,508123,509403,1280,23.04642092322019,27.28579204778901
8387,C5_02300C_A,1214,C5,509606,511327,1721,80.34364146060882,95.12279154146327
8389,C5_02310C_A,286,C5,511587,513602,2015,16.166078296123565,19.1398157694791
8391,C5_02320C_A,204,C5,514002,515186,1184,19.62420898815368,23.234066900757416
8393,C5_02330W_A,305,C5,515646,515960,314,110.63279551957753,130.98361182717494
8395,C5_02340C_A,1265,C5,517861,521547,3686,39.088489640315046,46.27878677305548
8397,C5_02350C_A,166,C5,523617,524495,878,21.534126866807796,25.49531268112949
8399,C5_02360C_A,71,C5,524833,525309,476,16.988893396566066,20.11398706485079
8401,C5_02370C_A,346,C5,525672,527018,1346,29.27822433544194,34.663930829297726
8403,C5_02380W_A,15356,C5,529671,531464,1793,975.4645905508133,1154.9005399330417
8405,C5_02390C_A,424,C5,531715,532662,947,50.99523210239227,60.3757652092813
8407,C5_02400W_A,1116,C5,533214,534119,905,140.4524471955527,166.28856513332468
8409,C5_02410C_A,185,C5,534199,534717,518,40.677632076284944,48.16025071865683
8411,C5_02430W_A,383,C5,535546,537645,2099,20.782607259937098,24.605551629674885
8413,C5_02440C_A,296,C5,537707,538597,890,37.8804735559831,44.84855707373346
8415,C5_02450W_A,679,C5,538877,541222,2345,32.97923842363878,39.045743567722965
8417,C5_02460C_A,989,C5,541501,542742,1241,90.76913678134429,107.46604858187308
8419,C5_02470W_A,550,C5,547644,553208,5564,11.258726347497989,13.329760263610984
8421,C5_02480W_A,790,C5,553739,554719,980,91.81522668647173,108.70456590782541
8423,C5_02490C_A,826,C5,555200,556462,1262,74.54772382411396,88.26071938360501
8425,C5_02500C_A,1198,C5,557609,559051,1442,94.62486063570749,112.03102982708909
8427,C5_02510C_A,973,C5,559298,560461,1163,95.28988893261453,112.81838955968071
8429,C5_02520W_A,708,C5,562888,563793,905,89.10424069395278,105.49489615985115
8431,C5_02530W_A,926,C5,565049,566509,1460,72.23901674478877,85.52732744063933
8433,C5_02540C_A,88,C5,566644,568018,1374,7.29473693129302,8.636598091031326
8435,C5_02550C_A,884,C5,568081,570480,2399,41.96968525019612,49.68997606453497
8437,C5_02560C_A,887,C5,570689,572443,1754,57.5980427734671,68.19315774507189
8439,C5_02570W_A,327,C5,573167,575461,2294,16.235588460787486,19.222112274630422
8441,C5_02580W_A,452,C5,575960,576265,305,168.7921677237581,199.84135511321992
8443,C5_02590C_A,382,C5,576552,579308,2756,15.786935874018278,18.69093039502008
8445,C5_02600W_A,1910,C5,580917,582386,1469,148.08984094211837,175.33085149310875
8447,C5_02610C_A,499,C5,582629,586153,3524,16.12791927837268,19.09463743022342
8449,C5_02620C_A,1019,C5,586676,588685,2009,57.770741582905025,68.39762436559067
8451,C5_02630C_A,1584,C5,589400,591802,2402,75.109672683072,88.92603829616435
8453,C5_02640W_A,195,C5,594501,595151,650,34.16921094407935,40.45461060367174
8455,C5_02650C_A,2596,C5,595462,598119,2657,111.28248853447498,131.75281536461148
8457,C5_02660C_A,1006,C5,600804,601811,1007,113.78426418319707,134.71479068948616
8459,C5_02670W_A,385,C5,602727,604307,1580,27.753473024199476,32.85870270551396
8461,C5_02680W_A,538,C5,604742,605716,974,62.91251022558074,74.48521733324912
8463,C5_02690W_A,1035,C5,606039,607136,1097,107.46014380772449,127.22735331145623
8465,C5_02700W_A,1122,C5,607797,610301,2504,51.03548279986293,60.42341999110714
8467,C5_02710W_A,2272,C5,611323,612285,962,268.9966987697446,318.478431363625
8469,C5_02720W_A,478,C5,612652,613482,830,65.59390695289129,77.65985489379553
8471,C5_02730C_A,421,C5,613567,614718,1151,41.66011528368782,49.32346094452882
8473,C5_02740W_A,383,C5,614913,616580,1667,26.168381906783427,30.98203531534948
8475,C5_02750C_A,925,C5,616642,619695,3053,34.5087019579358,40.8565507243109
8477,C5_02760W_A,503,C5,620204,621007,803,71.34542592308807,84.4693612853752
8479,C5_02770W_A,191,C5,621344,622543,1199,18.143784515760792,21.481319503200726
8481,C5_02780W_A,212,C5,623507,625951,2444,9.879804582848912,11.697186917591937
8483,C5_02790C_A,520,C5,626060,627808,1748,33.882512759193865,40.11517451165008
8485,C5_02800C_A,11,C5,628354,629076,722,1.7352784874647869,2.054481609604751
8487,C5_02810W_A,90,C5,629164,629673,509,20.139024132070347,23.84358188821517
8489,C5_02820C_A,407,C5,629720,630532,812,57.08895260361369,67.5904208361839
8491,C5_02830W_A,636,C5,630777,631655,878,82.50424510415516,97.6808365373395
8493,C5_02840C_A,762,C5,631817,636205,4388,19.77889603417538,23.417208508050642
8495,C5_02850W_A,969,C5,637935,638080,145,761.1486299956987,901.1613258611014
8497,C5_02860C_A,3856,C5,638962,639987,1025,428.47634926949587,507.2942389845796
8499,C5_02870C_A,9,C5,640712,641194,482,2.1267143741128227,2.517921821805295
8501,C5_02890W_A,3098,C5,641753,642208,455,775.5034102912662,918.1566567778392
8503,C5_02900W_A,1142,C5,642638,644950,2312,56.25899495118025,66.6077931219624
8505,C5_02910C_A,1062,C5,645248,647530,2282,53.005699711674374,62.75605676467921
8507,C5_02920W_A,847,C5,648510,649700,1190,81.06812792614906,95.98054672635843
8509,C5_02930C_A,3387,C5,649786,650901,1115,345.9824139539515,409.62560871341157
8511,C5_02940C_A,4591,C5,651905,653617,1712,305.4338929989647,361.61821900595197
8513,C5_02950C_A,18,C5,654469,654849,380,5.395138570117792,6.3875700953165895
8515,C5_02960C_A,32,C5,654930,655382,452,8.063530606272414,9.546810761928434
8517,C5_02970W_A,1511,C5,656966,659482,2516,68.40179880299935,80.9842562561579
8519,C5_02980C_A,103,C5,659648,660151,503,23.322920657655224,27.613153692367057
8521,C5_02990W_A,200,C5,660366,660920,554,41.11818404823026,48.68184188167477
8523,C5_03000C_A,368,C5,661022,664453,3431,12.216331125445643,14.463515692364908
8525,C5_03010W_A,506,C5,664894,666915,2021,28.51661015620015,33.76221831677041
8527,C5_03020W_A,1381,C5,668022,671636,3614,43.52304031892048,51.52906958464367
8529,C5_03030W_A,338,C5,672427,674499,2072,18.579783299708527,21.997519922845957
8531,C5_03040W_A,309,C5,674318,675910,1592,22.106964367086512,26.17352319207405
8533,C5_03050C_A,30,C5,676465,677187,722,4.732577693085783,5.603131662558413
8535,C5_03060C_A,170,C5,679515,681047,1532,12.638742081143363,14.963628813368572
8537,C5_03070W_A,4415,C5,682963,683640,677,742.7723600103906,879.4047553678519
8539,C5_03080C_A,426,C5,684022,686037,2015,24.07954319632391,28.5089563559374
8541,C5_03090W_A,976,C5,687505,688824,1319,84.2788725838298,99.781905355531
8543,C5_03100C_A,297,C5,688982,689980,998,33.89530945354565,40.13032514793088
8545,C5_03110C_A,100,C5,690600,691057,457,24.92283803361003,29.507374619745978
8547,C5_03120W_A,132,C5,691292,692740,1448,10.382909402897042,12.292837476253842
8549,C5_03130W_A,229,C5,697356,698426,1070,24.376166062910194,28.860142767105383
8551,C5_03140C_A,3095,C5,699595,705870,6275,56.177268457862205,66.51103310404464
8553,C5_03150W_A,3915,C5,709951,711870,1919,232.36487901002374,275.1082169765066
8555,C5_03160W_A,449,C5,712905,716690,3785,13.511207145655332,15.996583144912911
8557,C5_03170C_A,389,C5,716852,719299,2447,18.10628396301167,21.43692075306948
8559,C5_03210C_A,32,C5,726044,728167,2123,1.7167761818347296,2.0325758193083616
8561,C5_03240W_A,1271,C5,731795,732916,1121,129.13787424895884,152.89268533234247
8563,C5_03250W_A,199,C5,734682,736340,1658,13.670432203200223,16.18509752740385
8565,C5_03260C_A,852,C5,736879,740160,3281,29.576519073814495,35.017096651760966
8567,C5_03270W_A,185,C5,741739,742398,659,31.97422369577481,37.85585716580309
8569,C5_03280W_A,2528,C5,742816,744072,1256,229.24566153564913,271.41522188450676
8571,C5_03290C_A,274,C5,744290,744577,287,108.73825550148366,128.74057265279973
8573,C5_03300C_A,876,C5,745130,747427,2297,43.43669828328764,51.42684499900804
8575,C5_03310C_A,282,C5,748851,749972,1121,28.65214833847867,33.92268864179432
8577,C5_03320C_A,81,C5,754145,755731,1586,5.816952682787783,6.886976584483839
8579,C5_03330C_A,873,C5,756011,759739,3728,26.671782147873103,31.57803563752273
8581,C5_03340W_A,10,C5,760485,760805,320,3.5592928066749323,4.214021937882473
8583,C5_03350W_A,4843,C5,761964,763088,1124,490.75174555805546,581.0251457698168
8585,C5_03360W_A,453,C5,763489,763962,473,109.08141337327659,129.14685414702817
8587,C5_03370C_A,91,C5,764152,764667,515,20.125554666092047,23.827634724492736
8589,C5_03380W_A,124,C5,764896,766140,1244,11.353114032866667,13.441510489965959
8591,C5_03390C_A,397,C5,766244,766900,656,68.9287436219487,81.6081321628947
8593,C5_03400C_A,364,C5,767218,767744,526,78.81871219039851,93.31735272329855
8595,C5_03410C_A,346,C5,768110,768631,521,75.64009588388647,89.55403243039297
8597,C5_03420W_A,1,C5,769601,769694,93,1.224702901221482,1.4499860431423561
8599,C5_03430W_A,21,C5,772001,772828,827,2.892194396717721,3.4242112965622993
8601,C5_03440W_A,449,C5,775455,775670,215,237.86008858746712,281.61426606276916
8603,C5_03450W_A,4,C5,776792,776872,80,5.694868490679892,6.742435100611956
8605,C5_03460C_A,171,C5,777303,778316,1013,19.2265056644869,22.763206361394758
8607,C5_03470C_A,881,C5,778703,780199,1496,67.07458743701852,79.4129053962451
8609,C5_03480C_A,523,C5,780649,782214,1565,38.06282710064643,45.06445441047991
8611,C5_03490C_A,2770,C5,782698,784329,1631,193.43698000224774,229.01956135738956
8613,C5_03500W_A,5027,C5,785559,787265,1706,335.61669287981033,397.3531213455604
8615,C5_03510C_A,4469,C5,787678,789219,1541,330.3097635931011,391.0699865624248
8617,C5_03520W_A,190,C5,791003,792178,1175,18.41744703368816,21.805322027511007
8619,C5_03530C_A,74,C5,792460,793005,545,15.464963974690349,18.309732016340725
8621,C5_03540C_A,2646,C5,793426,793743,317,950.7017051317977,1125.5825410863872
8623,C5_03550W_A,3202,C5,794502,796880,2378,153.36391006860399,181.57508151521853
8625,C5_03560W_A,385,C5,797418,797924,506,86.66104224947662,102.60227327018193
8627,C5_03570W_A,685,C5,798357,798866,509,153.2803503385354,181.47615103808212
8629,C5_03580C_A,294,C5,798967,800349,1382,24.229975922719078,28.68706106483235
8631,C5_03590W_A,807,C5,801071,802807,1736,52.946530783164434,62.686003757993646
8633,C5_03600W_A,1013,C5,803133,804599,1466,78.70261638552157,93.17990118581052
8635,C5_03610W_A,731,C5,805339,807027,1688,49.32403870482229,58.397157091793126
8637,C5_03620W_A,1607,C5,807684,808682,998,183.3998730365248,217.13613640648126
8639,C5_03630C_A,239,C5,808679,809257,578,47.095971255103606,55.75923837530302
8641,C5_03640W_A,19,C5,809368,810267,899,2.407174667918086,2.8499725675556657
8643,C5_03650C_A,154,C5,810545,811666,1121,15.646917886970625,18.52515620863945
8645,C5_03670C_A,176,C5,813516,814376,860,23.309229171154904,27.596943667621026
8647,C5_03680W_A,848,C5,816570,818933,2363,40.87387625980997,48.39259386643198
8649,C5_03690W_A,252,C5,819887,821131,1244,23.072457550664513,27.31661809251146
8651,C5_03700C_A,46,C5,821296,822195,899,5.827896564433259,6.899933584608454
8653,C5_03710C_A,577,C5,822508,823392,884,74.3425140072918,88.01776138129182
8655,C5_03720C_A,6,C5,823474,823827,353,1.935932631392598,2.2920459265536395
8657,C5_03730W_A,68,C5,824224,825066,842,9.198362407748995,10.890393986736653
8659,C5_03740W_A,386,C5,825581,826402,821,53.54979871869521,63.40024235898209
8661,C5_03750W_A,661,C5,829497,829922,425,177.14390928656042,209.72939301197658
8663,C5_03760C_A,1131,C5,830628,833507,2879,44.74398237553983,52.97460297875736
8665,C5_03770C_A,30,C5,833913,835052,1139,2.999930723799767,3.551765636845631
8667,C5_03780C_A,51,C5,836229,836855,626,9.27917869088417,10.986076362019482
8669,C5_03790W_A,161,C5,837646,838218,572,32.05852541956163,37.95566612582255
8671,C5_03800W_A,1265,C5,838556,839140,584,246.71262468185148,292.0952192559631
8673,C5_03810C_A,167,C5,839331,840098,767,24.799036191487406,29.36079952548101
8675,C5_03820C_A,1261,C5,840571,842865,2294,62.608798315146856,74.12563785415587
8677,C5_03830C_A,383,C5,843215,843910,695,62.76646422821291,74.31230628875912
8679,C5_03840W_A,144,C5,844113,845093,980,16.735940054242946,19.814503152818812
8681,C5_03850W_A,421,C5,845502,845894,392,122.32345074368543,144.82475394681805
8683,C5_03860W_A,532,C5,846256,846864,608,99.6601985868981,117.99261426070923
8685,C5_03870C_A,1184,C5,847034,847642,608,221.8001412159537,262.60010391857094
8687,C5_03880C_A,246,C5,848550,850904,2354,11.902613837784651,14.092090354719975
8689,C5_03890C_A,12,C5,855432,855689,257,5.3181651274831685,6.296437448042293
8691,C5_03900W_A,6871,C5,856564,856818,254,3081.0583779103576,3647.8166595515545
8693,C5_03910C_A,14,C5,857664,858137,473,3.3711695082248836,3.9912935056476697
8695,C5_03920C_A,380,C5,858499,859104,605,71.5388438498631,84.6983582886791
8697,C5_03930C_A,558,C5,859535,861340,1805,35.210378036558225,41.687299569434586
8699,C5_03940C_A,624,C5,863687,865150,1463,48.57960270928576,57.515782676443756
8701,C5_03950W_A,502,C5,868673,871177,2504,22.834057366783593,27.03436438104794
8703,C5_03960W_A,1742,C5,872141,872530,389,510.04940415240986,603.8725935869423
8705,C5_03970W_A,256,C5,873670,875154,1484,19.64806379533763,23.262309781087072
8707,C5_03980W_A,1182,C5,876481,878958,2477,54.35070291468415,64.34847225614317
8709,C5_03990W_A,610,C5,879343,881022,1679,41.38022369642328,48.992083518443046
8711,C5_04000W_A,305,C5,881262,882376,1114,31.183750263148426,36.91997676277642
8713,C5_04010C_A,50,C5,882395,883033,638,8.92612616094027,10.568080095003067
8715,C5_04020C_A,21,C5,889328,889642,314,7.617340019380748,9.01854376514975
8717,C5_04030W_A,1006,C5,891519,892661,1142,100.33340983579636,118.78966219291816
8719,C5_04040C_A,14,C5,896436,896792,356,4.479110048849353,5.303038843177943
8721,C5_04050W_A,1668,C5,899279,902074,2795,67.97166828231884,80.47500356222355
8723,C5_04060C_A,623,C5,902120,909097,6977,10.17028255609452,12.04109808708972
8725,C5_04070C_A,271,C5,909565,909873,308,100.21489356975655,118.64934495232727
8727,C5_04080C_A,775,C5,910835,911500,665,132.7375362489298,157.1545023450907
8729,C5_04090C_A,2573,C5,912034,912363,329,890.7535943172865,1054.6070221200341
8731,C5_04100W_A,2221,C5,913806,915161,1355,186.69081797490836,221.03244809533805
8733,C5_04110W_A,441,C5,916837,918357,1520,33.04522374197148,39.12386683381411
8735,C5_04120C_A,214,C5,918450,919472,1022,23.849351409109527,28.236420969294684
8737,C5_04130C_A,1490,C5,919760,921511,1751,96.92009196017177,114.74846716061468
8739,C5_04140W_A,10,C5,924645,925907,1262,0.902514816272566,1.06853171166592
8741,C5_04150C_A,296,C5,926574,927257,683,49.361085600036546,58.44101873444038
8743,C5_04160W_A,109,C5,927500,927886,386,32.16272878156001,38.079037614855096
8745,C5_04170W_A,1007,C5,928229,929836,1607,71.37190504187494,84.50071121737697
8747,C5_04180W_A,210,C5,930400,931917,1517,15.766939789621324,18.667256046519586
8749,C5_04190W_A,105,C5,933743,934489,746,16.03113113998361,18.98004518939022
8751,C5_04200W_A,7,C5,936262,936849,587,1.3582309858521038,1.6080765146263607
8753,C5_04210C_A,4,C5,937203,937973,770,0.5916746483823264,0.7005127377259175
8755,C5_04220W_A,6,C5,939282,939923,641,1.0661220263363294,1.2622343402081664
8757,C5_04230W_A,3,C5,940661,941251,590,0.5791391685437179,0.6856713661639277
8759,C5_04240C_A,3,C5,942315,942626,311,1.0986884547935485,1.3007913377386409
8761,C5_04250W_A,227,C5,943001,943615,614,42.108636722616794,49.85448755175616
8763,C5_04260W_A,551,C5,944238,945479,1241,50.570065082427405,59.87238904814162
8765,C5_04270C_A,11743,C5,945967,947319,1352,989.2727912138162,1171.2487483208015
8767,C5_04280C_A,2281,C5,947806,949854,2048,126.85542018789877,150.1903756298425
8769,C5_04290C_A,995,C5,952051,953346,1295,87.5118787370887,103.60962046500225
8771,C5_04300C_A,1769,C5,954129,955433,1304,154.5126128836308,182.93508731568326
8773,C5_04310W_A,286,C5,956328,957911,1583,20.577793914522417,24.36306302937485
8775,C5_04320C_A,1144,C5,958126,960237,2111,61.72363385445568,73.07764808242612
8777,C5_04330W_A,353,C5,960735,961004,269,149.46383473680314,176.95759037293834
8779,C5_04340W_A,339,C5,961458,962357,899,42.94906381180163,50.84951054744056
8781,C5_04350C_A,853,C5,962394,963245,851,114.16504870857692,135.16562023083426
8783,C5_04360C_A,1085,C5,963406,964269,863,143.19657734386286,169.53747587865521
8785,C5_04370C_A,454,C5,965156,965782,626,82.60288481689045,97.79762094817343
8787,C5_04380C_A,88,C5,966890,968029,1139,8.799796789812651,10.418512534747183
8789,C5_04390C_A,31,C5,970181,970636,455,7.760040580706667,9.187493983251455
8791,C5_04400W_A,95,C5,971596,972795,1199,9.024395439776308,10.684425930911356
8793,C5_04410C_A,726,C5,973063,974205,1142,72.40760988149916,85.72693315313974
8795,C5_04420W_A,803,C5,974657,975694,1037,88.19632397330672,104.41996886772229
8797,C5_04430C_A,923,C5,975716,976726,1010,104.08640825539685,123.23302173989772
8799,C5_04440C_A,2868,C5,977029,977940,911,358.5704243967054,424.52917384314134
8801,C5_04460C_A,13,C5,979414,979596,182,8.13552641525699,9.632050143731366
8803,C5_04470C_A,10864,C5,979898,980725,827,1496.2285679019676,1771.4586440882294
8805,C5_04480C_A,31,C5,981163,981432,269,13.125719197849566,15.54018499025804
8807,C5_04490C_A,3054,C5,981844,982797,953,364.99744744042795,432.13844275485656
8809,C5_04500W_A,1,C5,983105,983407,302,0.37714360865429747,0.4465188808352289
8811,C5_04510W_A,961,C5,984134,987622,3488,31.380554011143214,37.152982406468404
8813,C5_04520W_A,340,C5,987850,989031,1181,32.79009799883426,38.821810909535394
8815,C5_04530W_A,521,C5,989261,990049,788,75.30524070163004,89.15758089895505
8817,C5_04540C_A,173,C5,990125,991027,902,21.84506095094504,25.863442847136767
8819,C5_04550W_A,662,C5,991257,992165,908,83.03971235308565,98.3148025683946
8821,C5_04560C_A,2098,C5,992382,992483,101,2365.9077412765178,2801.114621996808
8823,C5_04570C_A,1496,C5,993708,995429,1721,99.00666196463821,117.21886008733858
8825,C5_04580C_A,236,C5,996127,996717,590,45.55894792543914,53.939480804895645
8827,C5_04590C_A,1848,C5,997099,997750,651,323.32156592247134,382.79631538958193
8829,C5_04600C_A,2700,C5,998235,1000577,2342,131.3078131924484,155.4617828492936
8831,C5_04610W_A,532,C5,1002086,1003516,1430,42.373007511072764,50.16748914021763
8833,C5_04620C_A,275,C5,1003656,1004540,884,35.43187409359661,41.94953965312869
8835,C5_04630W_A,114,C5,1004884,1005222,338,38.41508922707146,45.48151487986763
8837,C5_04640C_A,2231,C5,1005350,1009294,3944,64.4282535634221,76.27978047396184
8839,C5_04650C_A,277,C5,1010220,1011953,1733,18.205176825370227,21.5540048802021
8841,C5_04660C_A,760,C5,1012145,1012900,755,114.65165703090643,135.7417397739096
8843,C5_04670W_A,1616,C5,1013409,1015016,1607,114.53525178517367,135.60392187416204
8845,C5_04680W_A,1908,C5,1015777,1018989,3212,67.65759078591056,80.10315175571365
8847,C5_04690C_A,38,C5,1019083,1019319,236,18.3394070038844,21.712926595191043
8849,C5_04700C_A,2198,C5,1020159,1022405,2246,111.46323190128587,131.96680633254746
8851,C5_04710W_A,234,C5,1022682,1024034,1352,19.713006313891935,23.33919842519523
8853,C5_04720C_A,448,C5,1024374,1025190,816,62.53188930942627,74.03458149691559
8855,C5_04730C_A,3419,C5,1025651,1029475,3824,101.83449461105937,120.56687033991777
8857,C5_04740C_A,447,C5,1031038,1032462,1424,35.75289628277966,42.329613623223935
8859,C5_04750C_A,1558,C5,1032682,1034379,1697,104.56812149062195,123.80334574841989
8861,C5_04760W_A,1,C5,1035099,1035171,72,1.5819079140777477,1.8728986390588769
8863,C5_04770W_A,568,C5,1035440,1036315,875,73.93566406185552,87.53607170623064
8865,C5_04780W_A,494,C5,1036647,1038047,1400,40.18950049136952,47.58232771003294
8867,C5_04790C_A,132,C5,1038042,1038692,650,23.12992740829987,27.384659485562405
8869,C5_04800W_A,353,C5,1039131,1040645,1514,26.555991772919445,31.44094571355377
8871,C5_04810W_A,4801,C5,1041193,1044156,2963,184.54987258693325,218.4976774757881
8873,C5_04820W_A,2,C5,1051679,1051990,311,0.7324589698623655,0.8671942251590941
8875,C5_04830W_A,606,C5,1053827,1055971,2144,32.19300657977625,38.11488499039967
8877,C5_04840C_A,239,C5,1058090,1058830,740,36.785772142499845,43.552486190439396
8879,C5_04850W_A,69,C5,1059037,1059795,758,10.36796638144888,12.275145697684037
8881,C5_04860C_A,136,C5,1059960,1060479,519,29.845938910692308,35.33607605715707
8883,C5_04870W_A,529,C5,1061084,1061869,785,76.75376895718887,90.87256479550891
8885,C5_04880C_A,2360,C5,1062043,1063830,1787,150.41846265254108,178.08782134800467
8887,C5_04890C_A,260,C5,1064216,1065337,1121,26.416874354625726,31.276237754845827
8889,C5_04900C_A,493,C5,1065586,1066695,1109,50.632464669164776,59.9462669901117
8891,C5_04910W_A,211,C5,1066921,1067634,713,33.70595375970427,39.90613762213528
8893,C5_04920C_A,1590,C5,1067875,1073664,5789,31.282918984905955,37.03738749342895
8895,C5_04930C_A,45,C5,1074184,1075950,1766,2.902254610199266,3.436122078454564
8897,C5_04940W_A,1106,C5,1078889,1080637,1748,72.06549829167002,85.32189040362498
8899,C5_04950C_A,997,C5,1080794,1083001,2207,51.452504623541934,60.917152653467326
8901,C5_04960W_A,3673,C5,1088502,1091030,2528,165.48458834072187,195.92534908661165
8903,C5_04970C_A,234,C5,1091679,1094261,2582,10.322224839807086,12.220990035191308
8905,C5_04980W_A,214,C5,1095645,1097372,1727,14.113513109501989,16.709682820277457
8907,C5_04990W_A,56,C5,1097648,1098139,491,12.9903313840356,15.379892693860267
8909,C5_05000C_A,1231,C5,1098208,1100409,2201,63.701800200154,75.41969658203834
8911,C5_05010W_A,71,C5,1100839,1101153,314,25.7538638750492,30.491267015506303
8913,C5_05020C_A,1348,C5,1101230,1102420,1190,129.01987773842848,152.75298345588095
8915,C5_05030C_A,497,C5,1102463,1104616,2153,26.2921471422936,31.128567069244237
8917,C5_05040W_A,271,C5,1104724,1106172,1448,21.316427637765898,25.23756784897569
8919,C5_05050W_A,26790,C5,1107880,1108932,1052,2900.4853016219454,3434.0273069466593
8921,C5_05060C_A,110,C5,1109074,1109559,485,25.83239315359951,30.58424169349753
8923,C5_05070W_A,531,C5,1109829,1112132,2303,26.261182531923776,31.091906542986962
8925,C5_05080W_A,1385,C5,1119031,1121088,2057,76.68831171212106,90.7950667413472
8927,C5_05090W_A,115,C5,1121545,1122810,1265,10.354306346690713,12.258972910203555
8929,C5_05100C_A,282,C5,1122899,1124587,1688,19.027878132366464,22.528041449911985
8931,C5_05110C_A,955,C5,1125159,1127513,2354,46.20730168733473,54.707098734786896
8933,C5_05120W_A,2215,C5,1127776,1129365,1589,158.76820272946458,187.9734895891187
8935,C5_05130C_A,220,C5,1129420,1130145,725,34.561960495160726,40.91960612785187
8937,C5_05140W_A,319,C5,1130266,1131324,1058,34.34145649389198,40.65854058781123
8939,C5_05150C_A,243,C5,1131319,1132620,1301,21.273682447889527,25.186959714814844
8941,C5_05160C_A,654,C5,1132798,1133319,521,142.97289800017847,169.2726508944422
8943,C5_05170W_A,912,C5,1133822,1135915,2093,49.62943204491219,58.758727298214076
8945,C5_05180W_A,20,C5,1137147,1138370,1223,1.8625898579492695,2.205211807232038
8947,C5_05190W_A,1081,C5,1139258,1140172,914,134.70793957166222,159.48735981972703
8949,C5_05200C_A,2101,C5,1140239,1141543,1304,183.51102298954683,217.26773230652944
8951,C5_05210W_A,1148,C5,1141882,1143330,1448,90.2998484433773,106.91043502075311
8953,C5_05220W_A,279,C5,1143525,1144814,1289,24.652727833975018,29.187577859902802
8955,C5_05230C_A,8604,C5,1144905,1146224,1319,742.9666185566307,879.6347476219146
8957,C5_05240C_A,71,C5,1146493,1147437,944,8.56643353470916,10.142222291174765
8959,C5_05250C_A,591,C5,1147626,1148381,755,89.15674908587592,105.5570634294481
8961,C5_05260W_A,120,C5,1148532,1149152,620,22.044652221986677,26.099748776562414
8963,C5_05270C_A,669,C5,1149197,1150108,911,83.64142744818547,99.02720268516791
8965,C5_05280C_A,192,C5,1150249,1150743,494,44.26780365224856,52.41083155131561
8967,C5_05290C_A,525,C5,1150915,1151262,347,172.323109948527,204.02181140180267
8969,C5_05300W_A,1181,C5,1151677,1152390,713,188.65749474033524,223.3608935153638
8971,C5_05310W_A,1334,C5,1152535,1153125,590,257.5238836124398,304.89520082089325
8973,C5_05320C_A,1518,C5,1153178,1154074,896,192.9645171618767,228.46018934662837
8975,C5_05330C_A,707,C5,1154306,1155292,986,81.66880371015586,96.69171635157511
8977,C5_05340W_A,1287,C5,1155735,1156982,1247,117.55085400970364,139.1742417720543
8979,C5_05350W_A,434,C5,1157179,1158453,1274,38.80020290353333,45.937469916257285
8981,C5_05360C_A,2622,C5,1158484,1161177,2693,110.89450562616173,131.29346330341292
8983,C5_05370C_A,764,C5,1161357,1164347,2990,29.102873089494565,34.45632385864572
8985,C5_05380W_A,2268,C5,1164505,1165881,1376,187.7320019892732,222.2651570957546
8987,C5_05390C_A,2187,C5,1165900,1167255,1355,183.83287659213173,217.64879062787227
8989,C5_05400W_A,953,C5,1168093,1169409,1316,82.48039014616926,97.65259347846799
8991,C5_05410C_A,1507,C5,1169457,1171226,1769,97.02845466879138,114.87676310483005
8993,C5_05430W_A,1563,C5,1172085,1172609,524,339.7358569058272,402.2300023762018
8995,C5_05440C_A,5711,C5,1172634,1174892,2258,288.0725770617614,341.0633025650565
8997,C5_05450C_A,532,C5,1175166,1175846,680,89.10794226593242,105.49927863310472
8999,C5_05460C_A,150,C5,1175896,1176357,461,37.0598817180904,43.87701800832076
9001,C5_05470W_A,1250,C5,1176356,1178194,1838,77.46012636942181,91.70885610190363
9003,C5_05480W_A,3698,C5,1178288,1179400,1112,378.77021004557986,448.4446942817089
9005,C5_05490C_A,1904,C5,1179397,1180902,1505,144.09341669441216,170.59928812711183
9007,C5_05500C_A,730,C5,1182110,1182868,758,109.69007910808234,129.86748346825138
9009,C5_05510C_A,10,C5,1188747,1189058,311,3.6622948493118272,4.33597112579547
9011,C6_00010W_A,1,C6,5,346,341,0.3340098821513133,0.39545073903882444
9013,C6_00020W_A,41,C6,3622,4008,386,12.09790715636661,14.323307726688611
9015,C6_00030W_A,90,C6,5545,6069,524,19.562525349663755,23.161036605155573
9017,C6_00060W_A,1,C6,6928,7038,110,1.0354306346690711,1.2258972910203558
9019,C6_00070C_A,361,C6,7276,9894,2618,15.705481475442634,18.594492523460016
9021,C6_00080C_A,470,C6,10260,11345,1085,49.338031163493994,58.41372345230635
9023,C6_00090W_A,131,C6,11580,11948,368,40.544987623862276,48.00320642283512
9025,C6_00100C_A,1799,C6,11950,12543,593,345.533504712753,409.09412296799024
9027,C6_00110C_A,243,C6,12648,13433,785,35.25740237541946,41.74297399869313
9029,C6_00120W_A,92,C6,13533,13778,245,42.76962458306531,50.637063612759185
9031,C6_00130C_A,4255,C6,13792,16029,2237,216.64430422747375,256.495854743888
9033,C6_00140C_A,90,C6,16129,16587,458,22.38157922101268,26.498653233846113
9035,C6_00150W_A,6140,C6,17283,18128,845,827.6092907165571,979.8473732013588
9037,C6_00160W_A,222,C6,18356,18682,326,77.56201257245007,91.8294841923837
9039,C6_00170C_A,1931,C6,18679,20661,1982,110.96661004543766,131.37883127428546
9041,C6_00180C_A,36,C6,20920,21525,605,6.777364154197557,8.024054995769601
9043,C6_00190W_A,519,C6,21616,22845,1229,48.09823835090096,56.94587172038413
9045,C6_00200C_A,796,C6,22858,23190,332,273.0792360591081,323.3119481980191
9047,C6_00210W_A,934,C6,23379,24626,1247,85.30885597907007,101.00135339168511
9049,C6_00220C_A,6,C6,24672,24754,82,8.333953888799844,9.866978196017495
9051,C6_00230W_A,188,C6,24834,25922,1088,19.68079551926139,23.30106248005602
9053,C6_00240C_A,313,C6,25917,26810,893,39.921474525930705,47.26499857763812
9055,C6_00250W_A,884,C6,26954,28600,1646,61.169668842782805,72.42178163962295
9057,C6_00260W_A,1357,C6,28770,29879,1109,139.36765630031766,165.00422780036834
9059,C6_00270W_A,515,C6,30052,30744,692,84.76466106069782,100.35705424321264
9061,C6_00280W_A,9441,C6,32516,35077,2561,419.8770278837084,497.1130791478132
9063,C6_00290W_A,3978,C6,39723,41777,2054,220.58604533519582,261.1626760490201
9065,C6_00300C_A,2095,C6,43796,46627,2831,84.28646759430855,99.79089746225395
9067,C6_00310W_A,1712,C6,47121,49541,2420,80.57532938879318,95.39709828303857
9069,C6_00320C_A,529,C6,49594,53874,4280,14.077502016680668,16.667047515064134
9071,C6_00330C_A,10397,C6,54332,56071,1739,680.9608705876807,806.2230907540253
9073,C6_00340C_A,1102,C6,57603,59954,2351,53.387878151673675,63.208536630152075
9075,C6_00350W_A,1113,C6,60860,63445,2585,49.03975729305005,58.06058233641089
9077,C6_00360C_A,201,C6,63637,64182,545,42.00618593125352,49.73319101735792
9079,C6_00370C_A,2231,C6,64428,65978,1550,163.9387303575076,194.09513173503575
9081,C6_00380C_A,247,C6,66443,67438,995,28.274020446189613,33.475004419118655
9083,C6_00390W_A,539,C6,67494,68984,1490,41.20180022116056,48.78083918429321
9085,C6_00400C_A,133,C6,69031,70365,1334,11.355584846483142,13.444435807816943
9087,C6_00410C_A,1237,C6,70595,73825,3230,43.619519027684376,51.64329547651386
9089,C6_00420W_A,296,C6,74105,74448,343,98.29044158841096,116.37089153242793
9091,C6_00430C_A,476,C6,74582,76120,1538,35.25042134673119,41.73470881523135
9093,C6_00440C_A,2692,C6,76654,78531,1877,163.35200827821276,193.400482587612
9095,C6_00450C_A,13,C6,78916,79317,401,3.6924334353535464,4.371653681194784
9097,C6_00460C_A,251,C6,80175,82049,1874,15.255197344297256,18.061378978160093
9099,C6_00470C_A,92,C6,83656,85536,1880,5.573701075984575,6.59897903464149
9101,C6_00480C_A,3703,C6,87450,89309,1859,226.87571835382076,268.6093295058211
9103,C6_00490W_A,351,C6,92659,94050,1391,28.74045780343123,34.02724256383603
9105,C6_00500C_A,251,C6,94193,95188,995,28.73189931981212,34.017109753841225
9107,C6_00510C_A,512,C6,95673,97367,1694,34.42470681497172,40.75710474041701
9109,C6_00520W_A,71,C6,97678,97992,314,25.7538638750492,30.491267015506303
9111,C6_00530C_A,91,C6,98053,98313,260,39.86407943475925,47.19704570428369
9113,C6_00540W_A,416,C6,98512,100356,1844,25.694851324542682,30.421399152435722
9115,C6_00550W_A,1316,C6,100547,101452,905,165.6231366571213,196.08938325757643
9117,C6_00560W_A,685,C6,101799,103787,1988,39.24532108768336,46.46446724264778
9119,C6_00570C_A,1457,C6,103938,105929,1991,83.34930578523961,98.6813454705336
9121,C6_00580W_A,6,C6,107349,107708,359,1.9035772113693235,2.2537387522936903
9123,C6_00590W_A,1153,C6,107872,109443,1571,83.59240445262783,98.96916194787507
9125,C6_00600C_A,1334,C6,109686,110591,905,167.88849870866244,198.77145688875908
9127,C6_00610C_A,8,C6,111167,111499,332,2.744514935267418,3.249366313547931
9129,C6_00620W_A,328,C6,112252,112774,522,71.56769597482776,84.73251773949126
9131,C6_00630W_A,75,C6,112915,113313,398,21.463072201054867,25.411187565120436
9133,C6_00640C_A,317,C6,113323,114414,1091,33.09391955170533,39.18152019970651
9135,C6_00650C_A,2171,C6,114676,115535,859,287.85935956381945,340.8108638749373
9137,C6_00660C_A,213,C6,115818,116422,604,40.16579432168268,47.55426080895187
9139,C6_00670W_A,313,C6,116838,118541,1703,20.93357413485386,24.784288743294685
9141,C6_00680C_A,179,C6,118692,119232,540,37.75486888265558,44.699847518871856
9143,C6_00690W_A,300,C6,119448,120974,1526,22.391357106211895,26.51022975338908
9145,C6_00700C_A,391,C6,121065,121958,893,49.869956995651464,59.043496625739635
9147,C6_00710W_A,419,C6,122466,124409,1943,24.561501776581313,29.079570840518883
9149,C6_00720C_A,839,C6,124508,125947,1439,66.4071530740852,78.62269700366132
9151,C6_00730W_A,167,C6,126536,128452,1916,9.927380354316723,11.753514215054244
9153,C6_00740W_A,1436,C6,129790,131742,1952,83.78925361287219,99.20222135736444
9155,C6_00750C_A,11340,C6,131977,133230,1253,1030.8030117208298,1220.418420445963
9157,C6_00760W_A,345,C6,134254,135108,854,46.01240349612559,54.476349173562646
9159,C6_00770C_A,280,C6,135141,136989,1848,17.25717724448452,20.431621517005926
9161,C6_00780W_A,1003,C6,137336,140659,3323,34.378291279879214,40.70215110390486
9163,C6_00790C_A,17271,C6,140815,141570,755,2605.458906027349,3084.731036362095
9165,C6_00800C_A,3821,C6,142324,144471,2147,202.70230556951904,239.98923632452988
9167,C6_00810C_A,44,C6,149369,150541,1172,4.276010470817666,5.062579256432186
9169,C6_00820W_A,1776,C6,158273,159529,1256,161.05233183833582,190.67778246316615
9171,C6_00830C_A,343,C6,159840,161719,1879,20.79127080684623,24.615808829269838
9173,C6_00840W_A,118,C6,165020,165511,491,27.3724839877893,32.40763103349128
9175,C6_00850W_A,2293,C6,167136,167621,485,538.4879772836698,637.5424200289985
9177,C6_00860W_A,74,C6,169118,169807,689,12.232808949501074,14.483024599282576
9179,C6_00870C_A,5508,C6,170116,171318,1202,521.9190623405133,617.9256661259676
9181,C6_00880W_A,812,C6,172250,173392,1142,80.98481986746187,95.88191421535741
9183,C6_00890W_A,5221,C6,174611,176875,2264,262.6582013236724,310.9739722640903
9185,C6_00900C_A,203,C6,176941,177840,899,25.718760925651125,30.44970690598948
9187,C6_00910C_A,3441,C6,178343,181033,2690,145.69548309613018,172.49605339186425
9189,C6_00920W_A,1961,C6,182690,183145,455,490.8851477021216,581.1830871340679
9191,C6_00930C_A,1665,C6,183350,184084,734,258.36392471340656,305.8897668261283
9193,C6_00940C_A,166,C6,184756,185646,890,21.243779088828365,25.151555656215383
9195,C6_00950C_A,1836,C6,186531,188873,2342,89.28931297086491,105.71401233751965
9197,C6_00960W_A,2235,C6,191051,192766,1715,148.4318492906071,175.73577201011918
9199,C6_00970C_A,393,C6,192961,193944,983,45.53577450330005,53.91204464985755
9201,C6_00980C_A,331,C6,194243,195295,1052,35.83652985579932,42.428631526664596
9203,C6_00990W_A,143,C6,195918,196958,1040,15.660888349369705,18.54169652668288
9205,C6_01000C_A,262,C6,197030,198280,1250,23.87288871293011,28.264287941765318
9207,C6_01010W_A,44,C6,198680,199057,377,13.29306172890797,15.738310049173798
9209,C6_01020W_A,44,C6,199256,200110,854,5.868248561824712,6.947708300396394
9211,C6_01030W_A,271,C6,200518,201594,1076,28.686047601751877,33.962823648063946
9213,C6_01040C_A,505,C6,201650,204145,2495,23.05337545325327,27.29402585818868
9215,C6_01050W_A,502,C6,204367,205872,1505,37.991016376362865,44.97943415956414
9217,C6_01060C_A,1563,C6,205994,207700,1706,104.35028664633847,123.54544035470677
9219,C6_01070C_A,953,C6,209410,210309,899,120.73881360662818,142.9486240463447
9221,C6_01080C_A,218,C6,211793,212791,998,24.87938539014462,29.45592889646105
9223,C6_01090C_A,124,C6,212992,213913,921,15.3347164569882,18.155525569508846
9225,C6_01100W_A,1787,C6,214553,216145,1592,127.84836674428351,151.3659739295674
9227,C6_01110W_A,2834,C6,218197,219507,1310,246.40087484865364,291.72612328449287
9229,C6_01120C_A,33,C6,219755,220552,797,4.715951322269421,5.583446883819185
9231,C6_01130W_A,27,C6,220839,221612,773,3.978303990901865,4.7101099021092585
9233,C6_01140C_A,271,C6,221639,222187,548,56.325159159644194,66.68612818488467
9235,C6_01150W_A,440,C6,224375,226279,1904,26.3208207552432,31.162515170895595
9237,C6_01160W_A,144,C6,226945,227577,632,25.951299451199507,30.725020711649417
9239,C6_01170W_A,406,C6,228067,229164,1097,42.15344771588033,49.90754149222341
9241,C6_01180C_A,621,C6,229417,230640,1223,57.833415089324824,68.47182661455477
9243,C6_01190C_A,588,C6,232244,236857,4613,14.518025894297752,17.188605415824103
9245,C6_01200W_A,72,C6,237060,237734,674,12.16707808097781,14.405202588844535
9247,C6_01210W_A,451,C6,237854,238266,412,124.67891695614716,147.61350632893166
9249,C6_01220C_A,766,C6,238369,240150,1781,48.9867407508231,57.99781344265871
9251,C6_01250W_A,446,C6,242012,242335,323,157.27005243611342,186.19975571968624
9253,C6_01260W_A,508,C6,244222,244632,410,141.12161918367732,167.08083078589627
9255,C6_01280W_A,930,C6,245451,247826,2375,44.599812179640416,52.80391278795047
9257,C6_01290C_A,706,C6,247958,250051,2093,38.419275245293875,45.486470912871866
9259,C6_01300W_A,386,C6,251632,252873,1241,35.426579168451866,41.94327073064005
9261,C6_01310W_A,25,C6,253187,253984,797,3.572690395658652,4.229884002893322
9263,C6_01320W_A,1657,C6,254510,265975,11465,16.46122475195217,19.48925418528393
9265,C6_01330C_A,91,C6,266126,266865,739,14.02525122197213,16.60518522748817
9267,C6_01340C_A,162,C6,267237,267944,707,26.098124342012515,30.89885392642537
9269,C6_01350W_A,666,C6,268142,270265,2123,35.73040428443531,42.302984239355276
9271,C6_01360W_A,123,C6,272338,272679,341,41.08321550461154,48.6404409017754
9273,C6_01370W_A,522,C6,274059,275504,1445,41.144932209479634,48.713510346289844
9275,C6_01380C_A,143,C6,275554,276168,614,26.526586129225556,31.40613092467458
9277,C6_01390W_A,630,C6,276517,277704,1187,60.45100504007299,71.5709201918371
9279,C6_01400W_A,112,C6,278810,280840,2030,6.28399281730195,7.4399283868821575
9281,C6_01410C_A,368,C6,281102,282313,1211,34.61125688802973,40.97797055367795
9283,C6_01420C_A,1794,C6,282711,283952,1241,164.65099230104312,194.9384137066535
9285,C6_01430C_A,1876,C6,284857,285648,791,270.12827531012584,319.8181605246025
9287,C6_01440C_A,159,C6,287462,288292,830,21.818893735375973,25.832462192706046
9289,C6_01450C_A,724,C6,289441,290394,953,86.52853698325796,102.44539376375772
9291,C6_01460C_A,822,C6,292746,293900,1154,81.12966896601164,96.05340819242682
9293,C6_01470W_A,172,C6,294635,296263,1628,12.033383051559476,14.246914463209539
9295,C6_01480W_A,74,C6,296921,297466,545,15.464963974690349,18.309732016340725
9297,C6_01490C_A,240,C6,297609,298052,443,61.70512134370989,73.05573020979094
9299,C6_01500C_A,543,C6,298211,301176,2965,20.85877632673984,24.695731936811413
9301,C6_01510W_A,100,C6,304773,305993,1220,9.335849984721134,11.053172296085174
9303,C6_01520W_A,462,C6,306695,308335,1640,32.08572247187939,37.98786605466736
9305,C6_01530C_A,81,C6,310350,310466,116,79.53178409397779,94.1615936464773
9307,C6_01540C_A,8,C6,310465,310526,61,14.937359975553814,17.685075673736275
9309,C6_01550C_A,646,C6,314026,317713,3687,19.955980715916517,23.62686777865649
9311,C6_01560W_A,243,C6,319706,320740,1034,26.766983428147267,31.690749118930473
9313,C6_01570C_A,537,C6,321477,324401,2924,20.917540215424776,24.765305396912588
9315,C6_01590W_A,2239,C6,328457,329938,1481,172.1919048025966,203.86647117177813
9317,C6_01600W_A,51,C6,330122,330472,350,16.596473887124255,19.64938229321199
9319,C6_01610W_A,5188,C6,331191,332384,1193,495.3055780326451,586.4166521705755
9321,C6_01620W_A,900,C6,334854,336653,1799,56.98034065160537,67.46182980045315
9323,C6_01630W_A,1492,C6,337224,338591,1367,124.31227195456327,147.17941726573574
9325,C6_01640W_A,213,C6,339591,340175,584,41.541335223110174,49.18283138460092
9327,C6_01650C_A,786,C6,340292,347998,7706,11.617354356798325,13.754357615055795
9329,C6_01660C_A,4,C6,348429,348812,383,1.1895286664605518,1.4083415353758655
9331,C6_01670W_A,233,C6,350639,352531,1892,14.026473132435674,16.606631907426912
9333,C6_01680C_A,93,C6,352702,353787,1085,9.762631698308386,11.558460172477638
9335,C6_01690W_A,914,C6,354147,356351,2204,47.23330127478604,55.921830144821485
9337,C6_01700W_A,2810,C6,356945,357782,837,382.3794613813738,452.7178645811134
9339,C6_01710C_A,1830,C6,358106,360544,2438,85.49310367468583,101.21949330697193
9341,C6_01720C_A,3682,C6,364197,365009,812,516.465659672004,611.4691142968774
9343,C6_01730W_A,6,C6,365969,366277,308,2.2187799314337244,2.6269227664721906
9345,C6_01740C_A,2372,C6,366437,368230,1793,150.67739051748697,178.39437879142847
9347,C6_01750C_A,152,C6,368561,369448,887,19.51792583051508,23.108233039301403
9349,C6_01760W_A,1755,C6,369850,372375,2525,79.16431050410465,93.72652357682362
9351,C6_01770W_A,216,C6,372715,373851,1136,21.656542147655927,25.640246157256733
9353,C6_01780C_A,136,C6,374139,375542,1403,11.04065737323543,13.071577671892031
9355,C6_01790C_A,505,C6,376564,378156,1592,36.1295048717757,42.77549906795274
9357,C6_01800W_A,1,C6,378683,378755,72,1.5819079140777477,1.8728986390588769
9359,C6_01810W_A,34,C6,378946,380427,1481,2.6147944454168313,3.0957838409291893
9361,C6_01820C_A,678,C6,380495,381680,1185,65.16659639967877,77.15394089814185
9363,C6_01830W_A,518,C6,381840,382496,656,89.9372523832983,106.48113969868882
9365,C6_01840C_A,526,C6,382542,383525,983,60.94610022579091,72.15708775019102
9367,C6_01850W_A,1034,C6,383676,385970,2294,51.338221616068076,60.781847376048496
9369,C6_01860C_A,289,C6,386043,386584,541,60.84351178582213,72.03562824683382
9371,C6_01870C_A,222,C6,386807,388339,1532,16.50471024714016,19.540738803340133
9373,C6_01880W_A,177,C6,389289,389918,629,32.0506112194067,37.94629611473183
9375,C6_01890C_A,784,C6,390049,391773,1724,51.795555646090904,61.32330764361687
9377,C6_01900C_A,470,C6,392015,392737,722,74.14371719167727,87.78239604674845
9379,C6_01910W_A,2948,C6,393707,394456,749,448.2903153678056,530.7529686676648
9381,C6_01920C_A,948,C6,394669,396216,1547,69.79619042229525,82.63514512450077
9383,C6_01930W_A,1081,C6,397028,397942,914,134.70793957166222,159.48735981972703
9385,C6_01940W_A,147,C6,398675,398908,233,71.85799726437288,85.07621972445988
9387,C6_01950C_A,820,C6,399034,400629,1595,58.55538761576817,69.3266054232201
9389,C6_01960W_A,321,C6,400918,402603,1685,21.6979559110771,25.68927795010609
9391,C6_01970C_A,3236,C6,402753,403626,873,422.1900214396365,499.8515460614041
9393,C6_01980C_A,736,C6,403985,404632,647,129.56485963339722,153.39821434468007
9395,C6_01990W_A,18,C6,405913,407730,1817,1.1283173674434568,1.3358704657238878
9397,C6_02000W_A,213,C6,409352,411181,1829,13.264155150517409,15.704086128270603
9399,C6_02010C_A,14296,C6,411489,412604,1115,1460.337936193,1728.9659587147717
9401,C6_02020C_A,2346,C6,414633,415973,1340,199.40539521097054,236.08586188112906
9403,C6_02030C_A,1571,C6,416245,417378,1133,157.92830359855446,186.97909166922125
9405,C6_02040W_A,7108,C6,417949,418854,905,894.5663034641475,1059.1210761359068
9407,C6_02050W_A,366,C6,419022,420419,1397,29.83996947156536,35.329008544366154
9409,C6_02060W_A,1933,C6,422258,424654,2396,91.88798658167137,108.79070992890577
9411,C6_02070C_A,1754,C6,424970,425898,928,215.27584768647696,254.87567169123642
9413,C6_02080W_A,1,C6,425509,425817,308,0.369796655238954,0.43782046107869843
9415,C6_02090C_A,853,C6,426472,429609,3137,30.970499346827847,36.66749850699393
9417,C6_02100W_A,8356,C6,434385,434888,503,1892.100242867641,2240.1506044021276
9419,C6_02110W_A,246,C6,436350,437441,1091,25.681716749903824,30.405848483053003
9421,C6_02120W_A,5065,C6,437978,442957,4979,115.86466722351337,137.1778822438223
9423,C6_02130C_A,32,C6,443134,444234,1100,3.3133780309410277,3.9228713312651378
9425,C6_02140W_A,502,C6,444603,447512,2909,19.655029098118295,23.270556345872823
9427,C6_02150C_A,81,C6,447639,449000,1361,6.77860907781148,8.02552892210975
9429,C6_02160W_A,192,C6,449471,451141,1670,13.09478742767113,15.503563345119707
9431,C6_02170C_A,169,C6,451184,452335,1151,16.723419199390126,19.799679096497318
9433,C6_02180W_A,293,C6,453038,453583,545,61.23289789978747,72.49664163226801
9435,C6_02190C_A,521,C6,454198,455418,1220,48.639778420397114,57.58702766260375
9437,C6_02200C_A,362,C6,458121,458522,401,102.82006950753721,121.73374096865477
9439,C6_02210W_A,672,C6,460066,460428,362,211.43379147717613,250.32687224371458
9441,C6_02220W_A,1153,C6,461384,462114,730,179.89543478777853,212.98705947960508
9443,C6_02230W_A,1294,C6,463058,465112,2054,71.75423395267556,84.9533692326375
9445,C6_02240C_A,5002,C6,465254,465907,653,872.4573412061508,1032.9451875424504
9447,C6_02250W_A,176,C6,466317,467456,1139,17.599593579625303,20.837025069494366
9449,C6_02260C_A,2431,C6,467667,470486,2819,98.22082512126866,116.28846917054037
9451,C6_02270C_A,375,C6,470964,472793,1829,23.35238582837572,27.64803895822289
9453,C6_02280W_A,493,C6,474133,475320,1187,47.30531029326347,56.00708516599317
9455,C6_02290C_A,810,C6,475632,478013,2381,38.74711026838062,45.8746109323451
9457,C6_02300C_A,110,C6,478575,478916,341,36.741087036644466,43.499581294270676
9459,C6_02310W_A,596,C6,479401,481050,1649,41.16605967792864,48.73852419605489
9461,C6_02320C_A,573,C6,481253,482839,1586,41.149554163424696,48.71898250505234
9463,C6_02330W_A,364,C6,486452,487012,560,74.0332903788386,87.65165630795542
9465,C6_02340W_A,2732,C6,489805,491106,1301,239.17572200672507,283.1719092217043
9467,C6_02350C_A,364,C6,491416,493362,1946,21.30454399391039,25.223498218116667
9469,C6_02360W_A,277,C6,493517,494062,545,57.88912190525982,68.5377806557619
9471,C6_02370C_A,643,C6,494226,495677,1451,50.47278345289002,59.757212538848904
9473,C6_02380W_A,1409,C6,496005,497672,1667,96.26958252391083,113.9782970217426
9475,C6_02390W_A,12,C6,497760,497843,83,16.467089611604507,19.496197881287586
9477,C6_02400W_A,8,C6,498068,498158,90,10.124210650097584,11.98655128997681
9479,C6_02410W_A,1586,C6,499151,500542,1391,129.86429081550406,153.7527256588147
9481,C6_02420W_A,1542,C6,501489,502706,1217,144.3136764606145,170.8600645052364
9483,C6_02430W_A,2223,C6,503335,507153,3818,66.31583370760293,78.51457951105489
9485,C6_02440C_A,685,C6,507225,508085,860,90.72057944455177,107.40855916091138
9487,C6_02450W_A,3159,C6,508862,509665,803,448.071969167068,530.4944578538772
9489,C6_02460C_A,661,C6,509769,510749,980,76.82261372121242,90.9540735000919
9491,C6_02470W_A,1038,C6,511041,512948,1907,61.99552693577061,73.39955568364142
9493,C6_02480W_A,1171,C6,514254,515363,1109,120.26494143527779,142.38758345927144
9495,C6_02490C_A,939,C6,515648,516388,740,144.52652737157888,171.1120691749899
9497,C6_02500C_A,1612,C6,517713,518897,1184,155.06972984756732,183.59468550990664
9499,C6_02510C_A,15,C6,519240,519686,446,3.8306290296053085,4.5352702470484
9501,C6_02520W_A,2721,C6,520747,521556,809,383.08373703683526,453.55169119320476
9503,C6_02530C_A,538,C6,521838,522290,452,135.56810831795497,160.50575593492178
9505,C6_02540C_A,192,C6,522595,523275,680,32.15925735913351,38.07492762698517
9507,C6_02550W_A,52,C6,523443,524150,707,8.377175714720067,9.91815064305012
9509,C6_02560W_A,1988,C6,524474,525520,1046,216.47033574515535,256.2898848951543
9511,C6_02570C_A,292,C6,525572,526570,998,33.3246813482671,39.45473044847076
9513,C6_02580W_A,456,C6,526774,528267,1493,34.787140411922714,41.186207714387834
9515,C6_02590C_A,485,C6,528273,529094,821,67.28407351960409,79.66092628006818
9517,C6_02600W_A,1880,C6,529546,532056,2510,85.30958376476651,101.00221505299184
9519,C6_02610C_A,978,C6,532206,533732,1526,72.99582416625078,86.42334899604839
9521,C6_02620C_A,39,C6,534068,534433,365,12.169855952685799,14.408491447883085
9523,C6_02630C_A,768,C6,534981,537278,2297,38.081488905896016,45.086549040226224
9525,C6_02640C_A,567,C6,537774,538826,1052,61.387650840598845,72.67986125564599
9527,C6_02650C_A,1252,C6,539180,540637,1457,97.87200206357205,115.87548038388701
9529,C6_02660C_A,313,C6,541584,543302,1718,20.750801368833596,24.5678950697502
9531,C6_02670C_A,1250,C6,547501,548802,1301,109.43252288009015,129.56254997332738
9533,C6_02680W_A,210,C6,552562,553404,842,28.406707435695427,33.632099076686714
9535,C6_02690C_A,1362,C6,553947,555881,1934,80.21107429478813,94.96583874905362
9537,C6_02710C_A,151,C6,558152,559408,1256,13.693075511029674,16.21190605401919
9539,C6_02720C_A,448,C6,561383,563818,2435,20.955245041680424,24.80994599650231
9541,C6_02730W_A,9754,C6,564311,566254,1943,571.7730031712987,676.9502004258261
9543,C6_02740W_A,1001,C6,566592,566915,323,352.9760593913667,417.9057297654841
9545,C6_02750C_A,232,C6,567103,568881,1778,14.861749042044265,17.595556168076197
9547,C6_02760W_A,34,C6,569269,569946,677,5.7201042447006305,6.772312951870207
9549,C6_02770W_A,599,C6,570239,570931,692,98.59035335020968,116.72597182851335
9551,C6_02780C_A,922,C6,571363,572925,1562,67.23007360316083,79.59699312118083
9553,C6_02790C_A,1432,C6,573291,575498,2207,73.90169169600006,87.49585015021587
9555,C6_02800W_A,293,C6,576265,576792,527,63.324344127863704,74.97280776012535
9557,C6_02810C_A,749,C6,577043,580438,3395,25.127873340319525,29.7501260109476
9559,C6_02820W_A,7,C6,582651,582959,308,2.588576586672678,3.064743227550889
9561,C6_02830W_A,509,C6,583525,586143,2618,22.1442938254856,26.217719375183236
9563,C6_02840C_A,537,C6,586391,587995,1604,38.13147605355489,45.14573128464613
9565,C6_02850W_A,487,C6,588696,589763,1067,51.985022585962646,61.547626879063216
9567,C6_02860W_A,1592,C6,590320,593553,3233,56.085559153494515,66.40245394478337
9569,C6_02870W_A,627,C6,594266,594967,701,101.87396700873873,120.61360365431374
9571,C6_02880W_A,252,C6,596395,597093,698,41.120540391155664,48.68463167204048
9573,C6_02890C_A,2607,C6,597534,598598,1064,279.0699653233549,330.40466743036404
9575,C6_02900C_A,208,C6,599811,601172,1361,17.406798619565286,20.608765627146024
9577,C6_02910W_A,228,C6,601321,602160,839,30.95184781585257,36.645416041466646
9579,C6_02920C_A,667,C6,602192,603142,950,79.96794280596816,94.67798341280367
9581,C6_02930W_A,3436,C6,603414,606363,2949,132.7064641164877,157.11771451815991
9583,C6_02940C_A,605,C6,606561,607859,1298,53.08775711650747,62.853208565026705
9585,C6_02950C_A,141,C6,608693,609775,1082,14.842448376818203,17.57270516055981
9587,C6_02960W_A,120,C6,610396,611592,1196,11.42782974718373,13.529970101562453
9589,C6_02970C_A,497,C6,611719,613338,1619,34.96417096810261,41.39580290307773
9591,C6_02980C_A,3397,C6,614384,616048,1664,232.51764738989897,275.2890869805146
9593,C6_02990W_A,344,C6,617910,619601,1691,23.170133185025225,27.43226108350695
9595,C6_03000C_A,78,C6,620109,620915,806,11.02232611099334,13.049874388281207
9597,C6_03010W_A,827,C6,621127,629748,8621,10.92600914462886,12.93583999119844
9599,C6_03020W_A,108,C6,630448,632880,2432,5.05794240948543,5.988346964359303
9601,C6_03030W_A,203,C6,635173,636429,1256,18.408571713503473,21.794814099111896
9603,C6_03040C_A,822,C6,637254,640202,2948,31.758357526043902,37.60028258278852
9605,C6_03050C_A,345,C6,640436,641836,1400,28.067566132636614,33.23057299587321
9607,C6_03060W_A,39,C6,643530,645755,2225,1.9964033360585691,2.3636401701021685
9609,C6_03070C_A,144,C6,646161,646484,323,50.77777477757922,60.11830677945026
9611,C6_03080C_A,2550,C6,646612,647655,1043,278.4643269651721,329.6876223693286
9613,C6_03090W_A,29,C6,648469,650490,2021,1.6343511749600879,1.934988796810952
9615,C6_03100W_A,871,C6,652168,653727,1559,63.63348884390232,75.33881940517016
9617,C6_03110C_A,96,C6,653804,654937,1133,9.650615624100082,11.425838828927587
9619,C6_03120W_A,542,C6,655158,658325,3167,19.49238220365331,23.077990682233533
9621,C6_03130W_A,1222,C6,658611,658802,191,728.7046382838563,862.749287219666
9623,C6_03140C_A,840,C6,659079,661430,2351,40.69493434428847,48.18073572534278
9625,C6_03150C_A,755,C6,661783,663006,1223,70.31276713758493,83.24674572300943
9627,C6_03160C_A,2260,C6,663217,665157,1940,132.6845648343975,157.09178688023735
9629,C6_03170C_A,686,C6,666383,668077,1694,46.12372827162228,54.60815205454311
9631,C6_03180C_A,3164,C6,669284,672274,2990,120.52551106696441,142.69608467114534
9633,C6_03190C_A,6,C6,672825,673145,320,2.1355756840049596,2.5284131627294837
9635,C6_03200W_A,1000,C6,674165,675106,941,121.03865017385532,143.3036153158758
9637,C6_03210C_A,203,C6,675261,676253,992,23.30762708887133,27.59504688355296
9639,C6_03220W_A,267,C6,676467,677552,1085,28.028200682240207,33.18396630162935
9641,C6_03230W_A,674,C6,677961,678998,1037,74.02779870237698,87.6451544418989
9643,C6_03240W_A,246,C6,679400,680431,1031,27.176288044757584,32.175345000010495
9645,C6_03250W_A,2844,C6,682709,685078,2369,136.73453767407017,161.88674905985988
9647,C6_03260W_A,5539,C6,685751,686608,857,736.1464777100564,871.5600471946237
9649,C6_03270C_A,511,C6,686774,687667,893,65.17531464137569,77.16426285358811
9651,C6_03280W_A,18,C6,688257,689066,809,2.5341812813903104,3.0003419483563714
9653,C6_03290W_A,1172,C6,689317,690756,1439,92.76422336451472,109.828129783422
9655,C6_03300C_A,650,C6,690878,692836,1958,37.8106692435335,44.765912312541076
9657,C6_03310W_A,426,C6,693653,695770,2117,22.91935736447458,27.135355246676365
9659,C6_03320W_A,1396,C6,696248,697177,929,171.1525600212945,202.63593972990935
9661,C6_03330C_A,748,C6,697118,699883,2765,30.812019030947987,36.47986586081551
9663,C6_03340C_A,2328,C6,700203,702257,2054,129.09107932135143,152.83728251435866
9665,C6_03350C_A,1013,C6,703285,704691,1406,82.06119176470456,97.1562838822178
9667,C6_03360C_A,71,C6,704980,705516,536,15.087151598443,17.862421348636154
9669,C6_03370W_A,9029,C6,710076,711305,1229,836.761067572803,990.6826122607869
9671,C6_03380W_A,2238,C6,712164,713270,1106,230.4722546499385,272.86744584393415
9673,C6_03390W_A,219,C6,714482,715531,1049,23.77838321179974,28.15239822753133
9675,C6_03400C_A,1611,C6,715854,716237,383,479.08267041698724,567.2095533726298
9677,C6_03410C_A,741,C6,716494,717594,1100,76.72541002897819,90.83898926460834
9679,C6_03420W_A,72,C6,717849,720047,2198,3.730942050308937,4.417245925787633
9681,C6_03430C_A,1292,C6,720171,724973,4802,30.64460678866481,36.281658267349634
9683,C6_03440W_A,404,C6,725374,727680,2306,19.95426600376996,23.624837646550134
9685,C6_03450C_A,709,C6,727787,730372,2585,31.239162552356238,36.98558209929499
9687,C6_03460W_A,1427,C6,730859,734344,3485,46.63745960516617,55.21638386555674
9689,C6_03470W_A,1761,C6,737336,739201,1865,107.54598833337576,127.32898887053786
9691,C6_03480W_A,1224,C6,739894,741762,1868,74.63082476008766,88.35910667183121
9693,C6_03490C_A,172,C6,741928,743103,1175,16.6726362620756,19.73955467753628
9695,C6_03500C_A,201,C6,744962,746215,1253,18.270847033146982,21.631755071396697
9697,C6_03510C_A,9,C6,746965,747312,347,2.9541104562604628,3.4975167668880465
9699,C6_03520C_A,63,C6,748178,750613,2435,2.9468313339863093,3.4888986557581374
9701,C6_03530C_A,239,C6,751488,751889,401,67.88396854226903,80.3711715235041
9703,C6_03540W_A,844,C6,752357,753754,1397,68.81129572131466,81.46907981269136
9705,C6_03550C_A,519,C6,753856,755475,1619,36.51188074938683,43.22821268953187
9707,C6_03560W_A,1362,C6,756804,758795,1991,77.9147251060373,92.24707792097925
9709,C6_03570W_A,3,C6,759011,759733,722,0.4732577693085783,0.5603131662558413
9711,C6_03580W_A,374,C6,759950,762031,2081,20.469781984760015,24.235182389513422
9713,C6_03590C_A,790,C6,762043,762732,689,130.59350094737633,154.61607342477345
9715,C6_03600C_A,93,C6,763188,764768,1580,6.7040856915598726,7.9372970171761
9717,C6_03610W_A,278,C6,767669,769633,1964,16.121929128401323,19.08754539684444
9719,C6_03620C_A,1077,C6,769693,771234,1541,79.60250959717384,94.24532905073428
9721,C6_03630W_A,334,C6,771818,772507,689,55.212948501802146,65.36932724541055
9723,C6_03640W_A,1677,C6,772812,775011,2199,86.86034069004256,102.83823250319463
9725,C6_03650C_A,604,C6,775110,776588,1478,46.545339220171236,55.107318007708
9727,C6_03660C_A,1145,C6,776892,778082,1190,109.59032641728533,129.74938134791074
9729,C6_03670C_A,552,C6,780255,780551,296,212.40320316589867,251.47460645525672
9731,C6_03690W_A,502,C6,782435,786478,4043,14.142092418111828,16.74351927037943
9733,C6_03700W_A,8915,C6,791291,795073,3782,268.48097617351266,317.86784199870743
9735,C6_03710W_A,710,C6,797842,803514,5672,14.257251863126669,16.879862205340228
9737,C6_03720W_A,3372,C6,804198,807107,2909,132.02541457939222,156.31138645076328
9739,C6_03730C_A,673,C6,807280,808662,1382,55.465216993163054,65.66800032868085
9741,C6_03740W_A,78,C6,808828,809445,617,14.398695049368936,17.047323755193926
9743,C6_03750C_A,876,C6,809483,810148,665,150.036234521371,177.635282650709
9745,C6_03760C_A,7256,C6,810622,812034,1412,585.2969655576954,692.9618851280503
9747,C6_03770C_A,2674,C6,813339,814145,806,377.8679489845665,447.3764630033839
9749,C6_03780C_A,1432,C6,815053,816966,1913,85.25929616992792,100.94267709436821
9751,C6_03790C_A,4873,C6,817349,818989,1640,338.4279775010136,400.68153957661053
9753,C6_03800C_A,2868,C6,822645,824495,1850,176.57170628399925,209.05193371410905
9755,C6_03810W_A,614,C6,826674,828011,1337,52.305897580814566,61.92752657854511
9757,C6_03820C_A,634,C6,828137,829087,950,76.01150785454846,89.99376534290485
9759,C6_03830W_A,3651,C6,830112,831827,1715,242.47189340492463,287.0744087735773
9761,C6_03840C_A,6656,C6,832295,836782,4487,168.9549573165383,200.03408972441798
9763,C6_03850C_A,33,C6,838281,839459,1178,3.190673347919125,3.7775952176603487
9765,C6_03860C_A,91,C6,841828,842499,671,15.446588156538606,18.28797598079547
9767,C6_03870C_A,1,C6,843109,843181,72,1.5819079140777477,1.8728986390588769
9769,C6_03880W_A,258,C6,843973,844755,782,37.57739310985709,44.48972521631419
9771,C6_03890C_A,430,C6,844807,845961,1154,42.440094471271294,50.2469166943352
9773,C6_03900W_A,1362,C6,846169,848565,2396,64.74466514445753,76.65439571814261
9775,C6_03910C_A,179,C6,848580,849431,851,23.957261100627512,28.364180564266512
9777,C6_03920W_A,1157,C6,849768,850778,1010,130.47451175676505,154.47519626550562
9779,C6_03930W_A,1157,C6,851234,853390,2156,61.122104301638544,72.36546763829344
9781,C6_03940C_A,1194,C6,853685,855274,1589,85.58430431556691,101.3274702344956
9783,C6_03950C_A,360,C6,855600,856616,1016,40.35733576072365,47.78103614606898
9785,C6_03960W_A,3170,C6,857389,859491,2102,171.76720376265706,203.36364670732542
9787,C6_03990C_A,167,C6,863059,864597,1538,12.367269674168297,14.642219269209319
9789,C6_04030W_A,384,C6,876301,877632,1331,32.85994741429119,38.90450907039806
9791,C6_04040C_A,2743,C6,877853,879175,1322,236.32411906104304,279.7957561418849
9793,C6_04050W_A,308,C6,879657,880859,1202,29.18501655789363,34.5535775538849
9795,C6_04060W_A,721,C6,881371,884007,2636,31.153263898180597,36.88388245478924
9797,C6_04070C_A,28,C6,884108,885451,1343,2.3746287079528963,2.811439803680339
9799,C6_04080W_A,2489,C6,886488,887828,1340,211.56011452689927,250.47643231974862
9801,C6_04100W_A,2663,C6,890053,891459,1406,215.72453471807327,255.40689435177296
9803,C6_04110W_A,741,C6,892609,894141,1532,55.090046365454306,65.22381735709477
9805,C6_04120C_A,327,C6,894295,897546,3251,11.456302654274529,13.563680577669084
9807,C6_04130C_A,5533,C6,898452,904754,6302,99.99907127556916,118.39382231572819
9809,C6_04140C_A,1296,C6,907998,910160,2162,68.27520410657854,80.83437456422844
9811,C6_04150W_A,4,C6,911713,911964,251,1.8150975269099257,2.1489832989998265
9813,C6_04160C_A,1425,C6,913551,916088,2537,63.97467559494557,75.7427671925269
9815,C6_04170C_A,606,C6,916379,919258,2879,23.97422928344574,28.38427003105832
9817,C6_04180W_A,1874,C6,920228,923212,2984,71.52938037221259,84.68715401170782
9819,C6_04190C_A,198,C6,923628,924761,1133,19.904394724706417,23.56579258466315
9821,C6_04210C_A,618,C6,928032,930284,2252,31.25602777300331,37.0055496641047
9823,C6_04220C_A,1506,C6,930975,932251,1276,134.42745998376049,159.15528623074619
9825,C6_04230W_A,79,C6,933892,935499,1607,5.599186194943515,6.629152121323516
9827,C6_04240W_A,98,C6,935982,936497,515,21.673674255791436,25.66052970329987
9829,C6_04250W_A,2923,C6,936924,937175,251,1326.3825177894284,1570.3695457441233
9831,C6_04260C_A,162,C6,937516,938199,683,27.01518874056054,31.98461160465994
9833,C6_04270W_A,2315,C6,939854,945904,6050,43.58221671379819,51.599131431129514
9835,C6_04280W_A,800,C6,946421,947119,698,130.54139806716083,154.554386260446
9837,C6_04290W_A,1162,C6,948163,950031,1868,70.85050520524662,83.88340028812732
9839,C6_04300W_A,293,C6,950494,952914,2420,13.790053452638087,16.326723012225646
9841,C6_04310W_A,609,C6,953455,954192,737,94.11600843484544,111.42857466140246
9843,C6_04320C_A,27,C6,954379,954726,347,8.862331368781387,10.492550300664139
9845,C6_04330W_A,404,C6,954954,957020,2066,22.272283351739365,26.369252474803776
9847,C6_04340W_A,264,C6,957364,958923,1559,19.287303162790142,22.835187512014837
9849,C6_04350C_A,1978,C6,959560,961938,2378,94.73885512670165,112.16599351564717
9851,C6_04360C_A,648,C6,964395,965546,1151,64.12293278819409,75.91829618065243
9853,C6_04370W_A,248,C6,965838,968477,2639,10.703504249250575,12.67240549413994
9855,C6_04380W_A,2589,C6,971215,978303,7088,41.602749780954404,49.25554310238248
9857,C6_04400W_A,143,C6,983785,984099,314,51.870458227211756,61.411988496019724
9859,C6_04410C_A,538,C6,984319,985389,1070,57.268023326837046,67.80243147905107
9861,C6_04420W_A,1942,C6,985842,986297,455,486.1289937978176,575.5520424346557
9863,C6_04430W_A,191,C6,987663,988814,1151,18.900432349606593,22.37715211497626
9865,C6_04440C_A,350,C6,988798,991299,2501,15.939256071475109,18.871269773803952
9867,C6_04450W_A,239,C6,991302,992492,1190,22.87518603819318,27.083058639432902
9869,C6_04460W_A,1,C6,992696,992810,114,0.9990997352069986,1.1828833509845538
9871,C6_04470C_A,1502,C6,992873,995203,2330,73.42225298713474,86.9282190654005
9873,C6_04480C_A,473,C6,995286,995987,701,76.85229090132921,90.98920977430686
9875,C6_04490W_A,504,C6,997774,999153,1379,41.62746510953829,49.28480479635135
9877,C6_04500C_A,1151,C6,999224,1003501,4277,30.651361387760367,36.28965536967202
9879,C6_04510C_A,194,C6,1003604,1005055,1451,15.228180388585791,18.02939227455161
9881,C6_04520W_A,4876,C6,1005227,1008493,3266,170.04396056677987,201.3234142717936
9883,C6_04530C_A,872,C6,1008502,1011345,2843,34.93440255978098,41.36055861930092
9885,C6_04540C_A,355,C6,1012024,1013172,1148,35.22087655385648,41.69972928078823
9887,C6_04550C_A,538,C6,1013238,1015511,2273,26.958550356232134,31.91755463378119
9889,C6_04560W_A,1237,C6,1015669,1016658,989,142.4580853988074,168.66313891722928
9891,C6_04570W_A,3580,C6,1016757,1019129,2372,171.90243842018563,203.52375767445872
9893,C6_04580W_A,1538,C6,1019276,1020757,1481,118.28099579562019,140.038692569091
9895,C6_04590C_A,369,C6,1021000,1021746,746,56.33797514908526,66.70130166557135
9897,C6_04600W_A,312,C6,1021987,1023228,1241,28.634955182790115,33.90233281854843
9899,C6_04610C_A,108,C6,1023237,1024922,1685,7.300246848586686,8.643121553306722
9901,C6_04620C_A,9,C6,1025130,1026875,1745,0.5874362913022237,0.6954947381720069
9903,C6_04650W_A,2459,C6,1028580,1031093,2513,111.44991339898014,131.95103790214722
9905,C7_00010C_A,1084,C7,117,1155,1038,118.94484477643553,140.82465605131716
9907,C7_00020C_A,2937,C7,1246,2040,794,421.3055102550842,498.80432973544873
9909,C7_00030W_A,1171,C7,2278,2769,491,271.63710804831584,321.6045418662566
9911,C7_00040C_A,235,C7,2747,3421,674,39.71199095874702,47.016980671923136
9913,C7_00050C_A,2087,C7,3464,5761,2297,103.48446269089189,122.52034875905224
9915,C7_00060C_A,747,C7,5799,6467,668,127.36726833945747,150.79637784901593
9917,C7_00070C_A,1133,C7,6523,7476,953,135.40998950556806,160.3185512905214
9919,C7_00080C_A,1952,C7,7583,9430,1847,120.37231503851814,142.51470835294572
9921,C7_00090C_A,2489,C7,10024,13080,3056,92.76523346401996,109.82932568994214
9923,C7_00100W_A,840,C7,14047,15825,1778,53.809781014298196,63.70804819475864
9925,C7_00110W_A,12953,C7,15982,16662,680,2169.57739881696,2568.6694664184315
9927,C7_00120W_A,816,C7,16744,17208,464,200.30227105149964,237.1477173318688
9929,C7_00130W_A,741,C7,17255,18298,1043,80.91845736517354,95.80334438261667
9931,C7_00140C_A,511,C7,18321,18851,530,109.81425655612924,130.01450326085697
9933,C7_00150W_A,2123,C7,19179,19871,692,349.4279134599252,413.70490516182605
9935,C7_00160C_A,644,C7,19888,20349,461,159.11042550966815,188.37866398239046
9937,C7_00170W_A,1509,C7,21072,23375,2303,74.62923623478903,88.35722593854486
9939,C7_00180W_A,35,C7,23536,25842,2306,1.728711163692942,2.0467062317555804
9941,C7_00190W_A,357,C7,26062,27036,974,41.74677723147272,49.426064289906954
9943,C7_00200W_A,350,C7,27138,28232,1094,36.43882946504501,43.141723678504285
9945,C7_00210C_A,474,C7,28225,30591,2366,22.817985330365754,27.015335906086786
9947,C7_00220W_A,96,C7,30551,31618,1067,10.24756092043617,12.13259174618084
9949,C7_00230W_A,261,C7,31779,33545,1766,16.83307673915574,19.92950805503647
9951,C7_00240W_A,212,C7,33810,34454,644,37.4941652181409,44.39118761893586
9953,C7_00250C_A,485,C7,34632,35195,563,98.11762763693598,116.16628858958431
9955,C7_00260C_A,1021,C7,35365,38295,2930,39.68915173368035,46.98994018924783
9957,C7_00270W_A,356,C7,38507,39679,1172,34.596811991161125,40.96086852931496
9959,C7_00280W_A,211,C7,41587,43167,1580,15.210344956119712,18.008276028216745
9961,C7_00290C_A,288,C7,43379,45102,1723,19.03798172159964,22.54000358649151
9963,C7_00300W_A,1177,C7,46309,47109,800,167.57150533825586,198.3961528355068
9965,C7_00310C_A,527,C7,47152,47988,836,71.79894006192113,85.00629899575361
9967,C7_00320C_A,1304,C7,48461,51214,2753,53.94920822264133,63.87312292915358
9969,C7_00330C_A,217,C7,51707,52855,1148,21.529380879399593,25.4896936730452
9971,C7_00340C_A,1986,C7,52951,55866,2915,77.59868831897266,91.8729064138274
9973,C7_00350C_A,4935,C7,56058,57377,1319,426.1436846323771,504.53248250978015
9975,C7_00360W_A,3494,C7,59071,60084,1013,392.8503555071183,465.11487150124725
9977,C7_00370W_A,133,C7,60279,61298,1019,14.865898120911199,17.600468466759374
9979,C7_00380W_A,144,C7,61437,62255,818,20.050392730022114,23.738646809000528
9981,C7_00390W_A,2964,C7,62478,63944,1466,230.280903224764,272.6408954735858
9983,C7_00400W_A,916,C7,64158,65279,1121,93.06868041860449,110.18859147476452
9985,C7_00410C_A,561,C7,65303,68746,3443,18.55835738176834,21.972152724038963
9987,C7_00420C_A,259,C7,69078,69539,461,63.9900624332361,75.7609844277005
9989,C7_00430W_A,2510,C7,70601,72361,1760,162.43318081371055,192.3126375288183
9991,C7_00440C_A,1664,C7,72658,74332,1674,113.21697931291925,134.04315421049338
9993,C7_00450C_A,257,C7,74657,75454,797,36.72725726737095,43.483207549743355
9995,C7_00460W_A,84,C7,75620,76342,722,13.251217540640194,15.688768655163553
9997,C7_00470C_A,512,C7,76425,77930,1505,38.74780953127049,45.875438824097294
9999,C7_00480W_A,9,C7,79446,80990,1544,0.6639095390688993,0.7860351801231555
10001,C7_00490C_A,103,C7,81174,81905,731,16.048466608482325,19.000569503776514
10003,C7_00500W_A,1,C7,81346,81816,470,0.2423348293906337,0.2869121319409343
10005,C7_00510W_A,875,C7,82584,83879,1295,76.95768230648503,91.1139878461075
10007,C7_00520W_A,1829,C7,84177,87452,3275,63.60863798139555,75.30939724591919
10009,C7_00530C_A,116,C7,87578,88111,533,24.788170541045687,29.34793514712896
10011,C7_00540W_A,4,C7,88271,88384,113,4.031765303136207,4.773405380964217
10013,C7_00550C_A,2133,C7,88681,91080,2399,101.26848262292796,119.89674088874784
10015,C7_00560C_A,162,C7,91359,92165,806,22.89252346129386,27.103585267968658
10017,C7_00570W_A,2188,C7,92423,95923,3500,71.20212718632916,84.29970285793691
10019,C7_00580C_A,229,C7,96043,96723,680,38.35661424604986,45.41228347176876
10021,C7_00590W_A,309,C7,96928,97902,974,36.133765166736886,42.780543040843824
10023,C7_00600C_A,443,C7,97943,99298,1355,37.23729507558955,44.08706641433353
10025,C7_00610C_A,588,C7,99537,101327,1790,37.414331536533815,44.29666859396458
10027,C7_00620W_A,2508,C7,101629,103806,2177,131.21479260105806,155.35165119278628
10029,C7_00630C_A,125,C7,103977,105816,1839,7.741800558292404,9.165898722963508
10031,C7_00640C_A,18,C7,106320,106646,326,6.288811830198654,7.445633853436515
10033,C7_00650W_A,5,C7,114110,114475,365,1.5602379426520252,1.847242493318344
10035,C7_00660W_A,8232,C7,115894,117909,2015,465.3117361317804,550.9054664837481
10037,C7_00670C_A,1235,C7,122844,126245,3401,41.35938009990983,48.967405758634314
10039,C7_00680W_A,85,C7,126561,127202,641,15.103395373097996,17.881653152949024
10041,C7_00690W_A,766,C7,127379,128182,803,108.6492967337683,128.63524998925922
10043,C7_00700W_A,1897,C7,129228,129608,380,568.587659306303,673.1789150453095
10045,C7_00710W_A,1443,C7,131585,131860,275,597.650562330988,707.5879163769492
10047,C7_00720W_A,1987,C7,132567,134273,1706,132.6577220513593,157.06000638822925
10049,C7_00730W_A,3329,C7,135510,136031,521,727.7626566400522,861.6340287883762
10051,C7_00740W_A,4306,C7,137282,143053,5771,84.98389783700439,100.61661945324929
10053,C7_00750W_A,1738,C7,143529,143912,383,516.8502055771098,611.9243971208135
10055,C7_00760C_A,67,C7,144060,144569,509,14.992384631652367,17.75022207233796
10057,C7_00770W_A,1530,C7,145917,146819,902,193.19620378581453,228.73449454404198
10059,C7_00780W_A,1148,C7,148191,150485,2294,56.998335024416015,67.4831342240848
10061,C7_00790W_A,543,C7,150850,153243,2393,25.84466017918246,30.598765228853257
10063,C7_00800C_A,233,C7,153347,153889,542,48.96326045492306,57.97001396467106
10065,C7_00810W_A,599,C7,154466,155746,1280,53.300409779957114,63.10497851979002
10067,C7_00820W_A,227,C7,156150,157241,1091,23.698169521252712,28.057429291272484
10069,C7_00830C_A,1530,C7,157502,159808,2306,75.56937372714862,89.47030098817253
10071,C7_00840C_A,236,C7,160710,163940,3230,8.321913088547706,9.85272249996546
10073,C7_00850W_A,482,C7,165660,168671,3011,18.23265767192101,21.586540807007392
10075,C7_00860W_A,2117,C7,171720,172424,704,342.50103962412874,405.503838295327
10077,C7_00870W_A,506,C7,174289,176121,1832,31.45855301620115,37.24532926757259
10079,C7_00880C_A,1259,C7,176562,179318,2756,52.0307650926414,61.601783684110686
10081,C7_00890C_A,1114,C7,188023,188811,788,161.01734768064466,190.63636299699795
10083,C7_00900W_A,15,C7,189687,189995,308,5.54694982858431,6.567306916180478
10085,C7_00910C_A,289,C7,190074,191255,1181,27.87158329900912,32.99853927310509
10087,C7_00920C_A,295,C7,191453,192481,1028,32.68455651265697,38.6968551494266
10089,C7_00930W_A,10570,C7,195079,197781,2702,445.55706844179474,527.5169431048732
10091,C7_00940W_A,1204,C7,198460,200568,2108,65.05333645899991,77.01984687985573
10093,C7_00950W_A,519,C7,200872,201708,836,70.70901307805894,83.71588079467953
10095,C7_00960W_A,3669,C7,202217,203082,865,483.109190573515,571.9767487663645
10097,C7_00970C_A,374,C7,205033,206040,1007,42.301505769896316,50.08283470961016
10099,C7_00980W_A,1359,C7,209134,211122,1988,77.86042534038202,92.1827897558516
10101,C7_00990W_A,3378,C7,211801,212739,938,410.1762422498225,485.6278415749933
10103,C7_01000C_A,1,C7,211827,212249,422,0.26989898060094275,0.3195466872327941
10105,C7_01010W_A,154,C7,212898,214127,1229,14.271924289092002,16.897233612599532
10107,C7_01020C_A,308,C7,214245,214766,521,67.33280211629202,79.71861846404921
10109,C7_01030C_A,1562,C7,214925,218578,3653,48.701804448080985,57.66046332962428
10111,C7_01040C_A,646,C7,218779,220611,1832,40.16250049103941,47.55036108073497
10113,C7_01050W_A,76,C7,221546,222589,1043,8.299328960530621,9.825984039242737
10115,C7_01060W_A,7,C7,222726,223154,428,1.8628074502223948,2.2054694254338174
10117,C7_01070C_A,2303,C7,223296,226653,3357,78.13692066747566,92.51014618236124
10119,C7_01100C_A,194,C7,230874,232412,1538,14.36676836400389,17.00952418099765
10121,C7_01130C_A,2,C7,236122,236562,440,0.5177153173345356,0.6129486455101779
10123,C7_01150W_A,246,C7,244441,245340,899,31.166577279360478,36.89964482203652
10125,C7_01160C_A,647,C7,245475,245753,278,265.07769161653886,313.8385259061824
10127,C7_01170C_A,350,C7,246116,247258,1142,34.907249942871495,41.32841129972303
10129,C7_01180W_A,307,C7,248250,249536,1286,27.190118610244586,32.19171968721416
10131,C7_01190W_A,194,C7,249860,250768,908,24.33490059894051,28.81128655327576
10133,C7_01200C_A,681,C7,250792,252975,2183,35.53097061065512,42.06686489708421
10135,C7_01210C_A,336,C7,253347,254183,836,45.776933322211576,54.19756444511046
10137,C7_01220W_A,463,C7,254404,255339,935,56.40051574726824,66.77534655793231
10139,C7_01230C_A,2127,C7,255373,256806,1433,169.05771499896903,200.1557496022558
10141,C7_01250W_A,4829,C7,257912,259124,1212,453.80395943058085,537.2808432484346
10143,C7_01260W_A,1,C7,258488,258578,90,1.265526331262198,1.4983189112471011
10145,C7_01270C_A,430,C7,259274,261082,1808,27.08842313044639,32.071317403353326
10147,C7_01280C_A,237,C7,261260,262552,1292,20.892938580358116,24.736178310294637
10149,C7_01290W_A,171,C7,263352,263858,506,38.491008375741565,45.57139929662627
10151,C7_01300C_A,85,C7,263896,264606,710,13.635600611487064,16.14385869160609
10153,C7_01310C_A,3,C7,264744,265073,329,1.0385778402455732,1.2296234226040044
10155,C7_01320W_A,967,C7,266119,267939,1820,60.51580033502698,71.6476345306787
10157,C7_01330C_A,585,C7,268107,273401,5294,12.585939051937048,14.901112708190384
10159,C7_01340W_A,553,C7,273669,275717,2048,30.75451440767559,36.41178330701574
10161,C7_01350C_A,239,C7,275786,276745,959,28.38526734666307,33.60671510002622
10163,C7_01360C_A,56,C7,277182,277736,554,11.513091533504475,13.630915726868935
10165,C7_01370W_A,186,C7,278053,279501,1448,14.630463249536739,17.32172553472132
10167,C7_01380W_A,44,C7,281375,282502,1127,4.4467473574075465,5.264723059927703
10169,C7_01390W_A,711,C7,285900,286292,392,206.58426004456138,244.58527329260718
10171,C7_01400C_A,401,C7,286775,289093,2318,19.70355707301671,23.32801100384292
10173,C7_01410C_A,1042,C7,290111,291139,1028,115.44850130911377,136.68516293458478
10175,C7_01420W_A,483,C7,292252,293031,779,70.6192934787776,83.60965734520089
10177,C7_01430C_A,2612,C7,295832,296773,941,316.15295425411006,374.3090432050676
10179,C7_01440W_A,178,C7,302675,303043,368,55.09166257288157,65.22573086461567
10181,C7_01450C_A,2722,C7,303151,305370,2219,139.71547572447648,165.4160283358787
10183,C7_01460C_A,316,C7,305828,308848,3020,11.9177380334758,14.109996634393232
10185,C7_01470C_A,1436,C7,309229,310165,936,174.7399818935112,206.88326505296516
10187,C7_01480W_A,519,C7,310445,311785,1340,44.11398129347558,52.228713689815
10189,C7_01490W_A,437,C7,312570,313262,692,71.92651822043679,85.15734505686198
10191,C7_01500W_A,218,C7,313805,315115,1310,18.953913449896437,22.440471021884065
10193,C7_01510W_A,1439,C7,317084,318727,1643,99.7555174447762,118.10546694802927
10195,C7_01520W_A,1975,C7,320555,322387,1832,122.7878304486112,145.37455593568353
10197,C7_01530W_A,7,C7,322903,323229,326,2.4456490450772543,2.8955242763364226
10199,C7_01540W_A,90,C7,325170,326693,1523,6.73063905661445,7.968734852988524
10201,C7_01550W_A,2547,C7,329715,336473,6758,42.926398478134615,50.822675943352024
10203,C7_01560C_A,29,C7,336677,337897,1220,2.7073964955691294,3.2054199658647002
10205,C7_01570C_A,103,C7,338747,339883,1136,10.326962227817411,12.2265988620252
10207,C7_01580W_A,1023,C7,340590,343976,3386,34.411402634173236,40.74135326595412
10209,C7_01590C_A,266,C7,344244,345575,1331,22.762359406774625,26.949477637306988
10211,C7_01600W_A,585,C7,345794,346918,1124,59.279325036436596,70.18371056686823
10213,C7_01610W_A,234,C7,347245,347582,337,79.08600752635577,93.63381682748947
10215,C7_01620C_A,328,C7,347813,349792,1979,18.877381151521014,22.349860667010827
10217,C7_01630W_A,135,C7,350989,352284,1295,11.873470984429119,14.057586696256587
10219,C7_01640W_A,4014,C7,352678,354111,1433,319.0398063027088,377.72692943274797
10221,C7_01650W_A,835,C7,354542,356139,1597,59.5518495894516,70.50636579850949
10223,C7_01660C_A,1321,C7,356175,358622,2447,61.486892326833974,72.79735813574494
10225,C7_01670W_A,625,C7,359156,360895,1739,40.9349373970665,48.46488715218485
10227,C7_01680C_A,3244,C7,363741,364475,734,503.3829259881627,595.9798219723484
10229,C7_01690W_A,142,C7,369530,369886,356,45.43097335261488,53.78796540937628
10231,C7_01700W_A,3246,C7,370380,371207,827,447.0506196069391,529.2852318400583
10233,C7_01710W_A,1328,C7,371481,372662,1181,128.07426512485856,151.63342614077354
10235,C7_01720W_A,460,C7,373129,373893,764,68.57695041132854,81.19162686600784
10237,C7_01730C_A,70,C7,373998,374338,340,23.449458491034846,27.762968061343347
10239,C7_01740C_A,373,C7,374590,375264,674,63.03222394728783,74.62695230054183
10241,C7_01750W_A,208,C7,375744,376628,884,26.79938113261126,31.729106355820967
10243,C7_01760C_A,3536,C7,377222,377785,563,715.3483120086713,846.9360751603509
10245,C7_01770W_A,8,C7,379039,379386,347,2.625875961120411,3.1089037927893743
10247,C7_01780W_A,3079,C7,380242,384336,4094,85.65950211433018,101.41650060959556
10249,C7_01790C_A,5209,C7,384487,385383,896,662.155579641776,783.9585812296357
10251,C7_01800C_A,7335,C7,385958,388798,2840,294.168030838993,348.2800103027373
10253,C7_01810W_A,1893,C7,390347,391843,1496,144.12280819327586,170.63408616923036
10255,C7_01820C_A,525,C7,392020,392511,491,121.78435672533372,144.18649400494
10257,C7_01830W_A,227,C7,393003,393695,692,37.362287496657096,44.23505109361023
10259,C7_01840W_A,785,C7,394415,399358,4943,18.08809130157279,21.415381565771334
10261,C7_01850C_A,952,C7,399687,401742,2055,52.76413433700493,62.470055628054325
10263,C7_01860W_A,6,C7,401550,402020,470,1.4540089763438024,1.7214727916456056
10265,C7_01870W_A,380,C7,402404,404011,1607,26.9327943554245,31.887060836746027
10267,C7_01880C_A,81,C7,404173,405123,950,9.711249426212026,11.49762617156986
10269,C7_01890C_A,345,C7,405642,405839,197,199.46493698320435,236.15635631585022
10271,C7_01900W_A,2827,C7,406702,408138,1436,224.2255323558782,265.47164386392757
10273,C7_01910C_A,357,C7,408386,409249,863,47.116293190561336,55.78329851491236
10275,C7_01920W_A,1454,C7,411053,411787,734,225.6223102302061,267.1253579370513
10277,C7_01930C_A,443,C7,412311,412922,611,82.58025340003903,97.77082649987223
10279,C7_01940C_A,9581,C7,413292,416609,3317,328.987247568309,389.5041947480443
10281,C7_01950W_A,315,C7,418439,419293,854,42.011324931245106,49.73927533238328
10283,C7_01960W_A,797,C7,419928,421982,2054,44.194841159414544,52.32444766492433
10285,C7_01970C_A,2948,C7,422229,423401,1172,286.49270154478364,339.1928101809564
10287,C7_01990C_A,505,C7,429941,431671,1730,33.24749812477856,39.363349431318355
10289,C7_02000C_A,8,C7,432211,433887,1676,0.543662863072066,0.6436692220154612
10291,C7_02010C_A,711,C7,435297,437282,1985,40.79648863348517,48.30097084670127
10293,C7_02020W_A,750,C7,438032,439222,1190,71.78405660520872,84.98867773880616
10295,C7_02030W_A,12478,C7,439525,441648,2123,669.4354124041798,792.5775335415543
10297,C7_02040C_A,12831,C7,449870,450904,1034,1413.3628163232822,1673.3498022427855
10299,C7_02050C_A,1728,C7,455359,457362,2003,98.25993761252974,116.33477637401359
10301,C7_02060W_A,1113,C7,458219,460717,2498,50.747707206779175,60.08270830249085
10303,C7_02070W_A,29,C7,460994,461365,371,8.903028907262366,10.54073411955508
10305,C7_02080W_A,331,C7,461678,462148,470,80.21282852829975,94.96791567244927
10307,C7_02090C_A,338,C7,462241,463041,800,48.12163874624509,56.97357660017103
10309,C7_02100W_A,3275,C7,463552,464776,1224,304.7499069767426,360.8084142892836
10311,C7_02110W_A,633,C7,465064,467130,2066,34.89691921200747,41.3161802389871
10313,C7_02120C_A,327,C7,467306,467767,461,80.79054214543707,95.65189925813924
10315,C7_02130W_A,21,C7,468121,469158,1037,2.3065041138722804,2.73078374373869
10317,C7_02140W_A,93,C7,469496,470368,872,12.147311230119952,14.381799641213576
10319,C7_02150C_A,563,C7,470403,471722,1319,48.6157840826805,57.558619585208966
10321,C7_02160W_A,567,C7,472182,475838,3656,17.66406145632111,20.913351761744963
10323,C7_02170C_A,810,C7,475895,476923,1028,89.74403652627846,106.2523819357137
10325,C7_02180C_A,400,C7,477161,477799,638,71.40900928752215,84.54464076002454
10327,C7_02190W_A,38,C7,479891,480038,147,29.44285750283482,34.858848139218274
10329,C7_02200W_A,848,C7,480365,482479,2114,45.68825430554918,54.092572992610584
10331,C7_02210W_A,4,C7,483232,483624,392,1.162218059322427,1.3760071633901951
10333,C7_02220C_A,454,C7,483803,485029,1226,42.177329441577015,49.935816242705194
10335,C7_02230W_A,18,C7,486519,486872,353,5.807797894177793,6.876137779660918
10337,C7_02240W_A,1526,C7,487109,487966,857,202.8090855724041,240.1156584255273
10339,C7_02250W_A,13,C7,489299,491008,1709,0.8663930998108672,1.0257654336799933
10341,C7_02260W_A,315,C7,492273,492731,458,78.33552727354437,92.7452863184614
10343,C7_02270W_A,148,C7,493961,494419,458,36.80526360788751,43.575563095658055
10345,C7_02280W_A,1504,C7,495607,496065,458,374.0210572044785,442.82193848560615
10347,C7_02290W_A,60,C7,496851,497402,551,12.402617402569637,14.684069184635838
10349,C7_02300W_A,512,C7,497855,499960,2105,27.70330325157344,32.79930424240685
10351,C7_02310C_A,101,C7,500154,501344,1190,9.666919622834774,11.445141935492563
10353,C7_02320W_A,1132,C7,502656,504995,2339,55.12262617742315,65.26239020002338
10355,C7_02330W_A,1791,C7,505458,510197,4739,43.044986143944655,50.96307771764513
10357,C7_02340C_A,244,C7,510339,511619,1280,21.71168612071709,25.705533821083083
10359,C7_02350C_A,588,C7,511805,514204,2399,27.91648747411235,33.05170353613864
10361,C7_02360W_A,46,C7,515708,516121,413,12.685905596671914,15.019468020733655
10363,C7_02370W_A,1851,C7,517530,518033,503,419.1332634691244,496.232499850208
10365,C7_02380C_A,11438,C7,519130,519618,488,2669.586303131008,3160.6546180655555
10367,C7_02390W_A,1322,C7,520547,521104,557,270.3273301500473,320.0538313468224
10369,C7_02420C_A,511,C7,523711,526224,2513,23.16018940499343,27.42048815290656
10371,C7_02430C_A,192,C7,526542,527896,1354,16.15088257327237,19.121824805280585
10373,C7_02450W_A,862,C7,529016,530869,1853,52.98409756034611,62.73048091449008
10375,C7_02460C_A,901,C7,530886,532163,1277,80.3614175427186,95.14383751999017
10377,C7_02470C_A,445,C7,532246,533123,877,57.79285013346754,68.4237997667576
10379,C7_02480W_A,343,C7,533816,534331,515,75.85785989527002,89.81185396154955
10381,C7_02490W_A,1197,C7,534960,538232,3272,41.6672223920772,49.33187539995422
10383,C7_02500C_A,174,C7,538375,539295,920,21.54145907344133,25.503993641445224
10385,C7_02510W_A,426,C7,540438,540911,473,102.57987217884288,121.44935952899337
10387,C7_02520W_A,161,C7,541379,542170,791,23.18265049303319,27.447080940544247
10389,C7_02530C_A,531,C7,542111,543661,1550,39.01903443291643,46.19655533451546
10391,C7_02540W_A,576,C7,545757,547433,1676,39.14372614118876,46.34418398511321
10393,C7_02550C_A,298,C7,547659,548327,668,50.81050330007808,60.157055688094694
10395,C7_02560W_A,432,C7,548601,552542,3941,12.485070733183015,14.781689741001598
10397,C7_02570C_A,1450,C7,552627,553001,374,441.58071184416275,522.8091388175046
10399,C7_02600C_A,1177,C7,554233,558933,4700,28.522809419277593,33.76955792944796
10401,C7_02610C_A,552,C7,558964,559916,952,66.04133207679203,78.18958351970167
10403,C7_02630W_A,520,C7,560574,562490,1916,30.911603498471234,36.597768813342554
10405,C7_02640W_A,2091,C7,563064,564953,1889,126.07697209117687,149.26873261386552
10407,C7_02650W_A,63,C7,565312,566472,1160,6.185805429531606,7.3236795058371245
10409,C7_02660C_A,67,C7,566564,567244,680,11.222240849280963,13.28656328650003
10411,C7_02670W_A,260,C7,568036,571017,2981,9.934020849223563,11.761376223811531
10413,C7_02680W_A,552,C7,571203,571655,452,139.09590295819913,164.6824856432655
10415,C7_02690C_A,294,C7,571898,573106,1208,27.720055236090868,32.81913774138932
10417,C7_02750W_A,161,C7,585449,586982,1533,11.96182422699886,14.16219244877397
10419,C7_02760W_A,251,C7,590345,590770,425,67.26644664285425,79.64005695311064
10421,C7_02770W_A,570,C7,593118,596198,3080,21.07840934862038,24.95576628148581
10423,C7_02780W_A,2446,C7,596435,597913,1478,188.49321147771334,223.16639047492347
10425,C7_02790C_A,1337,C7,597970,601086,3116,48.87059802335696,57.86030635120787
10427,C7_02800W_A,1747,C7,601521,604766,3245,61.31855317853788,72.5980531326292
10429,C7_02810W_A,2888,C7,605320,606051,731,449.9803064591936,532.7538323000637
10431,C7_02830C_A,286,C7,609391,610782,1391,23.418150802795818,27.725901348310845
10433,C7_02840C_A,17067,C7,612138,613691,1553,1251.6976243455726,1481.9464244963845
10435,C7_02850W_A,1323,C7,614917,616851,1934,77.91428141850565,92.24655261747277
10437,C7_02860C_A,3130,C7,617611,621030,3419,104.26989397969034,123.45025951983283
10439,C7_02870C_A,338,C7,621309,621806,497,77.45937826357358,91.70797038256906
10441,C7_02880C_A,78,C7,622107,623468,1361,6.527549482336982,7.728287110179759
10443,C7_02890C_A,2954,C7,624651,627284,2633,127.78307270389973,151.28866910146385
10445,C7_02910W_A,11978,C7,629776,632691,2915,468.0146468704202,554.1055755412008
10447,C7_02920W_A,2249,C7,633412,635133,1721,148.8408975658231,176.22006439600568
10449,C7_02930C_A,920,C7,635249,636553,1304,80.35704005253835,95.13865479391104
10451,C7_02940C_A,1142,C7,636728,639031,2303,56.47885207430687,66.86809279113204
10453,C7_02950C_A,633,C7,639193,640713,1520,47.432259928952256,56.15738708799169
10455,C7_02960C_A,284,C7,641273,642400,1127,28.701732943266897,33.98139429589699
10457,C7_02970W_A,509,C7,642586,644340,1754,33.05231541341009,39.132263012673725
10459,C7_02980C_A,679,C7,644348,647710,3362,23.00306784754103,27.23446420770683
10461,C7_02990W_A,675,C7,648090,652049,3959,19.419228245561644,22.991380110700028
10463,C7_03000C_A,296,C7,652101,652583,482,69.94527274859949,82.81165102826303
10465,C7_03010W_A,1622,C7,653587,656172,2585,71.46674423120143,84.61299600149007
10467,C7_03020C_A,786,C7,656372,657406,1034,86.57962540956277,102.50587986617015
10469,C7_03030W_A,611,C7,658010,658528,518,134.34612539789242,159.0589902113477
10471,C7_03040W_A,67,C7,658745,659356,611,12.489564283978813,14.787009876955844
10473,C7_03050W_A,347,C7,659498,660100,602,65.65180618823663,77.72840464825079
10475,C7_03060C_A,385,C7,660102,662387,2285,19.190585285879724,22.720678457204404
10477,C7_03070C_A,2316,C7,662700,667772,5072,52.00834157892205,61.575235382560294
10479,C7_03080W_A,1033,C7,669562,671481,1919,61.31109068131661,72.58921791487391
10481,C7_03090C_A,132,C7,671607,672854,1247,12.05649784714909,14.274281207390187
10483,C7_03110W_A,50,C7,675478,676158,680,8.374806603941018,9.915345736194054
10485,C7_03120W_A,921,C7,676794,677996,1202,87.2707800318832,103.32417184132464
10487,C7_03130C_A,136,C7,678065,678643,578,26.79938113261126,31.729106355820967
10489,C7_03140W_A,57,C7,679341,681512,2171,2.99039616737682,3.5404772062172407
10491,C7_03150W_A,104,C7,682298,684385,2087,5.675767350557823,6.719820320686568
10493,C7_03160W_A,1368,C7,685122,687359,2237,69.6520348256602,82.4644722184815
10495,C7_03170W_A,432,C7,687921,690194,2273,21.647014412439184,25.6289658025901
10497,C7_03180C_A,662,C7,691394,692238,844,89.33656257891205,105.76995347405486
10499,C7_03190C_A,14,C7,692216,692593,377,4.229610550107082,5.0076441065553
10501,C7_03200C_A,175,C7,693435,694121,686,29.055451483060676,34.400179084754875
10503,C7_03210W_A,137,C7,695611,696768,1157,13.486551136095855,15.967391681656663
10505,C7_03220C_A,1407,C7,697006,700323,3317,48.31281257996146,57.199916711251255
10507,C7_03230C_A,40,C7,700560,700940,380,11.989196822483983,14.194600211814643
10509,C7_03240W_A,2317,C7,703277,705439,2162,122.0629999343692,144.5163934145967
10511,C7_03250C_A,7675,C7,705589,707268,1679,520.6446178197518,616.41678853123
10513,C7_03260C_A,596,C7,708439,709125,686,98.95456619373807,117.15718134007946
10515,C7_03270W_A,1370,C7,710680,711873,1193,130.79580607261445,154.85559241975488
10517,C7_03280C_A,1894,C7,713476,715191,1715,125.78520024895295,148.92328956920167
10519,C7_03290C_A,466,C7,716697,721385,4688,11.321709542051321,13.404329167598855
10521,C7_03300C_A,632,C7,727464,728846,1382,52.086206745436925,61.667423785626
10523,C7_03310W_A,1386,C7,731779,732447,668,236.31999185875242,279.7908697439572
10525,C7_03320C_A,977,C7,732621,735782,3161,35.20333132169728,41.67895661687998
10527,C7_03330C_A,3214,C7,736055,737536,1481,247.1749808108734,292.64262543371814
10529,C7_03340C_A,424,C7,737814,738770,956,50.515151465445065,59.80737411421484
10531,C7_03350C_A,444,C7,738908,739837,929,54.43534143943751,64.44867997140385
10533,C7_03360W_A,10993,C7,740654,742282,1628,769.0870923592636,910.5600621747816
10535,C7_03370C_A,914,C7,742537,743631,1094,95.15740037443184,112.66152983472263
10537,C7_03380W_A,316,C7,744358,744657,299,120.37314000366861,142.51568506979118
10539,C7_03390C_A,1323,C7,744898,745518,620,243.04229074740311,287.7497302616006
10541,C7_03400C_A,1217,C7,745808,748996,3188,43.4796421151658,51.477688315211736
10543,C7_03410C_A,79,C7,749268,751232,1964,4.581411514905412,5.424158583995362
10545,C7_03420C_A,339,C7,753811,755640,1829,21.11055678885165,24.993827218233495
10547,C7_03440W_A,247,C7,756765,758426,1661,16.937176606838452,20.052757012054823
10549,C7_03450C_A,843,C7,758521,759939,1418,67.71190603163821,80.16745824846092
10551,C7_03460W_A,63,C7,762312,764132,1820,3.9426012627783864,4.667839685039047
10553,C7_03470W_A,43,C7,765204,765881,677,7.234249485944914,8.564984027365261
10555,C7_03480W_A,662,C7,771011,774148,3137,24.03572165017589,28.457073870609598
10557,C7_03490W_A,3528,C7,774906,777236,2330,172.45919343449495,204.18292733870368
10559,C7_03500W_A,497,C7,777676,778842,1166,48.54802126703098,57.47839185255819
10561,C7_03520W_A,274,C7,779702,780436,734,42.51754676965369,50.33861628249798
10563,C7_03530C_A,293,C7,780464,781264,800,41.71491169423021,49.38833711198258
10565,C7_03540C_A,961,C7,781559,783811,2252,48.60362894798736,57.54422852298481
10567,C7_03550C_A,26,C7,784193,786196,2003,1.4784481353737116,1.7504075148867781
10569,C7_03560W_A,1596,C7,789476,790456,980,185.49000226785935,219.61074327707516
10571,C7_03570W_A,1186,C7,792047,793453,1406,96.07559075314869,113.74862061629842
10573,C7_03580C_A,673,C7,793704,795782,2078,36.887839212969844,43.673328418785815
10575,C7_03590C_A,631,C7,796798,798657,1859,38.66016156663811,45.771668084842865
10577,C7_03600W_A,650,C7,800395,802665,2270,32.61378430785842,38.6130644528438
10579,C7_03610C_A,560,C7,802914,806345,3431,18.590069103939022,22.009697792729202
10581,C7_03620C_A,617,C7,806681,808660,1979,35.510195641733134,42.04226838885879
10583,C7_03630C_A,239,C7,809086,809449,363,74.99027929876002,88.7846825920803
10585,C7_03640C_A,280,C7,809748,811217,1469,21.709505478425726,25.70295205134578
10587,C7_03650W_A,252,C7,811482,812438,956,30.023156059651313,35.54589216222203
10589,C7_03660C_A,2467,C7,812904,814979,2075,135.4143669060944,160.32373391045488
10591,C7_03670W_A,2248,C7,815421,817079,1658,154.42779694871408,182.83466955579826
10593,C7_03680W_A,296,C7,817565,819406,1841,18.312667824456796,21.681268764596837
10595,C7_03690W_A,43,C7,820478,821188,710,6.898009721105221,8.166893220459553
10597,C7_03700C_A,352,C7,822571,823998,1427,28.095216660396943,33.26330981661399
10599,C7_03710C_A,411,C7,824288,827590,3302,14.176807690305486,16.78462038977295
10601,C7_03720C_A,1089,C7,827988,829871,1883,65.87054473022201,77.9873799741521
10603,C7_03730C_A,606,C7,830249,833116,2867,24.074574854217055,28.50307409118134
10605,C7_03740C_A,6,C7,834984,835313,329,2.0771556804911464,2.4592468452080087
10607,C7_03760W_A,485,C7,836244,836981,737,74.95281459917905,88.74032629027947
10609,C7_03770C_A,652,C7,837011,837775,764,97.20037319170916,115.08030590573286
10611,C7_03780C_A,572,C7,838198,839559,1361,47.86869620380453,56.67410547465156
10613,C7_03790W_A,874,C7,840836,842005,1169,85.15509086149231,100.81930330085285
10615,C7_03800W_A,339,C7,842328,842942,614,62.88470418047177,74.45229638786492
10617,C7_03810W_A,3288,C7,843505,846696,3191,117.35962141871191,138.94783209534384
10619,C7_03820C_A,163,C7,846800,847324,524,35.4299070221688,41.947210740448426
10621,C7_03830C_A,140,C7,847595,848101,506,31.51310627253695,37.30991755279343
10623,C7_03840W_A,509,C7,848744,849739,995,58.265086668463624,68.98290384344695
10625,C7_03850W_A,585,C7,850058,852295,2237,29.78540962939416,35.26441246185064
10627,C7_03860W_A,7373,C7,853117,854598,1481,567.0258660605381,671.3298311520857
10629,C7_03870W_A,620,C7,855127,855881,754,93.65566218094253,110.88354807372447
10631,C7_03880C_A,263,C7,856037,856963,926,32.348821016173034,38.29936137064675
10633,C7_03890C_A,1803,C7,857114,859144,2030,101.16106294281622,119.7695614423976
10635,C7_03900W_A,5,C7,859698,860027,329,1.7309630670759548,2.0493723710066734
10637,C7_03910W_A,164,C7,860161,861222,1061,17.605248491451505,20.84372019793329
10639,C7_03920C_A,827,C7,861407,861733,326,288.935965754127,342.08551093288884
10641,C7_03930C_A,2355,C7,862087,862881,794,337.8190250768551,399.96057082975204
10643,C7_03940C_A,499,C7,863305,864765,1460,38.92793666916803,46.088700208292686
10645,C7_03950C_A,1,C7,865870,865985,115,0.9904119114225899,1.1725974088020792
10647,C7_03960C_A,803,C7,866443,867900,1457,62.77253806473512,74.31949740276461
10649,C7_03970C_A,300,C7,868066,868530,464,73.64054082775722,87.18666078377528
10651,C7_03980W_A,207,C7,868824,869354,530,44.48444443663161,52.667323238742455
10653,C7_03990C_A,297,C7,869412,870218,806,41.969626345705414,49.6899063246092
10655,C7_04000W_A,720,C7,870453,872111,1658,49.46086023268423,58.55914683281795
10657,C7_04010W_A,1300,C7,872285,874201,1916,77.27900874617808,91.49442203335639
10659,C7_04020C_A,1611,C7,874326,875177,851,215.6153499056476,255.27762507839861
10661,C7_04030C_A,1231,C7,875398,878340,2942,47.657261128667216,56.423777082619424
10663,C7_04040C_A,756,C7,878586,879851,1265,68.06830954867982,80.58942191403382
10665,C7_04050W_A,691,C7,880352,881347,995,79.09857541828755,93.64869657332385
10667,C7_04060W_A,223,C7,881557,883278,1721,14.758346001413317,17.47313221890141
10669,C7_04070C_A,5,C7,883464,883853,389,1.4639764757531855,1.7332738047845644
10671,C7_04080C_A,5,C7,885185,885985,800,0.7118585613349865,0.8428043875764945
10673,C7_04090C_A,1789,C7,887242,888585,1343,151.72181280456184,179.6309217422902
10675,C7_04100C_A,146,C7,889548,890204,656,25.34910974509952,30.01205867955322
10677,C7_04110W_A,367,C7,890327,891421,1094,38.20871546763291,45.23717882860307
10679,C7_04120W_A,89,C7,891570,891977,407,24.90630445555334,29.48779970292207
10681,C7_04130C_A,1641,C7,892096,892941,845,221.1900400758746,261.8777751503957
10683,C7_04140C_A,380,C7,893178,893816,638,67.83855882314604,80.3174087220233
10685,C7_04150W_A,598,C7,893966,896869,2903,23.462151962980197,27.777996487536683
10687,C7_04160W_A,137,C7,897141,898802,1661,9.394304433752502,11.122379395350245
10689,C7_04170W_A,73,C7,898905,899724,819,10.152024415619831,12.019481375938284
10691,C7_04180W_A,1787,C7,900072,902312,2240,90.8636606504015,107.57796004279967
10693,C7_04190C_A,787,C7,902362,904020,1658,54.063468059892344,64.00840077420517
10695,C7_04200C_A,1562,C7,904199,907276,3077,57.81855432201489,68.45423222070767
10697,C7_04210C_A,2863,C7,907552,908649,1097,297.25448475508716,351.9342150055064
10699,C7_04220W_A,30,C7,915497,915931,434,7.873090079280956,9.321338848772289
10701,C7_04230W_A,11717,C7,918812,919744,932,1431.9050237188046,1695.302834203225
10703,C7_04240C_A,1585,C7,924629,926377,1748,103.27650523715823,122.2741376941642
10705,C7_04250W_A,105,C7,928797,930488,1691,7.07227902449898,8.373219226070436
10707,C7_04260W_A,1416,C7,930547,932679,2132,75.64665837526009,89.56180208692804
10709,C7_04270C_A,885,C7,932671,933591,920,109.56431770112401,129.71858834873
10711,C7_04280C_A,957,C7,933644,934390,746,146.11230953299346,172.9895547261566
10713,C7_04290W_A,228,C7,934460,934858,398,65.2477394912068,77.25001019796613
10715,C7_04300W_A,3896,C7,934878,939083,4205,105.52774144917412,124.93948704867624
10717,C7_04310C_A,1505,C7,939080,940303,1223,140.15988681068254,165.94218849421085
10719,C7_04320W_A,122,C7,940458,940859,401,34.652067624087124,41.02628839275105
10721,C7_04330C_A,181,C7,940993,941499,506,40.74194453806563,48.236393407540085
10723,C7_04340C_A,14,C7,942019,942219,200,7.9728158869518495,9.439409140856739
10725,C7_04360C_A,5,C7,942825,943352,527,1.0806202069601312,1.2793994498314907
10779,CR_00010C_A,330,CR,4884,6890,2006,18.73685545288499,22.183485375891777
10781,CR_00020W_A,459,CR,9111,9863,752,69.51980418143805,82.30791785055551
10783,CR_00030W_A,1,CR,10308,10418,110,1.0354306346690711,1.2258972910203558
10785,CR_00040C_A,440,CR,10646,11815,1169,42.869839792970964,50.755713332237136
10787,CR_00050W_A,673,CR,13684,14823,1139,67.29844590390812,79.67794245323698
10789,CR_00060C_A,624,CR,14971,16827,1856,38.29308123043376,45.33706360756315
10791,CR_00070W_A,658,CR,16909,21366,4457,16.815003216815658,19.908109922381275
10793,CR_00080W_A,1957,CR,21385,24462,3077,72.43976364160254,85.76500157229508
10795,CR_00090C_A,693,CR,24474,25163,689,114.55860272978708,135.63156820679492
10797,CR_00100C_A,3745,CR,25279,27540,2261,188.65353823614504,223.35620921531867
10799,CR_00110W_A,1058,CR,28507,30687,2180,55.2767969095351,65.4449205178665
10801,CR_00120C_A,2095,CR,30873,32402,1529,156.0595093260219,184.7665341501903
10803,CR_00130C_A,728,CR,33075,34247,1172,70.7485368808014,83.76267497005979
10805,CR_00140W_A,390,CR,36752,38833,2081,21.34549458303852,25.271981636123623
10807,CR_00150C_A,4689,CR,39001,40227,1226,435.61563381399696,515.7467893437107
10809,CR_00160C_A,348,CR,40843,41283,440,90.0824652162092,106.65306431877093
10811,CR_00170W_A,576,CR,41616,43364,1748,37.53139874864551,44.43527022828932
10813,CR_00180C_A,259,CR,43351,44739,1388,21.25318356031833,25.162690072889003
10815,CR_00190W_A,831,CR,45583,48474,2891,32.73909177277752,38.76142212804245
10817,CR_00200W_A,8488,CR,49655,51316,1661,582.0354455013958,689.1004110053495
10819,CR_00210W_A,3786,CR,52344,53912,1568,275.0098482871693,325.5976950372049
10821,CR_00220W_A,545,CR,54836,56452,1616,38.41216989381858,45.47805853754351
10823,CR_00230W_A,1736,CR,56627,62170,5543,35.671267183187055,42.23296891453132
10825,CR_00240W_A,369,CR,62271,62572,301,139.62833708045716,165.31286060636623
10827,CR_00250W_A,3739,CR,62794,63164,370,1150.97909657579,1362.700802226384
10829,CR_00260W_A,4370,CR,63737,67375,3638,136.81459760456914,161.98153595202996
10831,CR_00270C_A,492,CR,67399,67866,467,119.99465941818018,142.06758327627762
10833,CR_00280C_A,1072,CR,67793,69016,1223,99.83481638608085,118.19935286763723
10835,CR_00290W_A,13743,CR,72120,73049,929,1684.9209400950217,1994.8608307364934
10837,CR_00300W_A,306,CR,73423,74526,1103,31.59800105436169,37.410428663413576
10839,CR_00310C_A,600,CR,75931,76707,776,88.06497665999832,104.26446031874157
10841,CR_00320C_A,3365,CR,82153,83460,1307,293.23997660501664,347.18124121743284
10843,CR_00330C_A,1683,CR,83900,86197,2297,83.45201279768618,98.80294535768327
10845,CR_00340C_A,94,CR,86887,87078,191,56.05420294491202,66.36532978612816
10847,CR_00350W_A,663,CR,88058,89263,1205,62.66718355719117,74.19476301586268
10849,CR_00360C_A,2095,CR,89445,91775,2330,102.40986684956545,121.24808185220641
10851,CR_00370W_A,986,CR,92310,94889,2579,43.545097571232056,51.555184251286455
10853,CR_00380W_A,195,CR,95282,96580,1298,17.110929979700753,20.258472182116048
10855,CR_00390W_A,239,CR,96952,102066,5114,5.322931440252226,6.302080520321695
10857,CR_00400C_A,769,CR,102094,104001,1907,45.92924876070097,54.37789818951855
10859,CR_00410W_A,129,CR,104225,105304,1079,13.617016409596035,16.1218559402955
10861,CR_00420W_A,160,CR,105862,107451,1589,11.468583492873288,13.578220466934082
10863,CR_00430C_A,108,CR,107586,107855,269,45.72831204412106,54.13999932089898
10865,CR_00440C_A,1210,CR,108217,112623,4406,31.27912334871843,37.03289365292994
10867,CR_00450C_A,14,CR,112872,112934,62,25.71876092565113,30.44970690598948
10869,CR_00460C_A,317,CR,115600,116151,551,65.52716194357626,77.58083219215933
10871,CR_00470W_A,2466,CR,116814,118070,1256,223.62333914039195,264.75867767689624
10873,CR_00480W_A,448,CR,118387,119088,701,72.79033049428222,86.18005492365639
10875,CR_00490W_A,865,CR,119368,120249,881,111.82885912458812,132.39969039794192
10877,CR_00500C_A,3,CR,120697,120831,134,2.5499411152298026,3.019000791318786
10879,CR_00510C_A,1249,CR,120977,121852,875,162.58035988249563,192.48689007232758
10881,CR_00520C_A,2185,CR,122317,125556,3239,76.83413184399853,90.96771037256637
10883,CR_00530W_A,15,CR,126526,127080,554,3.08386380361727,3.651138141125608
10885,CR_00540C_A,4383,CR,127168,128181,1013,492.80569782132216,583.4569209473287
10887,CR_00550W_A,11,CR,129408,130007,599,2.0916044540059704,2.4763534593232563
10889,CR_00560W_A,1796,CR,130642,133365,2723,75.12290715579205,88.94170723980223
10891,CR_00570W_A,781,CR,134039,135571,1532,58.063868031605686,68.74467119553444
10893,CR_00580W_A,1622,CR,136149,136787,638,289.56353266090235,342.82851828189945
10895,CR_00590W_A,529,CR,137383,141375,3992,15.09311338461755,17.869479800720065
10897,CR_00600C_A,322,CR,141503,143776,2273,16.135043150012542,19.103071732486143
10899,CR_00610W_A,315,CR,145023,149603,4580,7.833552727354436,9.274528631846142
10901,CR_00620C_A,3334,CR,149870,151120,1250,303.78706476682817,359.6684580070442
10903,CR_00630W_A,1362,CR,152179,153792,1613,96.17372454192204,113.86480603885288
10905,CR_00640W_A,19081,CR,155196,162011,6815,318.89592273121946,377.55657859068737
10907,CR_00650W_A,6,CR,163014,164153,1139,0.5999861447599536,0.7103531273691261
10909,CR_00660W_A,162,CR,164515,165780,1265,14.58606633185996,17.269161838721534
10911,CR_00670C_A,159,CR,165832,167064,1232,14.699417045748422,17.403363327878264
10913,CR_00680W_A,383,CR,167245,168624,1379,31.63356971617692,37.452540152782866
10915,CR_00690C_A,421,CR,168752,170080,1328,36.10752461711196,42.74947556261496
10917,CR_00700W_A,103,CR,170219,171604,1385,8.470345913935436,10.028459427625004
10919,CR_00710C_A,24,CR,171645,172334,689,3.967397497135484,4.697197167334889
10921,CR_00720W_A,1,CR,171661,171984,323,0.35262343595541124,0.41748824152396014
10923,CR_00730C_A,1,CR,172432,172504,72,1.5819079140777477,1.8728986390588769
10925,CR_00740C_A,1988,CR,172978,174627,1649,137.31229301966798,162.57078204992806
10927,CR_00750C_A,325,CR,175807,177243,1436,25.777608070626254,30.519378937310385
10929,CR_00760C_A,332,CR,177792,181469,3677,10.283907201010196,12.175623896672121
10931,CR_00770W_A,1,CR,178149,178532,383,0.29738216661513794,0.35208538384396637
10933,CR_00780C_A,4347,CR,182254,184239,1985,249.4266330376372,295.308467328566
10935,CR_00790C_A,7,CR,185398,185736,338,2.3588212683289496,2.7927245978866084
10937,CR_00800C_A,728,CR,186234,189002,2768,29.955666627275736,35.465988101484854
10939,CR_00810W_A,104,CR,189237,189632,395,29.988168254719433,35.504468377905994
10941,CR_00820C_A,221,CR,189674,190655,981,25.658836624673928,30.378759576661412
10943,CR_00830W_A,76,CR,191176,192171,995,8.699698598827576,10.300001359728816
10945,CR_00840C_A,1,CR,191346,191900,554,0.20559092024115133,0.24340920940837385
10947,CR_00850C_A,860,CR,192172,197094,4922,19.900800089332414,23.561536718920284
10949,CR_00860C_A,3876,CR,197957,198460,503,877.666412321084,1039.1124632195601
10951,CR_00870C_A,160,CR,198806,199867,1061,17.175852186781952,20.3353367784715
10953,CR_00880W_A,326,CR,200121,201206,1085,34.22169821127456,40.516752862663544
10955,CR_00890C_A,205,CR,201467,201727,260,89.80369542995214,106.32301504811161
10957,CR_00900W_A,821,CR,202216,203886,1670,55.993856656864565,66.29388284553791
10959,CR_00910W_A,6829,CR,206330,206494,164,4742.71425888451,5615.132841716957
10961,CR_00920W_A,92,CR,207723,208721,998,10.499557137125251,12.430942470066132
10963,CR_00930W_A,392,CR,210182,210634,452,98.77824992683708,116.94843183362329
10965,CR_00970W_A,89,CR,215621,216148,527,19.23503968389034,22.77331020700053
10967,CR_00980C_A,2887,CR,216776,218971,2195,149.80487774572072,177.3613679769177
10969,CR_00990W_A,199,CR,221203,221703,500,45.33115318581194,53.66978340087117
10971,CR_01000C_A,1533,CR,221874,225995,4121,42.36948991124618,50.16332448065096
10973,CR_01010W_A,81,CR,227653,228033,380,24.278123565530066,28.744065428924653
10975,CR_01020C_A,365,CR,228566,230386,1820,22.84205493514462,27.043833095861142
10977,CR_01030W_A,395,CR,231760,234396,2636,17.067322107879797,20.206842676340838
10979,CR_01040C_A,200,CR,234556,235158,602,37.83965774538134,44.80023322665752
10981,CR_01050C_A,1656,CR,235391,237199,1808,104.32192721864935,123.5118642324491
10983,CR_01060W_A,1612,CR,238178,239416,1238,148.30578363450704,175.5865166750642
10985,CR_01070W_A,168,CR,239879,240880,1001,19.11564248619824,22.631949988068104
10987,CR_01080W_A,715,CR,241115,247618,6503,12.522930865250261,14.826514214785632
10989,CR_01090W_A,968,CR,248128,250674,2546,43.304263149867516,51.27004852625588
10991,CR_01100C_A,188,CR,250793,251212,419,51.104309128774204,60.50490686945335
10993,CR_01110W_A,1655,CR,251455,253125,1670,112.87433954581103,133.63748612590166
10995,CR_01120C_A,555,CR,253261,253995,734,86.12130823780218,101.9632556087094
10997,CR_01130W_A,1018,CR,254233,258486,4253,27.26252585709913,32.27744619056182
10999,CR_01140C_A,2086,CR,258558,259598,1040,228.45183983765875,270.47537730531803
11001,CR_01150C_A,589,CR,259797,262358,2561,26.195060843502198,31.013621821635628
11003,CR_01160W_A,22,CR,269096,269497,401,6.248733505982924,7.398183152791173
11005,CR_01170W_A,2264,CR,269855,274990,5135,50.216873467962124,59.45422811211478
11007,CR_01180W_A,455,CR,275359,276201,842,61.547866110673425,72.86954799948789
11009,CR_01190C_A,205,CR,276255,276551,296,78.88162436414716,93.3918375422602
11011,CR_01200W_A,375,CR,277552,278730,1178,36.257651680899144,42.927218382503966
11013,CR_01210C_A,1895,CR,278915,280411,1496,144.27507740425662,170.81436518261575
11015,CR_01220W_A,42,CR,282664,284229,1565,3.056670627585374,3.618942801606417
11017,CR_01230C_A,227,CR,288278,290905,2627,9.841912047082873,11.652324079474031
11019,CR_01240C_A,1431,CR,291720,295238,3518,46.32948726641799,54.851760255689086
11021,CR_01250C_A,12,CR,299565,299870,305,4.481207992666145,5.305522702120883
11023,CR_01260W_A,598,CR,300879,303074,2195,31.029898473135084,36.73782405618177
11025,CR_01270C_A,413,CR,303468,305003,1535,30.6446995003361,36.28176803326043
11027,CR_01280C_A,529,CR,305767,306345,578,104.24171043493644,123.41689163403892
11029,CR_01290C_A,1994,CR,307230,310298,3068,74.02586551770342,87.64286564941487
11031,CR_01300W_A,710,CR,310826,311203,377,214.5016778982877,253.95909397530446
11033,CR_01310W_A,7693,CR,311996,313136,1140,768.6074262947441,909.9921619124171
11035,CR_01320C_A,640,CR,313501,316497,2996,24.33054628861903,28.80613127097231
11037,CR_01330W_A,961,CR,318322,321771,3449,31.735393560703837,37.573094413963986
11039,CR_01340W_A,68,CR,322485,324131,1646,4.705359141752523,5.5709062799709965
11041,CR_01350C_A,992,CR,324493,325374,881,128.2476627186028,151.8387200864259
11043,CR_01360W_A,136,CR,325668,326258,590,26.25430897398188,31.083768599431394
11045,CR_01370C_A,795,CR,326329,327291,962,94.12516528254707,111.43941590408534
11047,CR_01380W_A,497,CR,327526,330459,2933,19.300031639058343,22.85025738154887
11049,CR_01390W_A,924,CR,330749,331477,728,144.5620463018742,171.15412178476507
11051,CR_01400W_A,2574,CR,332022,333152,1130,259.4440972568149,307.1686362650473
11053,CR_01410C_A,297,CR,333193,334479,1286,26.304446994275708,31.143129469389596
11055,CR_01420W_A,1635,CR,334910,336898,1988,93.6731386545435,110.90423933099144
11057,CR_01430W_A,313,CR,337258,337875,617,57.77937885195482,68.40785045353459
11059,CR_01440C_A,669,CR,338122,338310,188,405.30500215583487,479.8605406712126
11061,CR_01450C_A,2,CR,339491,339606,115,1.9808238228451798,2.3451948176041584
11063,CR_01460C_A,4,CR,340527,340859,332,1.372257467633709,1.6246831567739655
11065,CR_01470W_A,6731,CR,341030,341995,965,794.4489079951576,940.5871639838149
11067,CR_01480W_A,801,CR,342520,344247,1727,52.82674766687427,62.54418663103853
11069,CR_01490C_A,514,CR,344477,344854,377,155.28713019678858,183.85207648353025
11071,CR_01500W_A,990,CR,345897,348482,2585,43.62026929031406,51.644183749368175
11073,CR_01510C_A,8,CR,349038,349379,341,2.672079057210506,3.1636059123105955
11075,CR_01520W_A,1606,CR,349630,351381,1751,104.4655487839167,123.68190487244776
11077,CR_01530C_A,25,CR,352937,353272,335,8.499803717432675,10.063335971062621
11079,CR_01540W_A,566,CR,353346,355763,2417,26.67187063073909,31.578140396742796
11081,CR_01550C_A,152,CR,355983,357224,1241,13.950362781359287,16.516521116728725
11083,CR_01560W_A,132,CR,357404,358150,746,20.153422004550826,23.86062823809057
11085,CR_01570W_A,162,CR,358522,359118,596,30.95868105671619,36.653506251648885
11087,CR_01580C_A,636,CR,359334,361136,1802,40.19907169891689,47.59365953373145
11089,CR_01590C_A,673,CR,361874,363512,1638,46.79666049117908,55.404869630181274
11091,CR_01600C_A,339,CR,363823,366783,2960,13.044327150949211,15.443820939915224
11093,CR_01610C_A,1447,CR,367035,368150,1115,147.81120548903684,175.00096126610762
11095,CR_01620C_A,24572,CR,368747,371050,2303,1215.2349852625819,1438.7765114393137
11097,CR_01630C_A,95,CR,372034,373998,1964,5.509292328050812,6.522722347842524
11099,CR_01640C_A,52,CR,374212,375279,1067,5.550762165236259,6.571820529181289
11101,CR_01650W_A,460,CR,377249,377905,656,79.86705810099848,94.55854104516769
11103,CR_01660C_A,1232,CR,378021,378848,827,169.67540460743962,200.88706273165488
11105,CR_01670W_A,545,CR,379272,380720,1448,42.86883048923399,50.75451836786624
11107,CR_01680C_A,1797,CR,380831,383137,2306,88.75697031874905,105.08374567042225
11109,CR_01690C_A,3328,CR,384286,387579,3293,115.10794009707065,136.28195575363858
11111,CR_01700C_A,410,CR,387843,390590,2747,16.99960743486535,20.126671942125242
11113,CR_01710W_A,194,CR,390661,391524,863,25.60381198590728,30.313613198579823
11115,CR_01720W_A,1127,CR,391750,394848,3098,41.43393666233853,49.05567694247692
11117,CR_01730W_A,8459,CR,395478,396188,710,1356.982889089048,1606.5988314387757
11119,CR_01740W_A,1353,CR,396471,396890,419,367.78792686825267,435.44222869345947
11121,CR_01750C_A,3105,CR,397246,397878,632,559.5748944164894,662.5082590949406
11123,CR_01760C_A,3650,CR,398686,400464,1778,233.8163103597481,276.8266379891298
11125,CR_01770C_A,1642,CR,400727,403447,2720,68.75716221835576,81.40498849415317
11127,CR_01780W_A,263,CR,404537,405496,959,31.235670762227564,36.981447997099984
11129,CR_01790C_A,525,CR,405497,407908,2411,24.8013766703189,29.363570533565134
11131,CR_01800C_A,258,CR,408029,409024,995,29.533187348651502,34.96579408960572
11133,CR_01810C_A,46,CR,409235,410230,995,5.265607046658794,6.234211349309548
11135,CR_01820W_A,1245,CR,410663,413719,3056,46.40125177288263,54.93672578705423
11137,CR_01830C_A,29,CR,414010,415965,1955,1.689526201838536,2.0003132267800177
11139,CR_01870C_A,40,CR,418960,419550,590,7.721855580582904,9.142284882185704
11141,CR_01900C_A,396,CR,420757,422253,1496,30.14930377418766,35.69524465029859
11143,CR_01910C_A,98,CR,422477,423115,638,17.49520727544293,20.71343698620601
11145,CR_01920W_A,167,CR,423365,424666,1301,14.620185056780047,17.309556676436536
11147,CR_01930C_A,889,CR,425221,426345,1124,90.08430761947375,106.65524563067666
11149,CR_01950W_A,562,CR,427487,428386,899,71.20169280894547,84.29918857717284
11151,CR_01960C_A,250,CR,428526,429932,1406,20.252021659601326,23.97736522265987
11153,CR_01970C_A,1929,CR,430298,431046,748,293.72730798185864,347.75821682033325
11155,CR_01980C_A,1866,CR,431374,432228,854,248.86708673556623,294.6459929213562
11157,CR_01990C_A,284,CR,433224,435581,2357,13.723739086576916,16.248210170333437
11159,CR_02000C_A,1496,CR,436061,437755,1694,100.5846902249955,119.08716541340598
11161,CR_02020C_A,732,CR,440887,443238,2351,35.462728500022806,41.98606970351299
11163,CR_02030C_A,278,CR,445207,446703,1496,21.165420326323662,25.058782860563152
11165,CR_02040W_A,1762,CR,447150,449222,2072,96.85674016001902,114.6734618463153
11167,CR_02050C_A,910,CR,449417,451918,2501,41.44206578583528,49.06530141189029
11169,CR_02060W_A,415,CR,452957,453880,923,51.210626730924275,60.63078151146179
11171,CR_02070C_A,26170,CR,454017,455027,1010,2951.1823445760947,3494.050031346829
11173,CR_02080W_A,5,CR,456551,456671,120,4.745723742233243,5.6186959171766295
11175,CR_02090C_A,2158,CR,456872,458434,1562,157.3562894095673,186.30185591703713
11177,CR_02100C_A,235,CR,458808,459412,604,44.31437401687995,52.4659684981394
11179,CR_02110W_A,643,CR,459667,462309,2642,27.719912486806745,32.8189687334859
11181,CR_02120C_A,188,CR,462365,463117,752,28.47434245339946,33.71217550305978
11183,CR_02130W_A,3507,CR,463707,464792,1085,368.1456921071775,435.86580456859224
11185,CR_02140W_A,550,CR,465453,466273,820,76.39457731399855,90.44730013016039
11187,CR_02150W_A,644,CR,467256,469313,2057,35.658680680581924,42.21806713460476
11189,CR_02160W_A,928,CR,470534,475072,4538,23.291485056637022,27.575935537099582
11191,CR_02170W_A,870,CR,475602,476831,1229,80.62710475006519,95.45839768156878
11193,CR_02180W_A,88,CR,478027,479415,1388,7.221158893081131,8.54948543017078
11195,CR_02190C_A,1735,CR,479677,482430,2753,71.78057995880576,84.98456156601338
11197,CR_02200C_A,632,CR,484025,485110,1085,66.34390573474086,78.5478153656545
11199,CR_02210W_A,976,CR,490308,493292,2984,37.253295220533346,44.106009773440135
11201,CR_02220C_A,355,CR,493892,496609,2717,14.881695356579769,17.619171591588103
11203,CR_02230W_A,7,CR,497838,498158,320,2.491504964672453,2.9498153565177305
11205,CR_02240C_A,125,CR,499907,502696,2789,5.1047584176047796,6.043774740598741
11207,CR_02250C_A,780,CR,504777,507014,2237,39.713879505858884,47.01921661580085
11209,CR_02260C_A,393,CR,507449,508468,1019,43.92705234224136,52.007399304033335
11211,CR_02270C_A,540,CR,508632,509357,725,84.83390303357633,100.43903322290913
11213,CR_02280W_A,2917,CR,510499,511347,848,391.7908346064445,463.86045255861023
11215,CR_02290W_A,28,CR,511771,512280,509,6.265474174421886,7.418003254111386
11217,CR_02300C_A,4816,CR,512524,514905,2381,230.3778803117544,272.75571141996795
11219,CR_02310C_A,1,CR,515738,515811,73,1.5602379426520252,1.847242493318344
11221,CR_02320W_A,5,CR,516594,516683,89,6.398728641213362,7.57576977596849
11223,CR_02330C_A,175,CR,516753,517862,1109,17.972984416032123,21.279100858558923
11225,CR_02340W_A,15,CR,518245,519572,1327,1.2874608494378053,1.5242882669054911
11227,CR_02350C_A,2099,CR,520042,522621,2579,92.69894503247069,109.750843553195
11229,CR_02360W_A,7994,CR,525541,526779,1238,735.4568451453159,870.7435572583519
11231,CR_02370W_A,4124,CR,527702,528628,926,507.2491934247057,600.5572862834495
11233,CR_02380C_A,214,CR,528825,529232,407,59.887069140319255,70.90324872388003
11235,CR_02390W_A,1252,CR,530045,532714,2669,53.428065570110334,63.25611649281505
11237,CR_02400W_A,90,CR,533719,535104,1385,7.401273128681449,8.762731538701459
11239,CR_02410W_A,787,CR,535397,538387,2990,29.979006703445318,35.49362156643217
11241,CR_02420W_A,482,CR,538766,539575,809,67.85974320167387,80.34248995043171
11243,CR_02430C_A,853,CR,539688,542237,2549,38.11473379795957,45.12590930421341
11245,CR_02440W_A,42,CR,542623,542955,332,14.408703410153946,17.059173146126636
11247,CR_02460W_A,532,CR,544683,546848,2165,27.987713968052677,33.13603208799594
11249,CR_02470W_A,895,CR,547329,547457,128,796.3917654935162,942.8874086012032
11251,CR_02480W_A,2,CR,548257,548727,470,0.4846696587812674,0.5738242638818686
11253,CR_02490W_A,72,CR,550905,552005,1100,7.455100569617313,8.826460495346561
11255,CR_02500W_A,409,CR,552462,554012,1550,30.054209195975172,35.58265749871342
11257,CR_02510W_A,2721,CR,556957,560259,3302,93.85667573070859,111.12153790893478
11259,CR_02520W_A,306,CR,560832,561227,395,88.23441813407833,104.46507041960803
11261,CR_02530W_A,2799,CR,561929,564680,2751,115.88467397610336,137.2015692229216
11263,CR_02540W_A,690,CR,566051,568717,2666,29.478314017772888,34.900826852379964
11265,CR_02550C_A,248,CR,568818,569693,875,32.28176881573973,38.219974970326064
11267,CR_02560C_A,803,CR,570071,573043,2972,30.773750996069673,36.43455845081696
11269,CR_02570C_A,487,CR,574720,575925,1205,46.031551119686426,54.49901898751905
11271,CR_02580W_A,354,CR,576979,577929,950,42.441756751593296,50.248884749823844
11273,CR_02590C_A,424,CR,578065,581277,3212,15.035020174646787,17.80070039015859
11275,CR_02600W_A,38,CR,581329,581982,653,6.628024583333413,7.847244527511618
11277,CR_02610C_A,944,CR,582048,583778,1730,62.149778672853394,73.5821819072565
11279,CR_02620C_A,1159,CR,584443,584970,527,250.48776397335843,296.56479247093955
11281,CR_02630C_A,88,CR,585248,586093,845,11.861501235025573,14.043415120801235
11283,CR_02640W_A,3121,CR,600287,602089,1802,197.26619932754656,233.55316258612558
11285,CR_02650C_A,1107,CR,609126,610355,1229,102.59104018197951,121.46258187758235
11287,CR_02660C_A,8,CR,612660,612749,89,10.237965825941378,12.121231641549585
11289,CR_02670C_A,1186,CR,613118,614518,1400,96.4873432849479,114.23611470465399
11291,CR_02680W_A,186,CR,615879,618245,2366,8.95389297773846,10.600954596059374
11293,CR_02690W_A,324,CR,618837,619685,848,43.51739129670483,51.52238142920458
11295,CR_02700W_A,188,CR,620000,620383,383,55.90784732364593,66.19205216266568
11297,CR_02710W_A,426,CR,620810,622459,1649,29.424062789928854,34.83659615355601
11299,CR_02720C_A,282,CR,622652,623521,869,36.96094164261748,43.759877983258264
11301,CR_02740W_A,2778,CR,627510,629489,1979,159.88220987477249,189.2924174785246
11303,CR_02750C_A,7,CR,630053,630646,593,1.3444883451858094,1.591805925945487
11305,CR_02760C_A,526,CR,632985,634427,1442,41.546474703157045,49.188916267987366
11307,CR_02770C_A,318,CR,634965,636134,1169,30.98320239582901,36.68253827193502
11309,CR_02780W_A,127,CR,636866,637357,491,29.460215817366446,34.87939950214739
11311,CR_02790C_A,182,CR,637548,638519,971,21.348425649922564,25.275451870471183
11313,CR_02800C_A,448,CR,638889,641339,2450,20.826947623057894,24.658048367952297
11315,CR_02810W_A,381,CR,641816,643483,1667,26.031732392909888,30.82024923015183
11317,CR_02820W_A,1970,CR,644421,646103,1682,133.39941648798322,157.93813493704582
11319,CR_02850C_A,2245,CR,647406,649544,2138,119.59756559005011,141.59744434867952
11321,CR_02860W_A,2134,CR,653851,654447,596,407.81373688291575,482.83075519147366
11323,CR_02870W_A,927,CR,655163,657649,2486,42.470982227355265,50.28348622902078
11325,CR_02880W_A,213,CR,658227,658640,413,58.74125852371995,69.5466671394841
11327,CR_02890C_A,468,CR,658855,660642,1787,29.828745983639504,35.315720504604315
11329,CR_02910W_A,877,CR,664676,666961,2285,43.71465791095199,51.755935083034444
11331,CR_02920C_A,805,CR,667781,668602,821,111.6776890376934,132.22071269165954
11333,CR_02930W_A,2777,CR,672970,678726,5756,54.95013828567776,65.05817329534192
11335,CR_02940C_A,190,CR,678887,679966,1079,20.05607068080036,23.74536921438872
11337,CR_02950C_A,739,CR,680604,681185,581,144.87118122590155,171.52012183656578
11339,CR_02960W_A,163,CR,681670,682533,863,21.512481204654055,25.469685316332534
11341,CR_02970C_A,1241,CR,682676,685207,2531,55.846161967078196,66.11901983294696
11343,CR_02980C_A,455,CR,685569,686855,1286,40.298058526584,47.71085491101773
11345,CR_02990C_A,700,CR,686998,688026,1028,77.5565747757962,91.82304611728345
11347,CR_03000C_A,353,CR,689760,690260,500,80.41154308840008,95.20318362064081
11349,CR_03010C_A,274,CR,690457,691064,607,51.41331026182176,60.870748519528036
11351,CR_03020C_A,393,CR,691388,692170,782,57.23998252780556,67.76923259694371
11353,CR_03030C_A,5257,CR,692731,693531,800,748.4480913876048,886.1245330979264
11355,CR_03040C_A,798,CR,693874,695364,1490,61.000067859900064,72.22098268843412
11357,CR_03050C_A,1052,CR,695733,697517,1784,67.16369565241308,79.51840499824863
11359,CR_03060W_A,2072,CR,698441,699550,1109,212.8001354858203,251.94455416533765
11361,CR_03070W_A,557,CR,699794,700975,1181,53.717895839266724,63.599260813562395
11363,CR_03080C_A,174,CR,700998,701573,575,34.46633451750613,40.80638982631236
11365,CR_03090C_A,458,CR,701827,702325,498,104.74898669603978,124.01748096707935
11367,CR_03100W_A,416,CR,702956,706177,3221,14.710122894274047,17.416038508876582
11369,CR_03110W_A,320,CR,706382,707911,1529,23.837252021158474,28.222095908382286
11371,CR_03120W_A,1629,CR,708144,709112,968,191.6723299858997,226.930305349109
11373,CR_03130W_A,244,CR,709559,709993,434,64.03446597815179,75.81355597001463
11375,CR_03140C_A,255,CR,710184,710984,800,36.304786628084315,42.98302376640122
11377,CR_03150W_A,1659,CR,711420,714107,2687,70.32219446250794,83.25790719698725
11379,CR_03160W_A,144,CR,714284,715111,827,19.83219014892151,23.480306033570052
11381,CR_03170W_A,2679,CR,715385,717121,1736,175.76673601994733,208.09888979884138
11383,CR_03180W_A,394,CR,717480,718601,1121,40.031724983548216,47.395529520804835
11385,CR_03190C_A,43,CR,718810,719053,243,20.15467860899056,23.862115993935316
11387,CR_03200C_A,565,CR,719189,721528,2339,27.512618189261556,32.57354281184912
11389,CR_03210C_A,554,CR,721748,722428,680,92.79285717166647,109.86203075703011
11391,CR_03220C_A,238,CR,722592,723932,1340,20.229532847489764,23.950739611129038
11393,CR_03230W_A,951,CR,724231,726348,2117,51.16504425731297,60.576814177439495
11395,CR_03240C_A,531,CR,726435,728183,1748,34.59925822140759,40.96376474170421
11397,CR_03250C_A,3387,CR,728528,729391,863,447.0108824549894,529.2381850700509
11399,CR_03260W_A,1412,CR,731819,732900,1081,148.77251265198905,176.13910013069534
11401,CR_03270W_A,400,CR,734584,736089,1505,30.27172619630507,35.84018658132601
11403,CR_03280W_A,1011,CR,737211,738287,1076,107.01695249214444,126.70263729960386
11405,CR_03290C_A,66,CR,738489,740051,1562,4.812564921701317,5.697832479390384
11407,CR_03300C_A,43,CR,740776,741861,1085,4.513904978787748,5.344234273296114
11409,CR_03310C_A,486,CR,742230,743781,1551,35.689311237529694,42.25433215857396
11411,CR_03320C_A,1,CR,743131,743781,650,0.1752267227901505,0.20745954155729096
11413,CR_03330W_A,326,CR,744085,745158,1073,34.60441990608844,40.96987591424972
11415,CR_03340C_A,187,CR,745188,746252,1064,20.017676837540222,23.69991285365481
11417,CR_03350C_A,596,CR,746467,748209,1742,38.96833088915288,46.13652491348709
11419,CR_03360W_A,421,CR,748450,749193,743,64.53673309761061,76.40821473371827
11421,CR_03370C_A,272,CR,749202,750068,866,35.77376973360117,42.35432672901737
11423,CR_03380W_A,258,CR,750308,751414,1106,26.569187533370926,31.456568823831546
11425,CR_03390C_A,358,CR,751411,753240,1829,22.293744337489354,26.394661192116786
11427,CR_03400W_A,574,CR,753492,756413,2921,22.38174949435302,26.49885482883439
11429,CR_03410W_A,275,CR,756742,757680,938,33.392086032771225,39.53453417203172
11431,CR_03420C_A,2252,CR,757726,759538,1812,141.55456778157966,167.5934199401559
11433,CR_03430W_A,133,CR,759808,760161,353,42.913173329202586,50.807018038605676
11435,CR_03440W_A,51,CR,760304,761083,779,7.456695584715647,8.828348912226181
11437,CR_03450W_A,360,CR,762146,763934,1788,22.932356338308292,27.15074537159177
11439,CR_03460W_A,859,CR,764417,765511,1094,89.43129860135333,105.8821161138148
11441,CR_03470W_A,956,CR,767511,769010,1499,72.63901637211444,86.00090668692502
11443,CR_03480W_A,594,CR,770493,772619,2126,31.82268940229404,37.67644825741771
11445,CR_03490W_A,393,CR,773209,775044,1835,24.39327865762613,28.880403210250666
11447,CR_03500W_A,41283,CR,777835,779331,1496,3143.064918459064,3721.2292547936286
11449,CR_03510W_A,174,CR,780328,782037,1709,11.596338412853145,13.729475804639911
11451,CR_03520C_A,1831,CR,782046,783887,1841,113.27869860331215,134.11622671613787
11453,CR_03530W_A,4755,CR,784375,786078,1703,318.01643773555946,376.5153130171445
11455,CR_03540W_A,243,CR,786518,787492,974,28.41587357772513,33.642951323382036
11457,CR_03550W_A,517,CR,787654,789012,1358,43.36151707925632,51.337834271228004
11459,CR_03560W_A,186,CR,789311,790126,815,25.9937555648211,30.775286594204264
11461,CR_03570C_A,213,CR,790132,791100,968,25.062127861876384,29.672286703106334
11463,CR_03580C_A,295,CR,791587,792717,1130,29.734269110629526,35.2038646846111
11465,CR_03590C_A,37,CR,794436,795215,779,5.409759541852528,6.404880583379778
11467,CR_03600C_A,821,CR,795625,796227,602,155.3317950447904,183.9049573954291
11469,CR_03610C_A,1603,CR,796561,798915,2354,77.56052838198697,91.8277269862444
11471,CR_03620C_A,259,CR,801143,803746,2603,11.332853930742159,13.417523557883186
11473,CR_03630W_A,146,CR,804770,807595,2825,5.886377342578862,6.9691718562077565
11475,CR_03640C_A,827,CR,808438,809547,1109,84.93518921176322,100.55895091444702
11477,CR_03650W_A,1106,CR,809883,812918,3035,41.505927846405015,49.14091084861168
11479,CR_03660C_A,150,CR,812990,814756,1766,9.674182033997551,11.453740261515213
11481,CR_03670W_A,10,CR,816393,818339,1946,0.5852896701623732,0.692953247750458
11483,CR_03680C_A,648,CR,818425,822147,3722,19.82952596432332,23.477151774296335
11485,CR_03690W_A,1024,CR,823246,825456,2210,52.77416592268062,62.48193251607822
11487,CR_03700C_A,1108,CR,825518,829063,3545,35.598952257677404,42.147351714967826
11489,CR_03710C_A,1298,CR,829626,830528,902,163.9010931463969,194.0505711883441
11491,CR_03720W_A,11044,CR,831859,832830,971,1295.450620207389,1533.7477497663942
11493,CR_03730C_A,1130,CR,833215,834933,1718,74.91503369578903,88.69559561922597
11495,CR_03740C_A,452,CR,836037,836567,530,97.13511538820042,115.00304398024922
11497,CR_03750C_A,318,CR,836856,838037,1181,30.668385775380283,36.30981138009487
11499,CR_03760W_A,445,CR,839136,839924,788,64.32021518661298,76.15186852214012
11501,CR_03770C_A,1384,CR,840282,840809,527,299.11567328656434,354.1377677133566
11503,CR_03780C_A,434,CR,841232,841969,737,67.07117842483238,79.4088692989305
11505,CR_03790C_A,1041,CR,844006,844398,392,302.4672499386616,358.1058642722983
11507,CR_03800C_A,263,CR,847829,848824,995,30.10553594067963,35.64342575800893
11509,CR_03810W_A,163,CR,849445,852048,2603,7.132259423594487,8.444232972721851
11511,CR_03820C_A,296,CR,852102,853577,1475,22.856692518525396,27.06116325126968
11513,CR_03830C_A,550,CR,853958,856669,2711,23.107175727583478,27.357722650952237
11515,CR_03840C_A,123,CR,857988,858500,512,27.362063451313546,32.395293647471505
11517,CR_03850W_A,512,CR,860662,862605,1943,30.013100022934683,35.53398632540733
11519,CR_03860C_A,1306,CR,862757,864421,1664,89.39300779841273,105.83678174758671
11521,CR_03870W_A,386,CR,864747,865049,302,145.57743294055882,172.35628800239834
11523,CR_03880W_A,201,CR,866454,869279,2825,8.103848259303776,9.594544815738075
11525,CR_03890W_A,464,CR,878579,880504,1925,27.45370368493995,32.503791030482574
11527,CR_03900W_A,760,CR,884029,885798,1769,48.93273095440043,57.933868586377464
11529,CR_03910C_A,579,CR,885976,888228,2252,29.283560000920584,34.67024798627285
11531,CR_03920C_A,542,CR,888806,890914,2108,29.284807608619563,34.6717250904334
11533,CR_03930C_A,476,CR,892917,894218,1301,41.67190471273833,49.33741902984306
11535,CR_03940W_A,469,CR,894731,895831,1100,48.56169676597944,57.49458294885468
11537,CR_03950W_A,283,CR,896166,896951,785,41.06109000923336,48.61424543880722
11539,CR_03960C_A,416,CR,897030,898727,1697,27.9206280745178,33.05660579675396
11541,CR_03970C_A,372,CR,899035,899762,727,58.28035979457826,69.00098644917875
11543,CR_03980W_A,440,CR,900136,900864,728,68.83906966755914,81.50196275465002
11545,CR_03990C_A,1002,CR,901285,902727,1442,79.14366473871362,93.70208003901774
11547,CR_04000W_A,2374,CR,903050,904336,1286,210.2584416310119,248.93531771155182
11549,CR_04010C_A,746,CR,904414,905430,1016,83.62936799305511,99.01292490268739
11551,CR_04020C_A,242,CR,905753,906449,696,39.60224640070499,46.8870486881636
11553,CR_04030W_A,504,CR,906681,909368,2687,21.363704646837853,25.293541426932833
11555,CR_04040C_A,367,CR,909343,910701,1358,30.780806127827987,36.44291136855064
11557,CR_04050C_A,1167,CR,911098,912951,1853,71.73137105907645,84.92630072762172
11559,CR_04060C_A,1522,CR,913389,913856,467,371.202991126972,439.48549135466374
11561,CR_04070W_A,619,CR,914672,915199,527,133.78078162166426,158.38965188913852
11563,CR_04080C_A,2259,CR,915381,917402,2021,127.3103208356841,150.72895489641175
11565,CR_04090C_A,5604,CR,917825,919603,1778,358.9881104811037,425.0236929564612
11567,CR_04100C_A,4194,CR,920395,921009,614,777.9895260557482,921.1000915950015
11569,CR_04110W_A,513,CR,921803,923548,1745,33.48386860422676,39.643200075804394
11571,CR_04120C_A,1862,CR,923584,926355,2771,76.53442894006466,90.61287735358688
11573,CR_04130C_A,1168,CR,926631,927968,1337,99.50046966513258,117.8035033285679
11575,CR_04140W_A,1339,CR,928306,929691,1385,110.11449688116066,130.36997255912505
11577,CR_04150W_A,352,CR,929946,930866,920,43.578124102593954,51.59428598729149
11579,CR_04160C_A,459,CR,930968,932329,1361,38.41211810759839,45.47799722528857
11581,CR_04170W_A,1471,CR,932629,934485,1856,90.27102963135907,106.87631501077789
11583,CR_04180C_A,2357,CR,934581,936911,2330,115.21721057967815,136.41132645615778
11585,CR_04190W_A,2849,CR,937197,938834,1637,198.22456114779487,234.68781431452
11587,CR_04200W_A,1783,CR,939255,940436,1181,171.95513156447498,203.58614368147533
11589,CR_04210C_A,697,CR,941149,942678,1529,51.9205145585858,61.47125265044517
11591,CR_04220C_A,234,CR,943890,945383,1493,17.851295737697185,21.135027642909545
11593,CR_04230W_A,341,CR,947438,948166,728,53.35027899235833,63.16402113485376
11595,CR_04240C_A,1781,CR,948342,951470,3128,64.85013287660414,76.77926415722438
11597,CR_04250W_A,31,CR,952020,953492,1472,2.3986538479765853,2.839884349442536
11599,CR_04260W_A,127,CR,953783,954152,369,39.2004497732437,46.411341884971186
11601,CR_04270C_A,115,CR,954290,954736,446,29.368155893640697,34.77040522737107
11603,CR_04275W_A,160,CR,955228,955492,264,69.02870897793808,81.7264860680237
11605,CR_04280C_A,561,CR,955596,957281,1685,37.92072668571418,44.896214735232135
11607,CR_04290W_A,444,CR,957628,957945,317,159.52817727835156,188.87326086256834
11609,CR_04300W_A,3393,CR,958467,960608,2141,180.5015300222034,213.70464545891048
11611,CR_04310C_A,217,CR,960689,961276,587,42.10516056141522,49.85037195341719
11613,CR_04330W_A,339,CR,961901,963100,1199,32.2028426745702,38.12653042714684
11615,CR_04340W_A,3123,CR,963533,966769,3236,109.92011308030472,130.1398320099576
11617,CR_04350C_A,273,CR,966882,968228,1346,23.10102671553656,27.350442532943003
11619,CR_04360C_A,599,CR,968673,969152,479,142.4311576583405,168.63125783993996
11621,CR_04370W_A,165,CR,969415,970200,785,23.94021148948235,28.343994690470645
11623,CR_04380C_A,3588,CR,970313,973171,2858,142.9894201858604,169.2922123232729
11625,CR_04390C_A,456,CR,973585,975972,2387,21.75835803728555,25.760791000243415
11627,CR_04400W_A,27,CR,977144,977368,224,13.728700825746168,16.25408461754668
11629,CR_04410W_A,86,CR,977512,978837,1325,7.392584002995784,8.75244405513401
11631,CR_04420C_A,373,CR,979245,979751,506,83.95991885468774,99.40428033708537
11633,CR_04430W_A,6,CR,980798,981112,314,2.1763828626802137,2.5767267900427857
11635,CR_04440C_A,190,CR,982073,982408,335,64.59850825248833,76.48135338007592
11637,CR_04450C_A,1274,CR,984184,986580,2396,60.5614562364456,71.70168879949608
11639,CR_04460C_A,332,CR,986837,987634,797,47.445328454346914,56.17285955842332
11641,CR_04470W_A,202,CR,987812,988726,914,25.17206641394613,29.802448365943437
11643,CR_04480C_A,1465,CR,988875,990404,1529,109.12991940936615,129.20428283056268
11645,CR_04490C_A,367,CR,990786,991736,950,44.000352338516215,52.09418277735974
11647,CR_04500C_A,607,CR,992082,993203,1121,61.67324128176082,73.01798583535161
11649,CR_04510W_A,7570,CR,995376,996830,1454,592.9869941464482,702.0664884681225
11651,CR_04520W_A,258,CR,997160,997549,389,75.54118614886438,89.43692832688353
11653,CR_04530W_A,1541,CR,997809,999197,1388,126.45233925270483,149.71314827151332
11655,CR_04540C_A,141,CR,999194,999619,425,37.78712739698187,44.738039961707564
11657,CR_04550W_A,1556,CR,999810,1000746,936,189.3422087926904,224.17156018273937
11659,CR_04560C_A,379,CR,1000795,1001913,1118,38.611004614806426,45.713468750123994
11661,CR_04570C_A,1149,CR,1002171,1003244,1073,121.96465788986387,144.39996142783107
11663,CR_04580W_A,883,CR,1004038,1004661,623,161.43078257689712,191.12584891943362
11665,CR_04590C_A,1505,CR,1004818,1005627,809,211.88571269402317,250.86192401535214
11667,CR_04600W_A,759,CR,1006481,1008139,1658,52.13999016195462,61.731100619595594
11669,CR_04610C_A,94,CR,1008189,1009691,1502,7.128064422422234,8.43926630436117
11671,CR_04620C_A,13,CR,1009945,1011462,1517,0.9760486536432248,1.155592040975022
11673,CR_04630C_A,140,CR,1011959,1013122,1163,13.710775385987702,16.232861807148304
11675,CR_04640W_A,123,CR,1014145,1015671,1526,9.180456413546878,10.869194198889522
11677,CR_04650W_A,132,CR,1015922,1016209,287,52.3848530153133,62.02100580353855
11679,CR_04660C_A,4399,CR,1016385,1018027,1642,305.1367416626169,361.26640691342254
11681,CR_04670C_A,4,CR,1018393,1018749,356,1.2797457282426723,1.515153955193698
11683,CR_04680C_A,24,CR,1019056,1019358,302,9.051446607703141,10.716453140045491
11685,CR_04690C_A,2,CR,1019991,1020106,115,1.9808238228451798,2.3451948176041584
11687,CR_04700C_A,2,CR,1020200,1020314,114,1.9981994704139971,2.3657667019691075
11689,CR_04710W_A,58,CR,1020906,1021310,404,16.351602597001673,19.35946712056898
11691,CR_04720C_A,1310,CR,1021410,1025573,4163,35.84087303766831,42.43377363344541
11693,CR_04730W_A,367,CR,1026934,1027266,332,125.90462265539279,149.0646796340113
11695,CR_04740C_A,1941,CR,1027449,1031561,4112,53.76332558565015,63.65304732630256
11697,CR_04750W_A,359,CR,1032104,1032370,266,153.7186306882768,181.99505271576632
11699,CR_04760C_A,335,CR,1032764,1034449,1685,22.64428420626426,26.80968259590511
11701,CR_04770C_A,431,CR,1034922,1035491,569,86.27375463912244,102.14374440645881
11703,CR_04780W_A,564,CR,1036032,1036478,446,144.0316515131596,170.52616128901985
11705,CR_04790W_A,598,CR,1037049,1037616,567,120.12456287218961,142.2213823691693
11707,CR_04800W_A,367,CR,1038242,1040401,2159,19.360970227693564,22.922405575957278
11709,CR_04810W_A,3605,CR,1040990,1041745,755,543.8410836794969,643.8802261643999
11711,CR_04820W_A,12159,CR,1043307,1043612,305,4540.583998568971,5375.820877923986
11713,CR_04830C_A,353,CR,1044383,1046803,2420,16.613955183553735,19.67007926046298
11715,CR_04840C_A,650,CR,1048237,1050153,1916,38.63950437308904,45.74721101667819
11717,CR_04850C_A,138,CR,1051306,1052082,776,20.254944631799617,23.980825873310565
11719,CR_04860C_A,388,CR,1052051,1053439,1388,31.83874602858499,37.695458487571166
11721,CR_04870C_A,2364,CR,1054455,1055960,1505,178.90590182016297,211.81550269563672
11723,CR_04880W_A,737,CR,1056963,1058072,1109,75.69194008351812,89.61541333004529
11725,CR_04890W_A,26,CR,1058318,1059307,989,2.9942685694171325,3.5450619335876814
11727,CR_04900C_A,13,CR,1059951,1060796,845,1.7522672279015055,2.07459541557291
11729,CR_04910W_A,138,CR,1062959,1064113,1154,13.620309388454508,16.125754660042457
11731,CR_04920W_A,509,CR,1064625,1065713,1088,53.284707017574725,63.086387246534656
11733,CR_04930W_A,1539,CR,1066170,1067528,1358,129.0780943616547,152.82190898146985
11735,CR_04940W_A,159,CR,1068772,1069845,1073,16.87761584376706,19.982240093146338
11737,CR_04950W_A,332,CR,1070692,1073802,3110,12.15881889971527,14.39542413764096
11739,CR_04960C_A,938,CR,1073848,1074759,911,117.2730328047802,138.84531557352392
11741,CR_04970C_A,3,CR,1075494,1076363,869,0.39320150683635624,0.46553061684317304
11743,CR_04980C_A,3,CR,1077754,1078335,581,0.5881103432715896,0.6962927814745564
11745,CR_04990C_A,1,CR,1079939,1080766,827,0.1377235427008438,0.1630576807886809
11747,CR_05000C_A,2,CR,1081690,1082016,326,0.6987568700220727,0.8272926503818351
11749,CR_05010W_A,301,CR,1082017,1084071,2054,16.69089986070738,19.761177850868535
11751,CR_05020W_A,174,CR,1084330,1085919,1589,12.4720845484997,14.766314757790816
11753,CR_05030W_A,1191,CR,1087249,1090161,2912,46.5837113488994,55.15274865953873
11755,CR_05040W_A,65,CR,1091568,1091867,299,24.76029778556475,29.314935220051982
11757,CR_05050W_A,17020,CR,1095486,1096607,1121,1729.289236598961,2047.3906407210613
11759,CR_05070W_A,4,CR,1098929,1099026,97,4.696798755199911,5.560771216999552
11761,CR_05080W_A,884,CR,1099596,1101072,1476,68.21495590462094,80.76304375258766
11763,CR_05090C_A,43,CR,1101386,1103358,1972,2.48356333772044,2.940412873492029
11765,CR_05100W_A,401,CR,1105182,1109018,3836,11.90637260043085,14.096540538818532
11767,CR_05120W_A,1120,CR,1110467,1113241,2774,45.98596041500706,54.44504190833015
11769,CR_05130C_A,316,CR,1113311,1114213,902,39.9019610433447,47.241895605174676
11771,CR_05140W_A,187,CR,1114420,1115133,713,29.87210119935876,35.3670508783853
11773,CR_05150W_A,181,CR,1115354,1115629,275,74.96517795004077,88.75496386987373
11775,CR_05160C_A,139,CR,1115649,1116845,1196,13.237236123821155,15.672215367643176
11777,CR_05170C_A,7465,CR,1117036,1118175,1139,746.4827617721754,883.7976826350878
11779,CR_05180C_A,3424,CR,1119608,1120399,791,493.0272999263704,583.7192865864813
11781,CR_05190W_A,1,CR,1122154,1122981,827,0.1377235427008438,0.1630576807886809
11783,CR_05200C_A,661,CR,1124185,1124604,419,179.68057624531784,212.7326778761099
11785,CR_05210W_A,49,CR,1125688,1126713,1025,5.4448498740158975,6.446425754731431
11787,CR_05220C_A,1583,CR,1126971,1128866,1895,95.14487409758596,112.64669935903669
11789,CR_05240C_A,1824,CR,1129264,1132713,3449,60.23450349086763,71.31459335179014
11791,CR_05250C_A,422,CR,1132887,1134713,1826,26.322393242792053,31.164376916300608
11793,CR_05260C_A,437,CR,1135405,1136463,1058,47.044565792573025,55.69837691809877
11795,CR_05270W_A,10,CR,1136783,1137096,313,3.6388936042683016,4.30826524000764
11797,CR_05280W_A,10,CR,1137083,1137402,319,3.5704504643761075,4.227232038001226
11799,CR_05290W_A,198,CR,1138119,1139255,1136,19.851830302017934,23.503558977485337
11801,CR_05300C_A,1596,CR,1139330,1141312,1982,91.71554098007174,108.58654309360931
11803,CR_05310W_A,676,CR,1142603,1143064,461,167.01653360952741,197.7390944908322
11805,CR_05320C_A,16,CR,1146067,1146381,314,5.803687633813903,6.8712714401140955
11807,CR_05330W_A,126,CR,1147599,1147784,185,77.57334376493691,91.84289974887636
11809,CR_05340C_A,5902,CR,1148612,1149919,1307,514.3246186992001,608.9342305097439
11811,CR_05350W_A,5,CR,1151638,1151704,66,8.62858862224226,10.215810758502963
11813,CR_05360C_A,396,CR,1151763,1153322,1559,28.93095474418521,34.252781268022254
11815,CR_05370W_A,354,CR,1153825,1155368,1543,26.130699231376298,30.937420941239566
11817,CR_05380C_A,2481,CR,1155586,1156452,866,326.3041276068548,386.32751696577975
11819,CR_05390W_A,5375,CR,1157977,1158576,599,1022.033994571099,1210.0363494420455
11821,CR_05400C_A,1,CR,1158859,1158954,95,1.1989196822483983,1.4194600211814645
11823,CR_05410C_A,2,CR,1158985,1159078,93,2.449405802442964,2.8999720862847123
11825,CR_05420W_A,33,CR,1160039,1160353,314,11.970105744741176,14.171997345235322
11827,CR_05430W_A,126,CR,1160460,1161524,1064,13.48784642529448,15.968925238291476
11829,CR_05440W_A,570,CR,1162025,1162540,515,126.06116658980731,149.2500197028666
11831,CR_05450C_A,574,CR,1162653,1163300,647,101.04650737713318,119.63393346989993
11833,CR_05460W_A,528,CR,1163597,1164436,839,71.67796336302702,84.86306872760699
11835,CR_05470C_A,4,CR,1164573,1164644,71,6.4167532289350895,7.5971099725205145
11837,CR_05480W_A,1538,CR,1165883,1166743,860,203.69087764338778,241.1596554590974
11839,CR_05490W_A,319,CR,1167478,1168518,1040,34.93582785628627,41.36224609798488
11841,CR_05500C_A,503,CR,1168592,1171228,2636,21.733830431046936,25.73175155999859
11843,CR_05510W_A,563,CR,1171820,1174612,2792,22.96712722244111,27.191912332697218
11845,CR_05520W_A,1489,CR,1174805,1176949,2144,79.10129834535783,93.65192038070153
11847,CR_05530C_A,753,CR,1177061,1178797,1736,49.403640247488006,58.49140127604611
11849,CR_05540C_A,882,CR,1179301,1181166,1865,53.86460063034493,63.772951836351154
11851,CR_05550C_A,1095,CR,1181749,1185222,3473,35.910630563170066,42.51636300126744
11853,CR_05560W_A,391,CR,1185511,1186995,1484,30.009347437410213,35.52954345470721
11855,CR_05570C_A,408,CR,1187177,1189627,2450,18.96739872814201,22.456436906527983
11857,CR_05580C_A,6,CR,1190023,1190650,627,1.0899269838621803,1.2904182010740586
11859,CR_05590C_A,1,CR,1190766,1190860,94,1.2116741469531684,1.4345606597046716
11861,CR_05600C_A,2,CR,1190939,1191036,97,2.3483993775999554,2.780385608499776
11863,CR_05610C_A,724,CR,1194011,1194859,848,97.24256573708118,115.13025973686453
11865,CR_05620C_A,377,CR,1198841,1200487,1646,26.087064653539727,30.885759816898023
11867,CR_05630W_A,431,CR,1201081,1202403,1322,37.13295490897176,43.96353295557872
11869,CR_05640C_A,184,CR,1202423,1202998,575,36.44715834035131,43.151584643916514
11871,CR_05650W_A,930,CR,1203262,1204923,1661,63.771555645181216,75.50228348668416
11873,CR_05660W_A,1560,CR,1205203,1207482,2279,77.9639740716159,92.30538619530189
11875,CR_05670C_A,973,CR,1207729,1208400,671,165.1596733660666,195.54066625619774
11877,CR_05680C_A,44,CR,1208432,1208830,398,12.591669024618856,14.907896704870657
11879,CR_05690W_A,312,CR,1209450,1210475,1025,34.66924817740735,41.04662929543278
11881,CR_05700C_A,698,CR,1210658,1211560,902,88.13787597548925,104.35076940636687
11883,CR_05710C_A,134,CR,1211886,1212743,857,17.808923634798262,21.084861224784184
11885,CR_05720W_A,1567,CR,1213671,1215107,1436,124.28772875898873,147.15035936850884
11887,CR_05730C_A,1100,CR,1215325,1216785,1460,85.81308684586139,101.59833713250892
11889,CR_05740C_A,1047,CR,1217854,1218891,1037,114.99570510591798,136.14907522354326
11891,CR_05750W_A,2796,CR,1219964,1220992,1028,309.7831186758945,366.7674813484636
11893,CR_05760C_A,208,CR,1221035,1222030,995,23.809701428370204,28.189477405573605
11895,CR_05770W_A,515,CR,1222388,1223902,1514,38.74316080185131,45.86993496453312
11897,CR_05780W_A,3668,CR,1224232,1225770,1538,271.63559978951685,321.6027561644298
11899,CR_05790C_A,1350,CR,1225928,1228303,2375,64.74166284141351,76.65084114379907
11901,CR_05800C_A,187,CR,1228646,1229050,404,52.719822166195044,62.417592268041375
11903,CR_05810C_A,2,CR,1229471,1229561,90,2.531052662524396,2.9966378224942023
11905,CR_05820C_A,1,CR,1230058,1230148,90,1.265526331262198,1.4983189112471011
11907,CR_05830C_A,231,CR,1230747,1232063,1316,19.992623424727284,23.670250885127082
11909,CR_05840W_A,261,CR,1232321,1233040,719,41.345220474755266,48.95064148149431
11911,CR_05850W_A,1,CR,1233214,1233287,73,1.5602379426520252,1.847242493318344
11913,CR_05860W_A,1798,CR,1233738,1234418,680,301.158045477719,356.55583267353813
11915,CR_05870W_A,1,CR,1234600,1234681,81,1.4061403680691091,1.6647987902745571
11917,CR_05880W_A,604,CR,1235017,1235643,626,109.89458684890269,130.1096102482307
11919,CR_05890C_A,982,CR,1235775,1236602,827,135.24451893222863,160.12264253448467
11921,CR_05900W_A,434,CR,1236909,1238417,1508,32.77948176332988,38.80924182580357
11923,CR_05910W_A,263,CR,1238642,1239028,386,77.60364834449801,91.87877883217328
11925,CR_05920C_A,3796,CR,1239215,1242844,3629,119.13872025693507,141.05419477499578
11927,CR_05930C_A,1,CR,1243713,1243794,81,1.4061403680691091,1.6647987902745571
11929,CR_05940W_A,48,CR,1244534,1245652,1118,4.890048077864666,5.789568601598816
11931,CR_05950C_A,1562,CR,1245828,1248944,3116,57.094894624146285,67.59745588675145
11933,CR_05960W_A,97,CR,1249568,1249843,275,40.17470862515997,47.5648148915898
11935,CR_05970C_A,708,CR,1249893,1251227,1334,60.449278731654616,71.56887633033381
11937,CR_05980W_A,1835,CR,1251495,1255409,3914,53.39848584771385,63.22109560359193
11939,CR_05990C_A,2598,CR,1255695,1258112,2417,122.42671360187306,144.94701192709854
11941,CR_06000W_A,5533,CR,1274159,1276636,2477,254.4183072986019,301.21835617025397
11943,CR_06010W_A,862,CR,1278556,1279848,1292,75.99035044839113,89.9687160484134
11945,CR_06020W_A,284,CR,1280965,1282092,1127,28.701732943266897,33.98139429589699
11947,CR_06030C_A,343,CR,1282621,1285008,2387,16.366484225414354,19.377086212902395
11949,CR_06040W_A,7484,CR,1290764,1292656,1892,450.53272499205406,533.4078677904849
11951,CR_06050W_A,627,CR,1293451,1294404,953,74.93562526036291,88.71997498601672
11953,CR_06060W_A,669,CR,1295059,1295826,767,99.34464198865314,117.61901127273529
11955,CR_06070W_A,1677,CR,1295893,1297119,1226,155.79599443507632,184.45454590091762
11957,CR_06080W_A,2514,CR,1297516,1298547,1031,277.72840709154707,328.8163306098634
11959,CR_06090W_A,752,CR,1298889,1299875,986,86.86695953329165,102.84606887748865
11961,CR_06100C_A,236,CR,1299955,1301847,1892,14.207071498947723,16.820451202372322
11963,CR_06110C_A,815,CR,1302431,1304986,2555,36.33125495032573,43.014360915841436
11965,CR_06120W_A,792,CR,1308687,1309574,887,101.69866616952591,120.40605636267576
11967,CR_06130C_A,7,CR,1315840,1316193,353,2.258588069958031,2.6740535809792463
11969,CR_06140W_A,1817,CR,1316618,1318372,1754,117.98832437360736,139.6921844676388
11971,CR_06150C_A,2290,CR,1318865,1320313,1448,180.1277464593502,213.26210470167652
11973,CR_06160C_A,95,CR,1320937,1321353,416,26.010216664162968,30.794775699910375
11975,CR_06170W_A,460,CR,1321747,1322535,788,66.48831232773477,78.71878543861675
11977,CR_06180W_A,1603,CR,1322879,1324033,1154,158.2127242731346,187.3158313046961
11979,CR_06190C_A,9,CR,1324260,1324350,90,11.389736981359784,13.484870201223911
11981,CR_06200C_A,5,CR,1324465,1324551,86,6.621940105441735,7.840040814665064
11983,CR_06210C_A,2,CR,1324474,1324560,86,2.648776042176694,3.136016325866026
11985,CR_06220C_A,6,CR,1324683,1324826,143,4.77891062154956,5.657987497017026
11987,CR_06230W_A,446,CR,1326329,1328179,1850,27.45850104695386,32.50947086349116
11989,CR_06240C_A,182,CR,1328224,1330083,1859,11.150791450282307,13.201970826373062
11991,CR_06250W_A,292,CR,1330782,1331681,899,36.994473843793735,43.79957840664497
11993,CR_06260W_A,444,CR,1331745,1332917,1172,43.14883293279645,51.086027042179325
11995,CR_06270W_A,104,CR,1334033,1334527,494,23.97839364496797,28.389200423629287
11997,CR_06290C_A,1033,CR,1335351,1336430,1079,109.04168954350934,129.09982314980815
11999,CR_06300C_A,302,CR,1336646,1337380,734,46.86240556363289,55.482708457351784
12001,CR_06310W_A,778,CR,1338711,1339799,1088,81.44499422332639,96.42673728448717
12003,CR_06320C_A,521,CR,1339957,1341360,1403,42.29545949599749,50.075676228351085
12005,CR_06330C_A,195,CR,1342340,1342891,551,40.308506558351326,47.72322485006647
12007,CR_06340C_A,6699,CR,1343151,1344803,1652,461.86348691361496,546.8229145157324
12009,CR_06350C_A,15,CR,1346060,1346347,287,5.952824206285601,7.047841568583926
12011,CR_06380C_A,237,CR,1348951,1350489,1538,17.55115516633465,20.77967644791981
12013,CR_06420W_A,1307,CR,1364396,1365844,1448,102.80653476959418,121.7177165262407
12015,CR_06430W_A,92,CR,1366337,1367128,791,13.247228853161822,15.684046251739568
12017,CR_06440C_A,2113,CR,1368264,1370486,2222,108.31014510176969,128.23371167950552
12019,CR_06450W_A,389,CR,1378087,1380147,2060,21.507804299752213,25.46414809842768
12021,CR_06460W_A,534,CR,1380753,1381400,647,94.00493891879637,111.29707399464559
12023,CR_06470W_A,1533,CR,1381903,1383804,1901,91.84885214321173,108.74437674106395
12025,CR_06480C_A,267,CR,1383886,1385961,2075,14.655709754328011,17.351616114345948
12027,CR_06490C_A,4065,CR,1386423,1388123,1700,272.3487107601619,322.44704334103056
12029,CR_06500C_A,209,CR,1389144,1389644,500,47.6091005820839,56.36675744111595
12031,CR_06510W_A,372,CR,1390614,1391096,482,87.90419412999667,104.0741019679522
12033,CR_06520C_A,253,CR,1391227,1391886,659,43.726911324492036,51.77044250242261
12035,CR_06530W_A,496,CR,1392635,1393051,416,135.80071016236667,160.78114470690048
12037,CR_06540W_A,339,CR,1393317,1396052,2735,14.117443644171725,16.71433637372909
12039,CR_06550C_A,9855,CR,1396675,1397004,329,3411.728205206707,4039.3129432541537
12041,CR_06560C_A,2103,CR,1400076,1400852,776,308.66774319329414,365.44693341718926
12043,CR_06570C_A,124,CR,1401467,1403584,2117,6.671362237546591,7.8985541093611955
12045,CR_06580W_A,17,CR,1406153,1406851,698,2.774004708927168,3.284280708034477
12047,CR_06590C_A,1953,CR,1409035,1410333,1298,171.37254487361832,202.89639062396225
12049,CR_06600C_A,162,CR,1416506,1416586,80,230.6421738725356,273.06862157478423
12051,CR_06610W_A,35,CR,1418649,1420058,1409,2.82924623383671,3.3496838682955072
12053,CR_06620W_A,508,CR,1420374,1421720,1346,42.986525902903196,50.89386376093424
12055,CR_06630W_A,27,CR,1424337,1424474,137,22.446926897570375,26.576021564455885
12057,CR_06640C_A,1631,CR,1424764,1426245,1481,125.43322766102504,148.50657189869142
12059,CR_06650C_A,232,CR,1426753,1427130,377,70.09068911606022,82.98381662291636
12061,CR_06660W_A,190,CR,1429410,1431239,1829,11.83187548637703,14.008339738832932
12063,CR_06670W_A,17,CR,1433878,1436097,2219,0.8725801202483837,1.0330905516935849
12065,CR_06680C_A,912,CR,1436296,1439613,3317,31.315767642448364,37.07627863586435
12067,CR_06690C_A,356,CR,1439829,1440640,811,49.99687256922421,59.19375821992247
12069,CR_06700C_A,688,CR,1440889,1441668,779,100.59228553498757,119.0961578747375
12071,CR_06710C_A,659,CR,1441949,1443298,1349,55.64000497195032,65.87494041961867
12073,CR_06720W_A,1223,CR,1443567,1445129,1562,89.17828635213198,105.58256245900668
12075,CR_06730W_A,471,CR,1445416,1447335,1919,27.955008432623544,33.09731039487474
12077,CR_06740W_A,302,CR,1447534,1450149,2615,13.153730662985293,15.573349142522451
12079,CR_06750C_A,1570,CR,1450291,1451058,767,233.14063964452228,276.0266781736837
12081,CR_06760C_A,6164,CR,1451389,1453027,1638,428.6101266978127,507.45262466632596
12083,CR_06770C_A,505,CR,1453898,1454575,677,84.96037186981819,100.58876590277806
12085,CR_06780W_A,984,CR,1455508,1456623,1115,100.5157057368433,119.00549128255004
12087,CR_06790C_A,111,CR,1457397,1459211,1814,6.969464194768116,8.25149168873128
12089,CR_06800C_A,847,CR,1460975,1461292,317,304.3251489972157,360.30552241125093
12091,CR_06810W_A,614,CR,1462250,1462660,410,170.56825625743676,201.94415374515808
12093,CR_06820W_A,101,CR,1462868,1463392,524,21.953500670178208,25.991829968007924
12095,CR_06830C_A,229,CR,1463495,1464340,845,30.866861168418822,36.54479616663048
12097,CR_06840W_A,684,CR,1464905,1467055,2150,36.23525625697717,42.90070333784724
12099,CR_06850C_A,66,CR,1467125,1467409,284,26.469107069357246,31.33807863664712
12101,CR_06860C_A,2165,CR,1467616,1469505,1889,130.53880658890384,154.55131808178808
12103,CR_06870C_A,21,CR,1470593,1472848,2255,1.0606850403927073,1.2557972249476812
12105,CR_06880C_A,1,CR,1474054,1474135,81,1.4061403680691091,1.6647987902745571
12107,CR_06900C_A,286,CR,1475518,1477209,1691,19.263540961968648,22.807054272915668
12109,CR_06910W_A,1155,CR,1479588,1484264,4676,28.133332364137193,33.30843687428062
12111,CR_06920W_A,32,CR,1484615,1485739,1124,3.2426297455828563,3.8391089540850993
12113,CR_06930W_A,367,CR,1486110,1487075,965,43.31640903791752,51.2844286409241
12115,CR_06940W_A,180,CR,1487266,1489308,2042,10.03992486113987,11.88676119598582
12117,CR_06950C_A,188,CR,1489480,1489704,224,95.59243537926962,113.17658918884356
12119,CR_06960W_A,432,CR,1490321,1491811,1490,33.02259312716394,39.09707333509215
12121,CR_06970C_A,443,CR,1491831,1493075,1244,40.55991545612849,48.02088021818483
12123,CR_06980W_A,76,CR,1493258,1493704,446,19.4085204166669,22.97870258504523
12125,CR_06990W_A,3,CR,1496722,1499319,2597,0.13157185577235023,0.1557743958554938
12127,CR_07000C_A,713,CR,1499481,1506116,6635,12.239461141988738,14.490900457381535
12129,CR_07010W_A,4695,CR,1507086,1509926,2840,188.29160256156405,222.92769575614884
12131,CR_07020W_A,650,CR,1510568,1511113,545,135.8408997776855,160.8287271705604
12133,CR_07030C_A,200,CR,1511408,1512253,845,26.957957352330848,31.916852547275532
12135,CR_07040W_A,251,CR,1512664,1514073,1409,20.289737276943264,24.022018598347778
12137,CR_07050C_A,4941,CR,1514438,1521088,6650,84.62660214270481,100.1935994951088
12139,CR_07060C_A,6174,CR,1523634,1525187,1553,452.8025506948829,536.0952261581225
12141,CR_07070C_A,1003,CR,1532277,1535744,3467,32.95040724633361,39.01160891787593
12143,CR_07080W_A,824,CR,1538707,1539444,737,127.34251387571862,150.7670698210109
12145,CR_07090W_A,1819,CR,1540034,1545817,5783,35.825577674379126,42.41566470002818
12147,CR_07100W_A,5570,CR,1547917,1550352,2435,260.53731000482134,308.4629446440131
12149,CR_07110C_A,217,CR,1550708,1552915,2207,11.198789872927382,13.258798521366511
12151,CR_07120C_A,238,CR,1553189,1554349,1160,23.368598289341623,27.667233688718028
12153,CR_07130C_A,1838,CR,1555145,1556692,1547,135.3221497849986,160.21455352197512
12155,CR_07140C_A,209,CR,1557476,1558195,719,33.10785854108755,39.198023255296214
12157,CR_07150W_A,4205,CR,1559026,1560444,1418,337.7563047011135,399.886313089891
12159,CR_07160C_A,1157,CR,1560577,1561917,1340,98.34272901069605,116.43279718519453
12161,CR_07170W_A,853,CR,1563256,1564104,848,114.56893449410255,135.64380049108487
12163,CR_07180W_A,910,CR,1564407,1565804,1397,74.19227382274448,87.83988463216721
12165,CR_07190W_A,368,CR,1566214,1568853,2639,15.882619208565366,18.804214604207655
12167,CR_07200W_A,530,CR,1569149,1570732,1583,38.133674037401676,45.148333585904446
12169,CR_07210W_A,509,CR,1570998,1571474,476,121.7936160401708,144.1974565635078
12171,CR_07220C_A,429,CR,1571688,1574810,3122,15.650855749530262,18.52981843794061
12173,CR_07230W_A,612,CR,1576200,1576703,503,138.5789072085922,164.07038892940426
12175,CR_07240C_A,2913,CR,1576964,1577719,755,439.44773280398744,520.2837999492087
12177,CR_07250C_A,955,CR,1579345,1581459,2114,51.453163752122016,60.9179330282348
12179,CR_07260C_A,17,CR,1582019,1582624,605,3.2004219617044023,3.789137081335645
12181,CR_07270C_A,281,CR,1582853,1584550,1697,18.85984732918149,22.32910151174967
12183,CR_07280W_A,3725,CR,1586232,1587092,860,493.3345378554092,584.0830406925472
12185,CR_07290W_A,8027,CR,1587150,1588361,1211,754.9580408701486,893.8319827021003
12187,CR_07300W_A,21,CR,1589557,1591749,2192,1.0911700575207823,1.29188993716105
12189,CR_07310W_A,383,CR,1592134,1594029,1895,23.01989057446331,27.254381462104266
12191,CR_07320C_A,798,CR,1594104,1595033,929,97.83649204655661,115.83343832698259
12193,CR_07330W_A,197,CR,1595318,1595608,290,77.37166156303026,91.60411826348657
12195,CR_07340C_A,432,CR,1595677,1596750,1073,45.85616380193314,54.29136930968062
12197,CR_07350W_A,1372,CR,1597334,1599787,2453,63.70452155901193,75.4229185327322
12199,CR_07360W_A,629,CR,1600181,1602901,2720,26.3387667693945,31.183762340330297
12201,CR_07370W_A,544,CR,1603281,1603664,383,161.77589863863506,191.53444881111773
12203,CR_07380C_A,352,CR,1603744,1604676,932,43.01703237595111,50.929981875867135
12205,CR_07390C_A,632,CR,1604878,1605645,767,93.85024474862298,111.11392395271854
12207,CR_07400C_A,10478,CR,1606023,1607498,1475,809.0960277334768,957.9286099554179
12209,CR_07410C_A,1,CR,1607966,1608040,74,1.5391536461297004,1.8222797569221505
12211,CR_07420W_A,7003,CR,1609157,1610482,1325,601.9798345695289,712.7135548616684
12213,CR_07440W_A,784,CR,1611767,1614118,2351,37.98193872133591,44.96868667698659
12215,CR_07450C_A,2054,CR,1614446,1617163,2717,86.10423172511224,101.94303788485063
12217,CR_07460C_A,287,CR,1618134,1620149,2015,16.22260304541071,19.206738202239517
12219,CR_07470W_A,189,CR,1620898,1621350,452,47.62522764329644,56.3858510626398
12221,CR_07480W_A,4581,CR,1622533,1623873,1340,389.37600829559085,461.0014208343787
12223,CR_07490C_A,907,CR,1624294,1625424,1130,91.42027824861349,108.23696701336361
12225,CR_07500W_A,25,CR,1626254,1626940,686,4.150778783294382,4.914311297822126
12227,CR_07510W_A,302,CR,1627319,1627769,450,76.43779040823676,90.49846223932491
12229,CR_07520C_A,2727,CR,1627966,1628634,668,464.9672567091038,550.4976203403834
12231,CR_07530C_A,4022,CR,1629332,1631914,2582,177.41875344317992,210.05479453649332
12233,CR_07540C_A,46,CR,1634660,1636483,1823,2.8739873897013166,3.4026551248288532
12235,CR_07550C_A,7,CR,1637820,1638125,305,2.614037995721918,3.0948882429038487
12237,CR_07560W_A,297,CR,1639406,1642045,2639,12.818309524304116,15.17622754741759
12239,CR_07570W_A,331,CR,1642482,1643309,827,45.586492633979304,53.97209234105338
12241,CR_07580C_A,575,CR,1643364,1647227,3863,16.953400891229293,20.071965740884675
12243,CR_07590W_A,540,CR,1649718,1650320,602,102.16707591252963,120.96062971197529
12245,CR_07600W_A,801,CR,1650950,1654243,3293,27.704765630334606,32.801035624598704
12247,CR_07610C_A,15,CR,1654471,1654964,493,3.465437215423869,4.102901683942367
12249,CR_07620W_A,3480,CR,1655311,1656561,1250,317.0902775610564,375.4187864020737
12251,CR_07630C_A,1858,CR,1657163,1657839,676,313.049279753942,370.6344502052371
12253,CR_07640C_A,487,CR,1658503,1659099,596,93.06714613963447,110.1867749663766
12255,CR_07650W_A,1846,CR,1660822,1661814,992,211.95014584264277,250.93820959132404
12257,CR_07660C_A,591,CR,1662889,1663806,917,73.40604750254779,86.90903259458378
12259,CR_07670W_A,268,CR,1664072,1664860,788,38.736668921375916,45.862248907715845
12261,CR_07680C_A,510,CR,1665030,1667474,2444,23.76745442100446,28.139459094207016
12263,CR_07690W_A,196,CR,1669651,1669986,335,66.63846114467218,78.89655401313095
12265,CR_07700W_A,1317,CR,1671100,1672311,1211,123.86691663460643,146.652139182592
12267,CR_07710W_A,1062,CR,1672493,1673734,1241,97.46898206449711,115.39832517082831
12269,CR_07720C_A,242,CR,1673907,1675646,1739,15.85000776014415,18.765604305325972
12271,CR_07730W_A,476,CR,1677339,1679117,1778,30.492209241435642,36.10122731036323
12273,CR_07740W_A,86,CR,1679654,1679848,194,50.49058661839904,59.77829058274518
12275,CR_07750C_A,678,CR,1679976,1681796,1820,42.42989930418645,50.234846134229734
12277,CR_07760W_A,169,CR,1682063,1682338,275,69.99511090362923,82.87065687297603
12279,CR_07770C_A,1201,CR,1682501,1683802,1301,105.14276798319064,124.48369801437293
12281,CR_07780W_A,1968,CR,1684645,1686483,1838,121.95322295601771,144.38642304683708
12283,CR_07790C_A,5038,CR,1686913,1688109,1196,479.77838555259694,568.0332447639304
12285,CR_07800W_A,388,CR,1692632,1693828,1196,36.949982849227396,43.74690332838527
12287,CR_07810W_A,355,CR,1696870,1698072,1202,33.638574279390376,39.826363739055644
12289,CR_07820W_A,146,CR,1699955,1702141,2186,7.6070521467453265,9.006363446380107
12291,CR_07830C_A,3280,CR,1702917,1703366,449,832.034238281962,985.0862864145752
12293,CR_07840C_A,611,CR,1703463,1704053,590,117.95134399340385,139.6484015753866
12295,CR_07850W_A,657,CR,1706856,1708703,1847,40.51465726450124,47.96729681756422
12297,CR_07860C_A,201,CR,1708816,1709559,743,30.812074471780843,36.47993149994625
12299,CR_07870W_A,274,CR,1712422,1713414,992,31.459555775126823,37.24651648321927
12301,CR_07880C_A,1,CR,1713590,1713660,70,1.6271052830513977,1.9264100287462733
12303,CR_07890W_A,2957,CR,1723489,1725146,1657,203.25559597996912,240.64430407374235
12305,CR_07900C_A,8,CR,1725543,1725878,335,2.719937189578456,3.220267510740039
12307,CR_07910C_A,1603,CR,1726113,1729280,3167,57.64997910047279,68.25464771885675
12309,CR_07920W_A,1565,CR,1731199,1733115,1916,93.03203745212977,110.14520806323289
12311,CR_07930C_A,30,CR,1733827,1734141,314,10.881914313401067,12.883633950213929
12313,CR_07940W_A,346,CR,1734390,1736519,2129,18.510328771960946,21.915289288978272
12315,CR_07950W_A,708,CR,1736935,1737786,851,94.75832882259373,112.18904938268543
12317,CR_07960C_A,1023,CR,1737861,1741031,3170,36.75615435940397,43.51742023928095
12319,CR_07970C_A,5,CR,1742830,1743189,359,1.5863143428077693,1.8781156269114083
12321,CR_07990C_A,1,CR,1748632,1749009,377,0.302115039293363,0.3576888647539499
12323,CR_08000C_A,1984,CR,1749562,1751244,1682,134.34743264576582,159.06053792644613
12325,CR_08010W_A,108,CR,1751963,1752281,318,38.682125597070964,45.79767238151517
12327,CR_08020C_A,404,CR,1752667,1752846,179,257.0644547748242,304.3512604075118
12329,CR_08030C_A,1597,CR,1753067,1755388,2321,78.3688494581283,92.78473809286767
12331,CR_08040W_A,766,CR,1755653,1756840,1187,73.50074581062843,87.02115058245592
12333,CR_08050C_A,1679,CR,1756914,1757813,899,212.718224601814,251.84757583820854
12335,CR_08060C_A,4152,CR,1758278,1758928,650,727.5413530247049,861.372016545872
12337,CR_08070W_A,1511,CR,1760025,1761143,1118,153.9346384511148,182.25079493782943
12339,CR_08080W_A,124,CR,1761311,1762069,758,18.632287410140016,22.05968212337421
12341,CR_08090W_A,14644,CR,1762392,1764233,1841,905.9821203423828,1072.6368236106625
12343,CR_08100C_A,1284,CR,1764414,1765817,1403,104.23679461201685,123.41107154933358
12345,CR_08110W_A,185,CR,1765907,1767181,1274,16.53925699804992,19.581640402091235
12347,CR_08120C_A,3117,CR,1767218,1769941,2723,130.377562140648,154.3604128432425
12349,CR_08130W_A,332,CR,1770028,1771158,1130,33.46365201603052,39.619264662003
12351,CR_08140W_A,2,CR,1771650,1771740,90,2.531052662524396,2.9966378224942023
12353,CR_08150W_A,2270,CR,1772154,1772513,359,720.1867116347273,852.6644946177794
12355,CR_08160W_A,2560,CR,1773596,1775338,1742,167.38075012790497,198.17030835323317
12357,CR_08170C_A,300,CR,1775806,1776909,1103,30.978432406236944,36.6768908464839
12359,CR_08180C_A,329,CR,1777046,1777843,797,47.01660560686787,55.665273478076124
12361,CR_08190W_A,87,CR,1778013,1778471,458,21.635526580312252,25.615364792717912
12363,CR_08200C_A,1557,CR,1778586,1783058,4472,39.655233631433774,46.949782878590405
12365,CR_08210C_A,22556,CR,1783404,1785737,2333,1101.1869153516986,1303.749388164623
12367,CR_08220C_A,1,CR,1786876,1786961,85,1.3399690566305626,1.5864553177910485
12369,CR_08230C_A,1,CR,1787634,1787708,74,1.5391536461297004,1.8222797569221505
12371,CR_08240W_A,1,CR,1788639,1788713,74,1.5391536461297004,1.8222797569221505
12373,CR_08250C_A,5765,CR,1788887,1791586,2699,243.2820811320458,288.0336299001699
12375,CR_08260C_A,8,CR,1791590,1791892,302,3.0171488692343797,3.572151046681831
12377,CR_08270W_A,19,CR,1792283,1793203,920,2.3522282896286515,2.7849188459049383
12379,CR_08280W_A,200,CR,1793368,1794405,1037,21.966705846402668,26.007464226082764
12381,CR_08290W_A,1150,CR,1794674,1795927,1253,104.53469695581606,123.76377279654828
12383,CR_08300C_A,1483,CR,1796429,1800589,4160,40.60331717153019,48.07226564522852
12385,CR_08310C_A,48,CR,1800912,1802069,1157,4.725214996588329,5.594414603792115
12387,CR_08320W_A,426,CR,1802701,1803603,902,53.79188419134444,63.68685926520384
12389,CR_08330W_A,385,CR,1804012,1804677,665,65.94058252366192,78.07030116498053
12391,CR_08340W_A,2100,CR,1805596,1806795,1199,199.4866360371605,236.18204689382998
12393,CR_08350W_A,1281,CR,1807225,1808469,1244,117.28499254921128,138.85947530359994
12395,CR_08360C_A,1061,CR,1808666,1809337,671,180.09703334162043,213.22574192993397
12397,CR_08370W_A,1199,CR,1810203,1811660,1457,93.72885820624833,110.9702084507033
12399,CR_08380C_A,40,CR,1811724,1812676,952,4.785603773680581,5.665911849253745
12401,CR_08390W_A,1,CR,1813131,1813216,85,1.3399690566305626,1.5864553177910485
12403,CR_08400C_A,460,CR,1813616,1813984,368,142.3717122669973,168.5608775152989
12405,CR_08410W_A,954,CR,1814233,1815585,1352,80.36841035663635,95.15211665656517
12407,CR_08420W_A,1847,CR,1816595,1818214,1619,129.93727118327067,153.83913070821845
12409,CR_08430W_A,2552,CR,1818617,1821289,2672,108.78221847466382,128.79262258055172
12411,CR_08440W_A,326,CR,1821550,1823403,1853,20.038069378970803,23.724056587150542
12413,CR_08450C_A,455,CR,1823510,1825432,1922,26.963217099472956,31.92307982079542
12415,CR_08460W_A,4927,CR,1826834,1827706,872,643.546262696785,761.92609497053
12417,CR_08470W_A,971,CR,1828604,1830001,1397,79.16560206800537,93.72805272289492
12419,CR_08480C_A,814,CR,1831039,1831209,170,545.367406048639,645.6873143409567
12421,CR_08490W_A,2300,CR,1832314,1834842,2528,103.62498044749805,122.68671464721122
12423,CR_08500W_A,732,CR,1835068,1836330,1262,66.06408455115184,78.21652129394536
12425,CR_08510W_A,16766,CR,1838763,1840133,1370,1393.871023572833,1650.2725094432121
12427,CR_08520C_A,163,CR,1840750,1841170,420,44.20302685622964,52.33413911427375
12429,CR_08530C_A,16,CR,1841759,1841873,114,15.985595763311977,18.92613361575286
12431,CR_08540C_A,899,CR,1842179,1844686,2507,40.84313341141782,48.35619589509492
12433,CR_08550W_A,825,CR,1845221,1846249,1028,91.40596312861695,108.22001863822693
12435,CR_08560C_A,528,CR,1846338,1846997,659,91.25616276415731,108.04266261375153
12437,CR_08570W_A,1565,CR,1847067,1850804,3737,47.698523885009536,56.47263009075574
12439,CR_08580C_A,104,CR,1850799,1851599,800,14.806658075767722,17.530331261591087
12441,CR_08590W_A,443,CR,1851759,1854059,2300,21.937623838010367,25.973032604966054
12443,CR_08600C_A,1770,CR,1854148,1855146,998,202.0023492686054,239.16052360888102
12445,CR_08610W_A,617,CR,1855954,1856352,398,176.56954064067807,209.04936970239078
12447,CR_08620C_A,301,CR,1856428,1857492,1064,32.22096646042571,38.14798806925186
12449,CR_08630W_A,334,CR,1857629,1859377,1748,21.76299857994375,25.76628516709832
12451,CR_08640C_A,855,CR,1859509,1861272,1763,55.236671123440814,65.39741362476713
12453,CR_08650C_A,1338,CR,1861693,1863837,2144,71.07960858703075,84.15464705801116
12455,CR_08660W_A,1903,CR,1864316,1871566,7250,29.896095828314028,35.39545930059187
12457,CR_08670C_A,411,CR,1871583,1872386,803,58.2961631299984,69.01969679580358
12459,CR_08680C_A,890,CR,1872526,1874673,2147,47.21409368146347,55.89908932971254
12461,CR_08690C_A,2441,CR,1874776,1875693,917,303.188091292249,358.9593038297445
12463,CR_08700C_A,919,CR,1875929,1876468,539,194.19607209405643,229.91828784647078
12465,CR_08710W_A,3225,CR,1876702,1878855,2153,170.60799705009433,201.99120482557882
12467,CR_08720W_A,151,CR,1879051,1880910,1859,9.251480818640813,10.953283487815012
12469,CR_08730W_A,3,CR,1880901,1880994,93,3.674108703664447,4.349958129427068
12471,CR_08740W_A,4,CR,1881722,1882402,680,0.6699845283152813,0.7932276588955243
12473,CR_08750C_A,1,CR,1882565,1882635,70,1.6271052830513977,1.9264100287462733
12475,CR_08760C_A,72,CR,1888934,1889054,120,68.3384218881587,80.90922120734348
12477,CR_08770W_A,108476,CR,1891236,1893022,1786,6917.766566573258,8190.28432221705
12479,CR_08780W_A,462,CR,1893023,1893161,138,381.3085858976972,451.4500023888005
12481,CR_08790W_A,685,CR,1893162,1893318,156,500.126271296888,592.1241081947678
12483,CR_08800W_A,450,CR,1893319,1893469,150,341.6921094407935,404.54610603671733
12485,CR_08810W_A,96627,CR,1893470,1896830,3360,3275.4646288626545,3877.9837884930444
12487,CR_08820C_A,1,CR,1893653,1893922,269,0.42341029670482466,0.5012962900083239
12489,CR_08830W_A,5376,CR,1898484,1898747,263,2328.183498547156,2756.4510342882036
12491,CR_08840C_A,635,CR,1899386,1900285,899,80.45031126989392,95.24908317883408
12493,CR_08850W_A,159,CR,1900674,1900997,323,56.0671263169104,66.38063040230966
12495,CR_08860W_A,4733,CR,1902380,1903915,1535,351.18974027867006,415.7908186475099
12497,CR_08870W_A,2431,CR,1904766,1905881,1115,248.32691122588014,294.0064525486576
12499,CR_08880C_A,453,CR,1906305,1906673,368,140.2051862107604,165.99582068354437
12501,CR_08890C_A,5777,CR,1907038,1907814,776,847.918950274684,1003.8929787689502
12503,CR_08900C_A,980,CR,1908216,1909313,1097,101.74970138315942,120.46647946398754
12505,CR_08910C_A,2445,CR,1910065,1911267,1202,231.6797580650971,274.2970685689889
12507,CR_08920W_A,3447,CR,1911649,1912971,1322,296.97748392395744,351.60626008788824
12509,CR_08930C_A,566,CR,1913084,1913587,503,128.1628455556588,151.738300872619
12511,CR_08940W_A,661,CR,1914210,1915217,1007,74.7628216949237,88.51538433971209
12513,CR_08950W_A,2616,CR,1915454,1916695,1241,240.093085763394,284.25802132475224
12515,CR_08960C_A,388,CR,1916751,1918823,2072,21.328271953511567,25.251590917349795
12517,CR_08970W_A,1,CR,1919560,1919633,73,1.5602379426520252,1.847242493318344
12519,CR_08980C_A,1100,CR,1919749,1921311,1562,80.20941536168861,94.96387465650643
12521,CR_08990C_A,30837,CR,1922057,1923109,1052,3338.6437195265366,3952.7846235279635
12523,CR_09010C_A,3884,CR,1924790,1925941,1151,384.34177615639794,455.0411456260094
12525,CR_09020C_A,5205,CR,1926708,1929737,3029,195.719976850372,231.72251369221019
12527,CR_09030C_A,198,CR,1930897,1931196,299,75.42367633141261,89.2978026703122
12529,CR_09040W_A,1411,CR,1931725,1932549,824,195.0354233094497,230.91203706222015
12531,CR_09050C_A,97,CR,1932933,1934693,1760,6.277298222681245,7.432002326810906
12533,CR_09060W_A,16,CR,1935842,1936579,737,2.4726701723440505,2.9275159188545805
12535,CR_09070C_A,226,CR,1936663,1938141,1478,17.41597129761374,20.619625612155644
12537,CR_09090C_A,269,CR,1940339,1941622,1283,23.880274730988166,28.273032612075077
12539,CR_09100C_A,1778,CR,1942195,1943244,1049,193.05007009397232,228.56147967374753
12541,CR_09110C_A,678,CR,1943868,1944725,857,90.1078374954718,106.68310380898264
12543,CR_09120C_A,2934,CR,1945291,1946851,1560,214.21466861095902,253.61928955378818
12545,CR_09140C_A,3109,CR,1947500,1949866,2366,149.66480251499397,177.1955260169279
12547,CR_09150W_A,209,CR,1950586,1951170,584,40.76121625178416,48.259210137941736
12549,CR_09160C_A,6445,CR,1951279,1952634,1355,541.7480062351573,641.4021287593218
12551,CR_09170C_A,3064,CR,1953918,1955363,1445,241.50971703035555,285.9352408065749
12553,CR_09180W_A,1855,CR,1957742,1958539,797,265.09362735787204,313.85739301468453
12555,CR_09190C_A,628,CR,1958669,1959574,905,79.03596490932536,93.57456891015046
12557,CR_09200C_A,401,CR,1959810,1961258,1448,31.542020231528134,37.344150211952964
12559,CR_09210W_A,704,CR,1961676,1963181,1505,53.278238105496925,63.07872838313378
12561,CR_09220C_A,108,CR,1963272,1964552,1280,9.610090578022318,11.377859232282676
12563,CR_09230C_A,737,CR,1964921,1966741,1820,46.12217667726462,54.60631504561551
12565,CR_09240C_A,1081,CR,1967127,1967570,443,277.93015071895996,329.0551848199334
12567,CR_09270C_A,6090,CR,1968719,1970188,1469,472.18174415575965,559.0392071167707
12569,CR_09290W_A,518,CR,1972214,1973233,1019,57.89876110249625,68.54919297579967
12571,CR_09300C_A,1206,CR,1973390,1974295,905,151.77925745325857,179.69893328923797
12573,CR_09310W_A,700,CR,1974738,1976477,1739,45.847129884714484,54.28067361044703
12575,CR_09320C_A,1102,CR,1976705,1977280,575,218.2867852775388,258.44046889997827
12577,CR_09330C_A,3487,CR,1977674,1980379,2705,146.82444678004276,173.8326890634668
12579,CR_09340W_A,1744,CR,1981012,1981515,503,394.90459831990984,467.54699067464225
12581,CR_09350C_A,10,CR,1982021,1982734,713,1.5974385668106288,1.89128614322916
12583,CR_09360W_A,137,CR,1983094,1984680,1586,9.838549599283041,11.648343112028222
12585,CR_09370W_A,1095,CR,1985044,1988631,3587,34.76933926565086,41.165132061165835
12587,CR_09380W_A,2091,CR,1989010,1989912,902,264.0348118406132,312.60380921019066
12589,CR_09390C_A,16,CR,1990348,1992162,1814,1.0046074514981065,1.189404207384689
12591,CR_09410W_A,447,CR,2000249,2002363,2114,24.083313295495852,28.513419961906756
12593,CR_09420C_A,646,CR,2002832,2005762,2930,25.111843310438296,29.73114726959265
12595,CR_09430C_A,6,CR,2006281,2006613,332,2.0583862014505634,2.437024735160948
12597,CR_09440C_A,771,CR,2006760,2007807,1047,83.87284825815084,99.30119317233654
12599,CR_09450C_A,1,CR,2008897,2008968,71,1.6041883072337724,1.8992774931301286
12601,CR_09460C_A,2608,CR,2015134,2015427,293,1013.8032098084068,1200.2915182522854
12603,CR_09470W_A,1536,CR,2017154,2021266,4112,42.54532101986535,50.371499584338345
12605,CR_09480W_A,890,CR,2021791,2023167,1376,73.6690836730393,87.22045406314885
12607,CR_09490W_A,359,CR,2023612,2026119,2507,16.309994321133477,19.31020503485993
12609,CR_09500C_A,383,CR,2026459,2027463,1004,43.448897050406345,51.44128771980835
12611,CR_09510C_A,684,CR,2027819,2028619,800,97.38225119062616,115.29564022046445
12613,CR_09520C_A,609,CR,2028990,2031764,2774,25.004865975660092,29.604491537654514
12615,CR_09530C_A,1703,CR,2032341,2034509,2168,89.46827527331972,105.9258946157026
12617,CR_09550C_A,1271,CR,2035681,2036295,614,235.77126552619356,279.14120563119855
12619,CR_09560C_A,105,CR,2037364,2038728,1364,8.767759406471976,10.38058189976914
12621,CR_09570W_A,201,CR,2039079,2039942,863,26.527660871996716,31.407403365538894
12623,CR_09580C_A,1081,CR,2040062,2041437,1375,89.54404128618128,106.01559772744035
12625,CR_09590W_A,715,CR,2042657,2043526,869,93.7130257959982,110.95146368095625
12627,CR_09600C_A,2585,CR,2043667,2044170,503,585.3373776702792,693.0097310171733
12629,CR_09610C_A,3844,CR,2044932,2046140,1208,362.4350079167799,429.1046444826549
12631,CR_09620C_A,373,CR,2047539,2048129,590,72.00630328893558,85.25180652638169
12633,CR_09630W_A,4,CR,2049080,2049173,93,4.898811604885928,5.7999441725694245
12635,CR_09640C_A,478,CR,2049605,2049799,194,280.63372562319466,332.25608021572316
12637,CR_09650W_A,1788,CR,2050217,2052358,2141,95.11840132027694,112.61535693502269
12639,CR_09660W_A,187,CR,2052941,2054116,1175,18.126645238419403,21.461027469181886
12641,CR_09670C_A,1142,CR,2054141,2055052,911,142.77804207149148,169.041951369898
12643,CR_09680C_A,988,CR,2055720,2057090,1370,82.13912509185012,97.24855298400894
12645,CR_09690C_A,5190,CR,2059146,2061044,1898,311.4474970140004,368.73802078162333
12647,CR_09700W_A,463,CR,2063617,2065386,1769,29.81033477879921,35.29392257301679
12649,CR_09710W_A,571,CR,2066448,2067626,1178,55.20831762611576,65.36384452375937
12651,CR_09720W_A,61,CR,2067865,2068431,566,12.275158230794114,14.533163997785488
12653,CR_09730C_A,773,CR,2068472,2069818,1346,65.41059945461451,77.44282812441371
12655,CR_09740W_A,634,CR,2069945,2071549,1604,45.01928457719516,53.30054680533641
12657,CR_09750C_A,1465,CR,2071617,2072705,1088,153.3636459346699,181.57476879405363
12659,CR_09760W_A,350,CR,2073298,2073834,536,74.3732825275359,88.05418974679793
12661,CR_09770C_A,671,CR,2073883,2076060,2177,35.105712055546235,41.56338036298229
12663,CR_09780C_A,75,CR,2077962,2079998,2036,4.195630027514655,4.96741289337816
12665,CR_09790W_A,1654,CR,2090643,2092316,1673,112.60385515343144,133.31724634085086
12667,CR_09800C_A,1383,CR,2092517,2095135,2618,60.1680910818204,71.23596443198116
12669,CR_09810W_A,154,CR,2095754,2096467,713,24.600553928883688,29.125806605729068
12671,CR_09820C_A,35,CR,2096565,2097002,437,9.122214973629116,10.800239291598098
12673,CR_09830W_A,843,CR,2096976,2098658,1682,57.08411578648215,67.5846942903196
12675,CR_09840C_A,139,CR,2098780,2099424,644,24.583438515667858,29.10554282562304
12677,CR_09850C_A,48,CR,2100198,2100560,362,15.102413676941152,17.880490874551047
12679,CR_09860W_A,1328,CR,2100701,2103163,2462,61.43611174348414,72.73723650375854
12681,CR_09880W_A,8928,CR,2106063,2108726,2663,381.8534426195274,452.09508507896015
12683,CR_09890C_A,978,CR,2112885,2113910,1025,108.67475870994994,128.66539567606816
12685,CR_09900C_A,202,CR,2114184,2116310,2126,10.821857338827263,12.812529542084809
12687,CR_09910W_A,278,CR,2118630,2120327,1697,18.658496645951796,22.090712527638466
12689,CR_09920W_A,3441,CR,2122776,2124491,1715,228.52527669305547,270.56232281289493
12691,CR_09930W_A,554,CR,2125325,2126614,1289,48.95201154129806,57.95669582217259
12693,CR_09940W_A,97,CR,2126919,2127764,845,13.074609315880464,15.479673485428632
12695,CR_09950C_A,3047,CR,2127986,2129536,1550,223.90018440131135,265.0864484072855
12697,CR_09960C_A,3679,CR,2129808,2132219,2411,173.7985995621014,205.76871617711643
12699,CR_09970W_A,2802,CR,2133546,2134433,887,359.7975537967319,425.9820327376483
12701,CR_09980W_A,1280,CR,2135208,2139131,3923,37.16253718108724,43.998556863539655
12703,CR_09990W_A,857,CR,2139765,2144084,4319,22.60014955551131,26.757429410624894
12705,CR_10000C_A,84,CR,2144187,2144645,458,20.889473939611833,24.732076351589708
12707,CR_10010C_A,1246,CR,2144900,2146207,1307,108.58157826147126,128.55507475688594
12709,CR_10020C_A,646,CR,2146647,2147423,776,94.8166248705982,112.25806894317844
12711,CR_10030W_A,887,CR,2147924,2149489,1565,64.55397253971968,76.42862535773553
12713,CR_10040W_A,107,CR,2149779,2150093,314,38.812161051130474,45.95162775576301
12715,CR_10060W_A,711,CR,2150598,2152013,1415,57.23040984980075,67.75789903229824
12717,CR_10070C_A,7198,CR,2152028,2154073,2045,400.8964635297199,474.64105480884945
12719,CR_10100C_A,15683,CR,2155482,2157044,1562,1143.5675101066931,1353.9258602163547
12721,CR_10110W_A,331,CR,2161683,2163386,1703,22.13742184867932,26.20958330361195
12723,CR_10120C_A,65,CR,2163621,2164442,821,9.017453152111887,10.676206614854497
12725,CR_10130W_A,305,CR,2164549,2165283,734,47.327926148702105,56.033861190371844
12727,CR_10140W_A,4460,CR,2165844,2168006,2162,234.95942153961443,278.18002357751453
12729,CR_10160W_A,7340,CR,2172466,2174556,2090,400.00320307742015,473.58347979417954
12731,CR_10170C_A,213,CR,2174773,2176227,1454,16.685103005705873,19.75431466891811
12733,CR_10180W_A,87,CR,2176706,2177347,641,15.458769381876774,18.302397933018412
12735,CR_10190C_A,210,CR,2177405,2178733,1328,18.01087926269243,21.323966432658295
12737,CR_10200W_A,88,CR,2179388,2180371,983,10.196305741196957,12.071908216761996
12739,CR_10210W_A,7,CR,2180905,2181852,947,0.8419024167847782,0.9967697086437949
12741,CR_10230W_A,3007,CR,2182766,2184085,1319,259.6583707577625,307.4223252091001
12743,CR_10240W_A,898,CR,2184322,2186232,1910,53.54965345162873,63.400070370152214
12745,CR_10250C_A,3151,CR,2186349,2187698,1349,266.0419661101904,314.9801779396334
12747,CR_10260W_A,189,CR,2188415,2189230,815,26.413009686834346,31.271662184433367
12749,CR_10270C_A,723,CR,2189291,2190331,1040,79.18057536079925,93.74578034120086
12751,CR_10280W_A,263,CR,2190995,2191321,326,91.88652840790255,108.78898352521132
12753,CR_10290C_A,1014,CR,2191398,2195222,3824,30.201865321911146,35.75747485366383
12755,CR_10300W_A,2121,CR,2195626,2196444,818,295.3255762526174,349.65048529090365
12757,CR_10310W_A,18,CR,2197472,2197963,491,4.1754636591543,4.943536937312228
12759,CR_10320W_A,5,CR,2199524,2199919,395,1.4417388583999726,1.7069455950916343
12761,CR_10330W_A,41,CR,2201576,2201950,374,12.486075300421152,14.782879097598405
12763,CR_10340W_A,6755,CR,2206795,2209563,2768,277.954022070395,329.0834472878162
12765,CR_10350C_A,2228,CR,2210175,2210486,311,815.9592924266752,966.0543668272306
12767,CR_10360C_A,3650,CR,2211476,2213536,2060,201.8084465143845,238.93095259450135
12769,CR_10370W_A,2391,CR,2214108,2214965,857,317.76967470748247,376.2231581228282
12771,CR_10380C_A,289,CR,2215084,2216109,1025,32.113502318175385,38.02075598198742
12773,CR_10390W_A,428,CR,2216407,2217153,746,65.34594407536176,77.3662794386573
12775,CR_10400W_A,464,CR,2217315,2217947,632,83.62085378719843,99.0028445153148
12777,CR_10410C_A,669,CR,2217987,2218817,830,91.80402458469513,108.69130318817828
12779,CR_10420W_A,1701,CR,2219749,2221599,1850,104.72401408266482,123.9879146609831
12781,CR_10430C_A,90,CR,2221721,2222299,578,17.73488457305157,20.99720273546976
12783,CR_10440W_A,288,CR,2222852,2225545,2693,12.180632196923941,14.421249973830252
12785,CR_10450C_A,405,CR,2225562,2226548,986,46.78340240822224,55.38917273322195
12787,CR_10460W_A,29,CR,2226852,2226936,84,39.32171100707545,46.554909028034935
12789,CR_10470C_A,1047,CR,2227306,2228901,1595,74.7652327240357,88.51823887574568
12791,CR_10480W_A,1465,CR,2229306,2229704,398,419.24534366060516,496.36519710535254
12793,CR_10490W_A,1539,CR,2230203,2230832,629,278.67734839924816,329.939828929787
12795,CR_10500C_A,200,CR,2230879,2231769,890,25.594914564853447,30.30307910387396
12797,CR_10510W_A,514,CR,2231968,2235234,3266,17.925060650394762,21.222361553671437
12799,CR_10520C_A,103,CR,2235243,2235953,710,16.523139564507858,19.562558179240323
12801,CR_10530W_A,197,CR,2236119,2237606,1487,15.089295126616527,17.86495917714264
12803,CR_10540C_A,176,CR,2237629,2239323,1694,11.833492967646528,14.01025475451835
12805,CR_10550W_A,1104,CR,2240734,2242575,1841,68.30130161554156,80.86527268957741
12807,CR_10570C_A,325,CR,2244004,2245206,1202,30.79587786141373,36.46075553575517
12809,CR_10580W_A,654,CR,2245713,2246984,1271,58.60651444381824,69.38713699134884
12811,CR_10590W_A,503,CR,2247055,2249460,2405,23.82136258471506,28.203283622518207
12813,CR_10600C_A,1128,CR,2249443,2250489,1046,122.82622672059117,145.4200151718984
12815,CR_10610C_A,138,CR,2250555,2250956,401,39.1966010829838,46.40678523114464
12817,CR_10620C_A,1380,CR,2251020,2253017,1997,78.70724604044318,93.1853824621382
12819,CR_10630W_A,134,CR,2253074,2254015,941,16.21917912329661,19.202684452327357
12821,CR_10640W_A,861,CR,2254171,2255601,1430,68.5773674192362,81.19212058219432
12823,CR_10650W_A,423,CR,2255688,2256839,1151,41.85802557007115,49.55777667348144
12825,CR_10660W_A,1105,CR,2257148,2258155,1007,124.98172159287549,147.97201164203
12827,CR_10670W_A,1340,CR,2258666,2259775,1109,137.62170924276023,162.9371151455369
12829,CR_10680W_A,3708,CR,2260358,2265544,5186,81.43683904142321,96.41708196324386
12831,CR_10690W_A,151,CR,2265597,2266343,746,23.054293353690714,27.295112605694513
12833,CR_10700W_A,276,CR,2266418,2267389,971,32.37453560098147,38.329806133242016
12835,CR_10710C_A,413,CR,2267386,2268957,1571,29.942465775312485,35.45035896311569
12837,CR_10720W_A,331,CR,2269081,2270994,1913,19.70728144709926,23.33242047362841
12839,CR_10730C_A,550,CR,2270978,2271985,1007,62.20809672043576,73.65122751413259
12841,CR_10740W_A,244,CR,2272097,2272774,677,41.05015987373394,48.60130471342148
12843,CR_10750C_A,259,CR,2272778,2273182,404,73.01836332109366,86.45003421081667
12845,CR_10760C_A,131,CR,2273274,2273660,386,38.65428871912258,45.76471493161483
12847,CR_10770W_A,478,CR,2274183,2275754,1571,34.65496038886045,41.029713279344556
12849,CR_10780C_A,306,CR,2275766,2276572,806,43.24143320466618,51.195661061718575
12851,CR_10790W_A,340,CR,2276745,2278457,1712,22.619804752700503,26.78070016598207
12853,CR_10800C_A,1672,CR,2278465,2281236,2771,68.72479333393562,81.36666537873107
12855,CR_10810C_A,966,CR,2281329,2282324,995,110.57774797983468,130.9184383355005
12857,CR_10820W_A,194,CR,2282415,2282765,350,63.13168498239424,74.7447091153554
12859,CR_10830C_A,438,CR,2282796,2283272,476,104.80472264360473,124.08346949865701
12861,CR_10840C_A,4195,CR,2283372,2284454,1082,441.58915560817275,522.8191358053078
12863,CR_10850C_A,5782,CR,2284743,2285228,485,1357.8445201282943,1607.6189588345703
12865,CR_10860C_A,1242,CR,2285377,2286198,821,172.30272022958408,203.997671009989
