,A22,read_count,chromosome,start,end,length,rpkm,tpm
0,C1_00010W_A,12,C1,4059,4397,338,4.213972508421208,5.282918327617112
2,C1_00020C_A,6,C1,4409,4720,311,2.289907890428245,2.870781985103832
4,C1_00030C_A,25,C1,8597,8908,311,9.541282876784354,11.9615916045993
6,C1_00040W_A,570,C1,10718,11485,767,88.20772962542698,110.58312092554462
8,C1_00050C_A,20,C1,11648,11995,347,6.841127319146822,8.576495651943244
10,C1_00060W_A,8032,C1,12163,13701,1538,619.8612911477043,777.0996533652024
12,C1_00070W_A,3306,C1,13778,14917,1139,344.51352591016195,431.90524297574865
14,C1_00080C_A,782,C1,14910,15761,851,109.06975690715434,136.73715635354918
16,C1_00090W_A,95,C1,15595,16116,521,21.64277946983445,27.13283869158436
18,C1_00100C_A,477,C1,16600,17328,728,77.77036763309498,97.49814449271935
20,C1_00110W_A,4285,C1,17338,18960,1622,313.56467340329266,393.1056874967987
22,C1_00120C_A,739,C1,18948,19628,680,128.99197072285125,161.7129786407913
24,C1_00130C_A,1066,C1,19615,21714,2099,60.27981604590394,75.57081692818271
26,C1_00140W_A,1891,C1,22270,25326,3056,73.4455235748659,92.07623016042476
28,C1_00150C_A,1316,C1,25381,27249,1868,83.61923106378572,104.83067163948571
30,C1_00160C_A,4732,C1,28286,29488,1202,467.26948513096335,585.800339703553
32,C1_00170W_A,256,C1,29804,31543,1739,17.473002358092305,21.905326674911507
34,C1_00180W_A,13802,C1,31842,32444,602,2721.2765799689337,3411.574681634374
36,C1_00190C_A,550,C1,32680,33318,638,102.32203360965289,128.27775824242696
38,C1_00200C_A,140,C1,34099,34446,347,47.88789123402775,60.03546956360271
40,C1_00210C_A,2385,C1,34525,35679,1154,245.30687884269125,307.5331420740888
42,C1_00220W_A,19074,C1,37851,39485,1634,1385.5330135384347,1736.9970345352635
44,C1_00230C_A,909,C1,40484,41770,1286,83.89770227011073,105.17978180493367
46,C1_00240C_A,2,C1,42100,42172,72,3.297043305199926,4.13339443225598
48,C1_00270W_A,25,C1,42605,43504,899,3.300710761601706,4.137992201368612
50,C1_00280C_A,1,C1,43549,43679,130,0.913027376824595,1.1446323043170408
52,C1_00290W_A,143,C1,43803,45764,1961,8.655369166328008,10.850950809410396
54,C1_00310W_A,243,C1,46803,48359,1556,18.53633344080267,23.238389777233493
56,C1_00320W_A,337,C1,48513,49298,785,50.955069272210835,63.88068949315866
58,C1_00330C_A,375,C1,49295,49843,548,81.22278215364783,101.82632269243747
60,C1_00340W_A,599,C1,49997,50743,746,95.30488181411691,119.480586510949
62,C1_00350C_A,1185,C1,50806,51681,875,160.74499131409013,201.52069312004582
64,C1_00360W_A,509,C1,53099,54442,1343,44.98512399440317,56.39636602878525
66,C1_00370W_A,44,C1,54558,54842,284,18.389142941678465,23.053861903850255
68,C1_00380C_A,666,C1,54837,57074,2237,35.33746548300109,44.30141480007572
70,C1_00390W_A,8172,C1,59349,62552,3203,302.8297733510387,379.6476974131288
72,C1_00400W_A,3060,C1,63202,64350,1148,316.37830182998596,396.6330406422638
74,C1_00410C_A,1095,C1,64696,66324,1628,79.83381270944786,100.08501751813927
76,C1_00420W_A,919,C1,67843,68814,971,112.33715829993241,140.83338969799883
78,C1_00430W_A,814,C1,69226,70902,1676,57.647110391156716,72.2702806938122
80,C1_00440W_A,2408,C1,71068,72581,1513,188.90554530150115,236.82465072267442
82,C1_00450C_A,751,C1,72741,73283,542,164.46284649333066,206.1816455174773
84,C1_00460W_A,1261,C1,73580,73900,320,467.7268058839246,586.373667645914
86,C1_00470C_A,477,C1,74056,75381,1325,42.72968123539105,53.568791842037506
88,C1_00480C_A,1862,C1,75573,77828,2255,98.00771921692305,122.86904460442699
90,C1_00490C_A,1223,C1,78008,78367,359,404.35159510123225,506.92225644391726
92,C1_00500C_A,3101,C1,78641,79669,1028,358.0435081899796,448.86733544681766
94,C1_00510W_A,611,C1,80124,81053,929,78.06433212182733,97.86667807524493
96,C1_00520W_A,392,C1,81233,81901,668,69.65250766913378,87.32105123951557
98,C1_00530C_A,957,C1,82117,84558,2441,46.534099119519816,58.33826504714585
100,C1_00540C_A,1260,C1,85080,87248,2168,68.98241896857411,86.4809831398207
102,C1_00550W_A,527,C1,87900,89810,1910,32.74947936453037,41.05694197317302
104,C1_00560W_A,699,C1,90099,91271,1172,70.79078304782504,88.74806953352346
106,C1_00570C_A,921,C1,91310,93694,2384,45.854348920809045,57.48608464592252
108,C1_00580W_A,179,C1,93970,94899,929,22.86991071981521,28.671252660341803
110,C1_00590W_A,15606,C1,95214,96494,1280,1447.13412621422,1814.2243174627545
112,C1_00600W_A,1151,C1,96816,101423,4607,29.654066940365567,37.17632552527866
114,C1_00610W_A,3243,C1,101751,103523,1772,217.22528882363488,272.3281789938043
116,C1_00620W_A,724,C1,103868,104809,941,91.32214315274271,114.48755842967043
118,C1_00630W_A,521,C1,105179,106924,1745,35.43801961738099,44.42747620137145
120,C1_00640C_A,5353,C1,107125,111027,3902,162.8310151866908,204.13587243751547
122,C1_00650C_A,1118,C1,111571,112251,680,195.14617492306857,244.64832221976275
124,C1_00660C_A,664,C1,112788,113801,1013,77.80110875370094,97.53668362156658
126,C1_00670C_A,480,C1,114127,115878,1751,32.53735483372629,40.79100844624976
128,C1_00680W_A,286,C1,117319,119442,2123,15.989805873922961,20.04589216886838
130,C1_00690W_A,140,C1,119767,122808,3041,5.464353258207047,6.850479427349603
132,C1_00700W_A,124,C1,123066,123431,365,40.32329127236294,50.551980124906024
134,C1_00710C_A,2088,C1,123869,125597,1728,143.4213837761968,179.80265780313513
136,C1_00720W_A,1,C1,126521,126612,91,1.3043248240351357,1.635189006167201
138,C1_00730C_A,1131,C1,126791,128620,1829,73.39661848798262,92.0149194662299
140,C1_00740C_A,840,C1,129260,130681,1421,70.16368018947628,87.96189136623563
142,C1_00750C_A,1768,C1,131413,133938,2525,83.10899496608512,104.19100547494202
144,C1_00760W_A,536,C1,134254,134913,659,96.53982946454899,121.02879964311289
146,C1_00770C_A,137,C1,135654,136436,782,20.794140129470634,26.068927544611885
148,C1_00780C_A,167,C1,138574,140931,2357,8.409768498456495,10.543049353722084
150,C1_00790W_A,190,C1,150607,151707,1100,20.50161473415227,25.702198106028092
152,C1_00800C_A,1749,C1,154633,155286,653,317.90970087076295,398.55290510346947
154,C1_00810W_A,144,C1,155443,156324,881,19.400536315728058,24.321812414091944
156,C1_00820W_A,44,C1,156643,157689,1046,4.992845693534115,6.2593659471256915
158,C1_00830W_A,199,C1,158725,160524,1799,13.129526536104654,16.460054314998246
160,C1_00840C_A,389,C1,160942,162672,1730,26.688898523710854,33.458991693244364
162,C1_00850W_A,138,C1,167077,167823,746,21.956717346157156,27.526412251270386
164,C1_00860W_A,145,C1,168533,169534,1001,17.193372680463153,21.554764172204013
166,C1_00870W_A,1083,C1,170158,172254,2096,61.32878071714444,76.88586933434931
168,C1_00880W_A,124,C1,174459,176084,1625,9.057231578099982,11.354752458825043
170,C1_00890W_A,227,C1,176325,178475,2150,12.531831576787814,15.710743860649242
172,C1_00900W_A,408,C1,178690,179307,617,78.48779913578042,98.39756470174366
174,C1_00910W_A,155,C1,179823,180829,1006,18.287774993057248,22.926780250485457
176,C1_00920W_A,404,C1,181403,185239,3836,12.500572948599514,15.671555949617044
178,C1_00930C_A,3073,C1,185507,190145,4638,78.6428000792707,98.59188427158571
180,C1_00940W_A,134,C1,190698,191156,458,34.72693647223678,43.53601471878351
182,C1_00950C_A,913,C1,191444,193405,1961,55.26120313886343,69.27914747546637
184,C1_00960C_A,1117,C1,194676,197798,3122,42.46659365429195,53.23896762007607
186,C1_00970W_A,93,C1,198221,198746,525,21.02571616344639,26.35924677941528
188,C1_00980W_A,372,C1,198951,199220,269,164.1412785993956,205.7785064564018
190,C1_00990C_A,1659,C1,199316,202249,2933,67.1369295464577,84.16735392842011
192,C1_01000C_A,369,C1,202532,203623,1091,40.14475093150855,50.328149989081986
194,C1_01010W_A,1113,C1,203945,204415,470,281.0764492611716,352.3762725779417
196,C1_01020W_A,1,C1,204985,205057,72,1.648521652599963,2.06669721612799
198,C1_01030W_A,1362,C1,205265,206284,1019,158.64634675226966,198.88969166081964
200,C1_01040W_A,407,C1,206477,206920,443,109.04803274896011,136.70992149303527
202,C1_01050C_A,533,C1,206917,207855,938,67.44527392342877,84.55391510248161
204,C1_01060W_A,4483,C1,208285,208740,455,1169.457637229903,1466.1104629295126
206,C1_01070C_A,400,C1,209078,210502,1424,33.340887355954315,41.79837066326272
208,C1_01080W_A,268,C1,210872,212377,1505,21.136128776457735,26.4976674301699
210,C1_01090C_A,737,C1,212439,212747,308,284.0167304336508,356.06240609290796
212,C1_01100W_A,3257,C1,213635,220399,6764,57.15330006228589,71.65120697381404
214,C1_01110C_A,774,C1,220539,222068,1529,60.08424764950343,75.32563928082448
216,C1_01130W_A,2443,C1,224667,226874,2207,131.38575650463213,164.71398891166695
218,C1_01140C_A,1284,C1,227677,229779,2102,72.50358217866861,90.8953493038061
220,C1_01150C_A,519,C1,232865,234934,2069,29.773783042221087,37.326409653103305
222,C1_01160C_A,405,C1,235077,235889,812,59.200605159870605,74.21784584026132
224,C1_01170C_A,516,C1,236084,238300,2216,27.63803088330047,34.64888762345988
226,C1_01180C_A,84,C1,239091,240914,1823,5.469149179881831,6.856491916150349
228,C1_01190C_A,462,C1,241113,242504,1391,39.42230356008999,49.4224415508853
230,C1_01200W_A,452,C1,242741,244663,1922,27.913365589080755,34.99406566163856
232,C1_01210W_A,484,C1,245206,246453,1247,46.06871094611349,57.7548232458927
234,C1_01220C_A,455,C1,246661,247413,752,71.81591667443458,90.0332457451502
236,C1_01240W_A,334,C1,248816,249865,1049,37.791848142730146,47.37839337792746
238,C1_01250W_A,1516,C1,250103,251977,1874,96.01890897790351,120.37573881259466
240,C1_01260C_A,104,C1,252036,252488,452,27.31002242183302,34.23767423532387
242,C1_01270W_A,423,C1,253158,254441,1283,39.132794584243555,49.059493697890936
244,C1_01280C_A,28,C1,254618,254965,347,9.57757824680555,12.00709391272054
246,C1_01290C_A,586,C1,255170,257443,2273,30.60027521623302,38.36255562818837
248,C1_01300W_A,789,C1,257921,258904,983,95.26878742716045,119.43533616866618
250,C1_01310W_A,24,C1,258992,259345,353,8.069817041622484,10.116863426258263
252,C1_01320W_A,3619,C1,259647,261173,1526,281.48885319440836,352.893289785084
254,C1_01330C_A,493,C1,261359,261838,479,122.16268179684404,153.15132439181448
256,C1_01340C_A,105,C1,262217,263083,866,14.39125137835534,18.04183712924666
258,C1_01350C_A,12722,C1,263479,264672,1193,1265.732990306056,1586.8076972487686
260,C1_01360C_A,1195,C1,265483,267465,1982,71.56347274959678,89.71676512394161
262,C1_01370C_A,3501,C1,269372,270012,640,649.2908593971531,813.9945322872105
264,C1_01380C_A,674,C1,270319,271974,1655,48.338041545239285,60.599808159673174
266,C1_01390C_A,1717,C1,272374,274197,1823,111.79201359353696,140.14995976226368
268,C1_01400C_A,1363,C1,275477,276952,1475,109.68089552511863,137.50332067927891
270,C1_01420C_A,1972,C1,278222,279262,1040,225.06124838726268,282.15186301415054
272,C1_01440C_A,20,C1,280421,280819,398,5.964500451617958,7.477497465387703
274,C1_01450W_A,1869,C1,282437,284137,1700,130.49309514533638,163.5948888117126
276,C1_01460W_A,916,C1,284639,287617,2978,36.508831441327324,45.76991766221396
278,C1_01470W_A,2294,C1,288033,289328,1295,210.2571616344639,263.59246779415275
280,C1_01480C_A,9685,C1,289699,290448,749,1534.7758595340538,1924.0978674904807
282,C1_01490W_A,2820,C1,291847,292449,602,556.00637266428,697.046848442902
284,C1_01500W_A,2,C1,296046,296504,458,0.5183124846602505,0.6497912644594556
286,C1_01510W_A,1259,C1,299614,301767,2153,69.40789166970806,87.01438423017652
288,C1_01520C_A,1884,C1,305308,306012,704,317.64014933505655,398.21497723484316
290,C1_01530C_A,2826,C1,306618,308486,1868,179.5653092600748,225.11510490363725
292,C1_01540W_A,612,C1,309122,310972,1850,39.26511248657555,49.22537628727771
294,C1_01550W_A,717,C1,311200,312759,1559,54.58837831547177,68.43564918883347
296,C1_01560W_A,2290,C1,313161,317798,4637,58.61726333419925,73.48652943609726
298,C1_01570C_A,257,C1,317950,318471,521,58.54941393418372,73.401468881444
300,C1_01580W_A,1008,C1,318929,319459,530,225.74171218697157,283.00493803340567
302,C1_01590C_A,4718,C1,319665,323369,3704,151.18688210086313,189.53800689249832
304,C1_01600W_A,925,C1,323650,324531,881,124.62150063922537,156.23386446552115
306,C1_01610C_A,94,C1,324887,325940,1053,10.595626348334807,13.283387235284176
308,C1_01620C_A,178,C1,326428,327426,998,21.169793085892916,26.539871264425173
310,C1_01630W_A,876,C1,331354,332037,683,152.23361299090027,190.85025888085593
312,C1_01640W_A,742,C1,332721,334077,1356,64.94883537500031,81.42421244426382
314,C1_01650W_A,754,C1,334643,336025,1382,64.75755678462141,81.18441278520719
316,C1_01660C_A,1,C1,336119,336200,81,1.4653525800888563,1.837064192113769
318,C1_01670C_A,245,C1,336700,341496,4796,6.063369881539481,7.601446808277262
320,C1_01680C_A,454,C1,341928,342440,512,105.2478042581789,131.94570039217137
322,C1_01690C_A,3147,C1,342930,343901,971,384.68448005428434,482.26624306812
324,C1_01700W_A,928,C1,345562,348762,3200,34.42113210628723,43.152637872752436
326,C1_01710W_A,718,C1,351098,353101,2003,42.547166926014825,53.33997967296684
328,C1_01720C_A,47,C1,353541,353627,86,64.867410144166,81.32213231833857
330,C1_01730W_A,1,C1,354206,354278,72,1.648521652599963,2.06669721612799
332,C1_01740W_A,538,C1,357079,359466,2387,26.75204639091419,33.5381580913003
334,C1_01750W_A,598,C1,361029,362930,1901,37.3375845735634,46.80889812604248
336,C1_01760W_A,567,C1,364172,366307,2135,31.521895993321266,39.5179611949457
338,C1_01770W_A,149,C1,366730,367860,1130,15.650743618665844,19.62082100408945
340,C1_01780C_A,2286,C1,367933,369807,1874,144.78840760124498,181.51645047862226
342,C1_01790W_A,1147,C1,372225,375440,3215,42.34572695437492,53.08744102541647
344,C1_01800W_A,195,C1,375835,376554,719,32.190881783732245,40.356646612568824
346,C1_01810C_A,1292,C1,376645,378174,1529,100.29566920304708,125.73737202948996
348,C1_01820C_A,356,C1,378463,379650,1187,35.59806823878876,44.628123878511076
350,C1_01830C_A,915,C1,380212,380784,572,189.86819313511467,238.03149055683915
352,C1_01840C_A,265,C1,381538,382092,554,56.77579987654747,71.17794744354161
354,C1_01850C_A,434,C1,382760,383590,830,62.06386096438994,77.80741519224992
356,C1_01860W_A,927,C1,383753,384670,917,119.98792713318642,150.4249062085568
358,C1_01870C_A,2496,C1,384790,386280,1490,198.8316263302313,249.2686510770425
360,C1_01880C_A,530,C1,386597,388924,2327,27.033771492571805,33.89134755799059
362,C1_01890C_A,2003,C1,389271,390800,1529,155.4893385554979,194.93185462466593
364,C1_01900C_A,476,C1,391247,392764,1517,37.24333162683319,46.69073631584606
366,C1_01910W_A,625,C1,393296,394360,1064,69.7213104952992,87.40730707308228
368,C1_01920W_A,2854,C1,395587,399411,3824,88.58562169180472,111.0568717436476
370,C1_01930W_A,2269,C1,400591,401977,1386,194.31146128567877,243.60186926724205
372,C1_01940C_A,222,C1,402263,402769,506,52.07503971375063,65.28475949128418
374,C1_01950C_A,174,C1,403144,403689,545,37.89482433719696,47.507491236057724
376,C1_01970W_A,6,C1,405749,406027,278,2.5617314889323173,3.2115582639111215
378,C1_01980W_A,6270,C1,406673,408310,1637,454.61735788010225,569.9387851245082
380,C1_01990W_A,9,C1,411340,412368,1028,1.0391459444404436,1.302742992267449
382,C1_02000W_A,279,C1,412817,413818,1001,33.08242053689117,41.474339338240824
384,C1_02010C_A,222,C1,414090,416273,2183,12.070531422426852,15.132427074021894
386,C1_02020W_A,98,C1,416452,417075,623,18.670896919334417,23.407087571427127
388,C1_02030C_A,140,C1,417078,417521,443,37.51037981536711,47.02552582070009
390,C1_02040C_A,3632,C1,418019,420493,2474,174.25020462469718,218.45173355146883
392,C1_02050C_A,1109,C1,421264,423846,2582,50.98030864322303,63.91233126002624
394,C1_02060W_A,358,C1,425985,426615,630,67.44808590066135,84.5574403855795
396,C1_02070W_A,8,C1,427843,428838,995,0.9543200722588732,1.1963995944620325
398,C1_02080W_A,165,C1,429371,430510,1139,17.194413725098826,21.556069295522846
400,C1_02090C_A,235,C1,430507,431994,1487,18.75789264424437,23.516151242021245
402,C1_02100W_A,147,C1,432225,433841,1616,10.797000724701741,13.53584364820461
404,C1_02110C_A,1901,C1,434412,436049,1637,137.83534247688587,172.79962209277355
406,C1_02120C_A,3359,C1,442448,444235,1787,223.10669537660658,279.7015043794752
408,C1_02130C_A,4392,C1,449253,450800,1547,336.9761545389598,422.4558891227263
410,C1_02140C_A,9,C1,451280,451624,344,3.1053547409441165,3.8930808024736554
412,C1_02150W_A,4871,C1,452164,454191,2027,285.22759044234743,357.5804213432066
414,C1_02160W_A,140,C1,454396,454902,506,32.840115134797685,41.17056904855759
416,C1_02170C_A,237,C1,454861,455823,962,29.241552473976895,36.65916974637008
418,C1_02180W_A,720,C1,456751,457911,1160,73.67186419895009,92.35998593454742
420,C1_02190W_A,137,C1,458366,459304,938,17.33583963885505,21.733370298386458
422,C1_02200C_A,70,C1,459294,460130,836,9.938455896057194,12.45951431732664
424,C1_02210W_A,941,C1,461070,462782,1712,65.23985923303313,81.78905945508387
426,C1_02220C_A,331,C1,462849,463859,1010,38.89858220273497,48.76586936115075
428,C1_02230W_A,880,C1,465637,467649,2012,51.91368385125928,65.08247296912
430,C1_02240W_A,1369,C1,469116,471743,2627,61.854389894736656,77.54480822204177
432,C1_02250W_A,817,C1,474919,475644,725,133.75536233453826,167.68468557450055
434,C1_02260C_A,424,C1,475896,477035,1139,44.18443284510244,55.392565947282954
436,C1_02270C_A,331,C1,477305,478183,878,44.74666062045823,56.097412363054964
438,C1_02280C_A,174,C1,478626,481568,2942,7.019945364980401,8.800673937339042
440,C1_02290C_A,166,C1,482379,483590,1211,16.270132776114586,20.397328759010517
442,C1_02300W_A,54,C1,483698,484063,365,17.560142973448375,22.014571989878423
444,C1_02310C_A,58,C1,484174,484539,365,18.86089430481492,23.645281026165716
446,C1_02320C_A,1231,C1,484846,486477,1631,89.58416377267929,112.308711011561
448,C1_02330C_A,407,C1,487350,488196,846,57.10198405176043,71.58687378417804
450,C1_02340C_A,22,C1,488645,488749,104,25.108252862676366,31.477388368718618
452,C1_02350W_A,287,C1,489332,490138,806,42.26433179817077,52.98539860306301
454,C1_02360C_A,153,C1,490252,492177,1925,9.433825727294126,11.826876120969319
456,C1_02370C_A,360,C1,492588,496217,3629,11.77450571380299,14.76130940811174
458,C1_02380C_A,31,C1,498351,498953,602,6.112126791699532,7.662571738202117
460,C1_02390W_A,332,C1,499217,501709,2492,15.813106574538333,19.824370086004606
462,C1_02400C_A,83,C1,502050,503384,1334,7.384981556174949,9.258307768801252
464,C1_02410C_A,169,C1,504151,505224,1073,18.694512086520366,23.436693127535303
466,C1_02420C_A,9233,C1,505969,511662,5693,192.4991445861221,241.32982760384695
468,C1_02430C_A,2079,C1,515594,517525,1931,127.79073492200068,160.20702894239597
470,C1_02440C_A,453,C1,518168,519169,1001,53.71446775344696,67.34005634488564
472,C1_02450C_A,164,C1,520056,520586,530,36.7278182526422,46.04445420384774
474,C1_02460W_A,10214,C1,521288,521950,662,1831.3232802042805,2295.869586583464
476,C1_02470W_A,21,C1,522615,523085,470,5.303329231342861,6.648608916564938
478,C1_02480W_A,156,C1,523976,524734,758,24.427698155676502,30.624199381991538
480,C1_02490C_A,478,C1,524841,526862,2021,28.072994159267857,35.194186734419056
482,C1_02500W_A,69,C1,527100,527726,626,13.08283637398821,16.401520398919896
484,C1_02510W_A,141,C1,528029,528760,731,22.894380050882116,28.701929053531266
486,C1_02520W_A,447,C1,530172,531908,1736,30.5622240018878,38.314852075958086
488,C1_02530C_A,8550,C1,532403,534163,1760,576.6079143980326,722.8743217320401
490,C1_02540C_A,2,C1,536532,536604,72,3.297043305199926,4.13339443225598
492,C1_02560W_A,4,C1,536928,537227,299,1.5878736988253825,1.9906648770731141
494,C1_02570C_A,277,C1,537385,539079,1694,19.408568972522826,24.331882690942525
496,C1_02580W_A,373,C1,540001,541512,1511,29.300263072286313,36.73277328678577
498,C1_02590C_A,7539,C1,541722,542600,878,1019.1694091167208,1277.6990688974968
500,C1_02600W_A,852,C1,544056,544805,749,135.0159042150763,169.2649853486721
502,C1_02610W_A,1374,C1,545022,549395,4373,37.293608517815954,46.753766795588795
504,C1_02620C_A,1577,C1,549494,550573,1079,173.47520159667306,217.4801378202377
506,C1_02630C_A,552,C1,550937,552376,1439,45.53081623414381,57.08048238901378
508,C1_02640C_A,1457,C1,552858,553373,515,335.79905911523605,420.98020341881687
510,C1_02650W_A,1618,C1,553758,554360,602,319.0135854506401,399.9368087874524
512,C1_02660C_A,798,C1,554577,555404,827,114.5313906551191,143.58422642061646
514,C1_02670C_A,35,C1,555675,558101,2426,1.7123967702192526,2.1467753440406163
516,C1_02680C_A,209,C1,558921,561449,2528,9.812877305508009,12.302080580812497
518,C1_02690C_A,3,C1,562357,562659,302,1.179075089276795,1.4781675453100855
520,C1_02700C_A,307,C1,564255,564428,173,210.62961045704964,264.0593945970699
522,C1_02710W_A,3640,C1,565683,567173,1490,289.96278839825396,363.516782820687
524,C1_02720W_A,376,C1,567442,568635,1193,37.408866872746195,46.89826239314078
526,C1_02730W_A,128,C1,574220,575107,887,17.128270068051027,21.473147174560943
528,C1_02740C_A,135,C1,575478,576398,920,17.416989633990916,21.83510537039572
530,C1_02750C_A,1126,C1,576658,579045,2387,55.990342446411496,70.1932453732419
532,C1_02760W_A,1511,C1,579750,580802,1052,170.48095782286617,213.7263531720497
534,C1_02770W_A,194,C1,581212,581508,296,77.79240014701449,97.52576592863434
536,C1_02780W_A,1036,C1,581844,582602,758,162.22496980308242,203.37609333168737
538,C1_02790W_A,3236,C1,582899,583951,1052,365.10680312031434,457.7223553042706
540,C1_02800W_A,30,C1,584332,584934,602,5.914961411322127,7.415392004711725
542,C1_02810W_A,2190,C1,585914,588472,2558,101.61801961765528,127.39515912394897
544,C1_02820W_A,5985,C1,588902,593116,4214,168.5764002226806,211.33867213428417
546,C1_02830W_A,511,C1,593697,595466,1769,34.28626831116894,42.98356358156078
548,C1_02840W_A,666,C1,598018,599733,1715,46.0932421489641,57.785577205696434
550,C1_02850W_A,1592,C1,600683,602722,2039,92.67295042060725,116.18102094235152
552,C1_02860C_A,546,C1,603130,603732,602,107.65229768606271,134.9601344857534
554,C1_02870W_A,248,C1,604676,605542,866,33.99076516030594,42.61310102907782
556,C1_02880C_A,2133,C1,605725,606483,758,334.0017959362691,418.7270338576151
558,C1_02890C_A,246,C1,607149,607523,374,78.07116446751485,97.87524356165498
560,C1_02900C_A,468,C1,607807,609984,2177,25.5161164933433,31.988713548299838
562,C1_02910C_A,287,C1,610205,611635,1430,23.821714286241708,29.8644973944537
564,C1_02920W_A,865,C1,611934,613046,1112,92.32907241360226,115.74991242846333
566,C1_02930C_A,782,C1,613106,614473,1367,67.8993146510522,85.12313098527457
568,C1_02940C_A,504,C1,614701,615219,518,115.48562496051635,144.78051849199326
570,C1_02950W_A,63,C1,615467,615844,377,19.8347326689481,24.86615005930123
572,C1_02960C_A,1438,C1,615939,617726,1787,95.51277997962495,119.74122158311559
574,C1_02970W_A,1889,C1,618379,619644,1265,177.24279282752238,222.20344266492938
576,C1_02980W_A,758,C1,620103,621131,1028,87.51918065398404,109.71990979319182
578,C1_02990C_A,2332,C1,622222,623538,1316,210.32931577366585,263.68292505832375
580,C1_03000W_A,301,C1,628046,629806,1760,20.29929616769682,25.448557993139662
582,C1_03010W_A,2175,C1,630193,630513,320,806.745283741107,1011.3899501426351
584,C1_03020C_A,17047,C1,631014,631622,608,3327.909704037423,4172.090618289534
586,C1_03030W_A,8532,C1,632083,632838,755,1341.3158215612818,1681.5633995447533
588,C1_03040W_A,206,C1,633766,634524,758,32.2570885901882,40.439647901860624
590,C1_03050W_A,945,C1,635104,638259,3155,35.551636527068624,44.569913973169086
592,C1_03060C_A,462,C1,638337,638966,629,87.18032472509569,109.2950972929753
594,C1_03070C_A,1258,C1,639143,641560,2417,61.77761572440805,77.44855897724817
596,C1_03080C_A,341,C1,641962,642642,680,59.52132884505045,74.61992654466826
598,C1_03090W_A,14035,C1,643226,643996,770,2163.459870630279,2712.258273820333
600,C1_03100W_A,4621,C1,645104,649550,4446,123.36548269901913,154.6592362061124
602,C1_03110W_A,6236,C1,650064,650956,892,829.790396686281,1040.2808480535184
604,C1_03120W_A,649,C1,651902,653134,1232,62.526071252184316,78.38687298314021
606,C1_03130C_A,2199,C1,653447,655201,1754,148.80680513845326,186.55418291625566
608,C1_03140W_A,183,C1,655798,656274,476,45.63218759381747,57.20756831870251
610,C1_03150C_A,853,C1,656446,657201,755,134.10014015374747,168.11692215326707
612,C1_03160C_A,1849,C1,657572,658543,971,226.01893982217086,283.35248917475496
614,C1_03170C_A,105,C1,658804,660771,1967,6.335955106078152,7.9431779125203885
616,C1_03180W_A,110,C1,660929,661792,863,15.128958851207079,18.966676653225587
618,C1_03190C_A,7231,C1,662177,664336,2159,397.5327119205299,498.3736475345751
620,C1_03200C_A,1229,C1,668763,671960,3197,45.628521737649535,57.20297255575026
622,C1_03210C_A,2529,C1,672483,673838,1355,221.53211120193515,277.7275001404527
624,C1_03220C_A,8819,C1,675074,675868,794,1318.3356381714023,1652.7539016755134
626,C1_03230C_A,1541,C1,677396,679090,1694,107.97330247890856,135.36256760556833
628,C1_03240W_A,393,C1,679785,680210,425,109.7566321928672,137.59826924131204
630,C1_03250C_A,392,C1,680242,681462,1220,38.13760255982079,47.811854285242944
632,C1_03260W_A,415,C1,681644,683680,2036,24.193431718903195,30.330507277949092
634,C1_03270W_A,344,C1,683901,685105,1204,33.912445424913535,42.514914160347224
636,C1_03280W_A,2884,C1,685412,686344,932,367.28779411918157,460.4565917752628
638,C1_03290W_A,870,C1,686628,688511,1883,54.8398281034847,68.75088349349829
640,C1_03300C_A,1637,C1,688617,690020,1403,138.48991878976625,173.6202428237416
642,C1_03310W_A,618,C1,690480,691616,1136,64.57096782930279,80.95049236692874
644,C1_03320C_A,449,C1,691821,693329,1508,35.34045622364165,44.30516419296132
646,C1_03330C_A,743,C1,694143,695732,1589,55.49988315134527,69.57837273378411
648,C1_03340C_A,864,C1,696019,696900,881,116.40321789436835,145.93087448455165
650,C1_03350C_A,3291,C1,697530,699398,1868,209.1116181086009,262.1563376637899
652,C1_03360W_A,2520,C1,701716,705948,4232,70.6776390944559,88.6062246914609
654,C1_03370W_A,9833,C1,706488,708377,1889,617.8474142515149,774.5749223321492
656,C1_03380W_A,2552,C1,709461,712127,2666,113.61814048586933,142.4393148087852
658,C1_03390W_A,1334,C1,712967,714244,1277,123.99154869923358,155.44411449856005
660,C1_03400W_A,690,C1,715541,717490,1949,42.020808466478286,52.68010143521732
662,C1_03410W_A,61,C1,717686,718510,824,8.786780459003687,11.015696812177344
664,C1_03420W_A,1,C1,719205,719309,104,1.1412842210307437,1.4307903803963007
666,C1_03430W_A,280,C1,719613,720668,1055,31.501608072431523,39.4925268977633
668,C1_03440C_A,1027,C1,721115,722551,1436,84.88738515310006,106.42051458869645
670,C1_03450C_A,1143,C1,723114,726743,3629,37.38405564132449,46.86715737075477
672,C1_03460C_A,694,C1,727114,730086,2972,27.71646363967529,34.74721618286791
674,C1_03470C_A,40,C1,731029,732438,1409,3.3695829378906277,4.2243349768975245
676,C1_03480C_A,453,C1,732768,735644,2876,18.69547365132142,23.437898609607274
678,C1_03490W_A,633,C1,736791,737672,881,85.28152422122125,106.91463373694582
680,C1_03500W_A,1825,C1,738229,738852,623,347.69782528352357,435.8972940597398
682,C1_03510C_A,2995,C1,739135,739680,545,652.2701085626717,817.7295186896143
684,C1_03520W_A,2618,C1,740588,742033,1445,215.04480098856934,269.5945733226724
686,C1_03530W_A,460,C1,742220,743984,1764,30.95183511004013,38.80329467015818
688,C1_03540C_A,225,C1,744051,744458,407,65.61683236392975,82.26165823408708
690,C1_03550C_A,2481,C1,744891,746333,1442,204.21547839614192,256.01820881510065
692,C1_03560C_A,1830,C1,746720,747754,1034,210.06693708565876,263.3539895522476
694,C1_03570C_A,1,C1,748226,748341,115,1.0321179042364987,1.2939321700975241
696,C1_03580W_A,1,C1,749095,749193,98,1.2111587651754832,1.5183897914409723
698,C1_03600W_A,707,C1,749583,750410,827,101.47079347514938,127.21058656563388
700,C1_03610C_A,165,C1,750533,751084,551,35.543443253879424,44.559642336843055
702,C1_03620C_A,521,C1,751389,752110,721,85.7688546911648,107.52558387155779
704,C1_03630W_A,413,C1,752775,756314,3539,13.851494733459313,17.36516202847751
706,C1_03640C_A,256,C1,756361,757074,713,42.616481207184464,53.426876700801
708,C1_03650C_A,1209,C1,757289,757795,506,283.5978514140743,355.53727128361515
710,C1_03660W_A,124,C1,758284,758523,239,61.581595457792766,77.20281483510752
712,C1_03670C_A,887,C1,758553,759638,1085,97.03335190934935,121.64751245234834
714,C1_03680W_A,750,C1,761416,764853,3437,25.900543858131513,32.47065745444035
716,C1_03690W_A,829,C1,765465,766517,1052,93.53323231975912,117.25952798122384
718,C1_03700C_A,2,C1,766633,766720,87,2.728587562924077,3.420740219798052
720,C1_03710C_A,1283,C1,767067,770930,3863,39.42113284508781,49.42097386410542
722,C1_03720C_A,368,C1,773999,775771,1772,24.649678164384103,30.902488396460058
724,C1_03730C_A,1062,C1,776730,778577,1847,68.24718984537282,85.55925064104528
726,C1_03740W_A,553,C1,781112,783955,2843,23.08742107629973,28.94393821925855
728,C1_03750W_A,316,C1,784461,785012,551,68.07107920136909,85.33846653601458
730,C1_03760C_A,1085,C1,785087,786874,1787,72.06631869116347,90.34716649351908
732,C1_03770W_A,5281,C1,788296,790142,1846,339.5561673951188,425.6903661336826
734,C1_03780C_A,2722,C1,790364,793585,3221,100.30545407114289,125.74963899584849
736,C1_03790C_A,4387,C1,795543,796823,1280,406.80362756002717,509.99628865238395
738,C1_03800W_A,144,C1,797157,798089,932,18.33891898514637,22.99089778628219
740,C1_03810C_A,369,C1,798181,799359,1178,37.179900905157744,46.611215312468964
742,C1_03820W_A,1853,C1,801727,802836,1109,198.32206023740008,248.6298248755022
744,C1_03830C_A,446,C1,803002,803994,992,53.36424123819558,66.90098891562704
746,C1_03840W_A,15,C1,804198,804467,269,6.618599943524016,8.297520421629105
748,C1_03860C_A,1153,C1,806466,811433,4967,27.552581741944543,34.54176285365034
750,C1_03870C_A,1272,C1,813869,815560,1691,89.28338677215555,111.93163680772672
752,C1_03880C_A,2,C1,820902,821264,362,0.6557655192662837,0.8221115997857198
754,C1_03890W_A,3,C1,823543,824613,1070,0.33278567940335707,0.4172024286763045
756,C1_03900W_A,17,C1,825308,825823,515,3.918039811227874,4.911917267069243
758,C1_03910C_A,406,C1,825919,827970,2051,23.49565331487183,29.455725510411217
760,C1_03920C_A,125,C1,828496,830040,1544,9.609258337694087,12.046810197637248
762,C1_03930W_A,313,C1,830273,831781,1508,24.635997322939502,30.885337176830493
764,C1_03940W_A,415,C1,832111,832620,509,96.77372687561278,121.32202911179637
766,C1_03950C_A,41,C1,833227,833766,539,9.028638067671785,11.318905718014522
768,C1_03960C_A,416,C1,834229,836838,2609,18.92545823636416,23.726222697380432
770,C1_03970W_A,21,C1,837444,837761,317,7.8629802483632325,9.85755896146852
772,C1_03980W_A,41,C1,838231,838758,527,9.234223754222185,11.576641711593599
774,C1_03990W_A,158,C1,839278,840204,926,20.252248725677305,25.389576167032416
776,C1_04000C_A,508,C1,840359,841801,1442,41.81437445596134,52.42130192586502
778,C1_04010C_A,3856,C1,842768,843802,1034,442.63284666792356,554.9141987505282
780,C1_04020C_A,9124,C1,844770,845783,1013,1069.0622232963362,1340.2480442216468
782,C1_04030W_A,903,C1,846649,848745,2096,51.135631567480544,64.10705448653502
784,C1_04040C_A,853,C1,848808,850970,2162,46.82960491030497,58.708730909212136
786,C1_04050C_A,2,C1,851796,852227,431,0.5507821762746977,0.6904974457596997
788,C1_04060W_A,112,C1,853943,855709,1766,7.527564329878881,9.437059088819995
790,C1_04070C_A,56,C1,855857,857047,1190,5.585579246456346,7.002456449939544
792,C1_04080W_A,94,C1,857251,857895,644,17.324836249684086,21.7195757123513
794,C1_04090C_A,227,C1,857906,859393,1487,18.119326086142433,22.715601412505627
796,C1_04100C_A,8935,C1,859621,860469,848,1250.6214027719438,1567.8627984427576
798,C1_04110W_A,75,C1,862034,862951,917,9.707761094917997,12.170299855061229
800,C1_04120C_A,208,C1,863013,864074,1061,23.26885982029882,29.17140198749555
802,C1_04130W_A,1116,C1,864122,866671,2549,51.96626591985573,65.14839337399617
804,C1_04140W_A,718,C1,867380,868414,1034,82.41970537022021,103.32686584618237
806,C1_04150C_A,29,C1,868503,869087,584,5.894029470254663,7.389150320676787
808,C1_04160C_A,45,C1,869423,870325,902,5.921519018208294,7.4236130601493215
810,C1_04170C_A,1438,C1,870671,871066,395,432.10465271794885,541.7153492886774
812,C1_04180W_A,1825,C1,871931,872323,392,552.5911866113142,692.7653423449437
814,C1_04190C_A,434,C1,872592,873764,1172,43.953075597648166,55.10252099792444
816,C1_04200C_A,292,C1,874582,875391,809,42.84118569129991,53.708581300216146
818,C1_04210C_A,1546,C1,876392,877791,1399,131.16529106090573,164.4375986573544
820,C1_04220C_A,269,C1,878742,879311,569,56.11347516266448,70.3476127978329
822,C1_04230W_A,1165,C1,879636,880616,980,141.0999961429438,176.8924107028733
824,C1_04240C_A,1874,C1,880940,881257,317,701.6773802586998,879.6697854186671
826,C1_04250C_A,8,C1,881368,881877,509,1.8655176265178366,2.3387379105888453
828,C1_04260W_A,1694,C1,882165,882575,410,490.4070461568593,614.8071367236554
830,C1_04270C_A,30,C1,882919,884154,1235,2.883244347867142,3.6146283294222337
832,C1_04280C_A,39,C1,884550,885734,1184,3.9096695950174807,4.901423803114354
834,C1_04290C_A,13742,C1,886010,889117,3107,524.9716406829953,658.1396286997813
836,C1_04300C_A,14972,C1,890373,892310,1937,917.439321195828,1150.1634134385727
838,C1_04310C_A,38,C1,892910,893674,764,5.9036063370595535,7.401156522678247
840,C1_04320W_A,447,C1,895092,895877,785,67.58728772901557,84.73195312594042
842,C1_04330W_A,12460,C1,897942,899552,1610,918.584934770484,1151.5996313867965
844,C1_04340C_A,759,C1,899992,900945,953,94.53138643366505,118.5108808677465
846,C1_04350C_A,410,C1,901560,903929,2369,20.54215246295944,25.753018919416743
848,C1_04360C_A,1086,C1,905274,905525,251,513.550617769308,643.8214690178477
850,C1_04370C_A,957,C1,905958,906560,602,188.68726902117587,236.55100495030408
852,C1_04380W_A,649,C1,907132,908076,944,81.60182180369817,102.30151219833552
854,C1_04390C_A,2492,C1,908570,910795,2225,132.936786065661,166.6584635085611
856,C1_04400C_A,7542,C1,911109,914328,3219,278.0946945888296,348.63814510428256
858,C1_04410C_A,556,C1,914539,915072,533,123.81541988157925,155.22330760982308
860,C1_04420C_A,1144,C1,915265,916104,839,161.84199223045744,202.89596698215766
862,C1_04430C_A,314,C1,916437,917263,826,45.12079603145274,56.5664535862247
864,C1_04440W_A,1,C1,916801,917169,368,0.32253684507390584,0.4043538031554763
866,C1_04450C_A,2510,C1,917491,918323,832,358.07792434839587,448.91048184933936
868,C1_04460C_A,1772,C1,918745,919554,809,259.9814419348748,325.9301577533665
870,C1_04470C_A,2078,C1,920167,920688,521,473.4073235612209,593.4951452748663
872,C1_04480C_A,4618,C1,921715,925908,4193,130.72426792341457,163.8847024978994
874,C1_04490W_A,3619,C1,926875,927996,1121,383.18643173476113,480.3881893060108
876,C1_04500W_A,9821,C1,929091,930743,1652,705.623149402703,884.6164660355299
878,C1_04510W_A,454,C1,931183,932622,1439,37.44744668532842,46.94662863154395
880,C1_04520C_A,919,C1,932754,933831,1077,101.2807620327153,126.972350414816
882,C1_04530C_A,775,C1,934147,935706,1559,59.00417460877354,73.9715873379999
884,C1_04540C_A,578,C1,936078,938918,2840,24.1566468642958,30.28439131914875
886,C1_04550W_A,102,C1,939165,939467,302,40.088553035411024,50.25769654054291
888,C1_04560W_A,301,C1,940013,941746,1733,20.61555756211564,25.845044470816966
890,C1_04570C_A,635,C1,941946,943343,1397,53.951617721453346,67.63736343691605
892,C1_04580C_A,1071,C1,943640,944467,827,153.71318219502825,192.70514598556417
894,C1_04590W_A,175,C1,946251,946439,188,110.48602565297627,138.51268576176955
896,C1_04600C_A,2304,C1,947537,948574,1037,263.7125939310537,330.6077799315719
898,C1_04610W_A,36434,C1,949329,951471,2142,2018.8987526328426,2531.02676882041
900,C1_04620W_A,1415,C1,952320,954050,1730,97.08172599241865,121.70815744457782
902,C1_04630C_A,1228,C1,954196,957687,3491,41.75184486859878,52.34291064485029
904,C1_04640W_A,809,C1,958785,960746,1961,48.96638919971579,61.387546886804266
906,C1_04650W_A,61,C1,961930,964107,2177,3.3258186027648318,4.169469073603185
908,C1_04660W_A,1129,C1,965166,970607,5441,24.628749879901825,30.87625129656535
910,C1_04670W_A,718,C1,970917,972158,1241,68.67201881773384,86.09184470987314
912,C1_04680W_A,5360,C1,973480,974406,926,687.038311200192,861.3172674385679
914,C1_04690C_A,167,C1,974965,976872,1907,10.394244546859968,13.030921513750892
916,C1_04700C_A,1156,C1,977199,979934,2735,50.16810025199274,62.89409239223578
918,C1_04710C_A,112,C1,980592,981179,587,22.646811936228456,28.391561074712282
920,C1_04720W_A,70,C1,982170,982391,221,37.59524492807156,47.13191841305462
922,C1_04730C_A,953,C1,982545,983831,1286,87.95875716547363,110.27099236534849
924,C1_04740W_A,614,C1,984729,985775,1046,69.67289217795333,87.34660662579942
926,C1_04750W_A,264,C1,986263,987447,1184,26.46545572011833,33.178868821081785
928,C1_04760C_A,362,C1,987525,990488,2963,14.501204304207034,18.17968148537291
930,C1_04770C_A,2872,C1,991622,992782,1160,293.8688805269231,368.41372167225023
932,C1_04780C_A,658,C1,994377,997034,2657,29.39418961745422,36.85052589811052
934,C1_04790W_A,583,C1,997297,997971,674,102.66816749189327,128.71169487268327
936,C1_04800C_A,84,C1,998118,1000229,2111,4.723002820902217,5.9210728390061975
938,C1_04810W_A,1163,C1,1001617,1003743,2126,64.92973146853741,81.40026250691129
940,C1_04820C_A,198,C1,1003914,1004285,371,63.345888623895085,79.4146509787618
942,C1_04830W_A,3408,C1,1004469,1007279,2810,143.9529000100956,180.46900217246323
944,C1_04840C_A,232,C1,1007444,1007815,371,74.2234654583013,93.0515102377411
946,C1_04850C_A,42,C1,1008208,1008380,172,28.983310915478427,36.33542082308745
948,C1_04860W_A,1357,C1,1008955,1011525,2570,62.6720465158081,78.56987735586348
950,C1_04870W_A,226,C1,1012991,1014757,1766,15.189549451362744,19.042637089940346
952,C1_04880C_A,316,C1,1015097,1015459,362,103.61095204407285,129.89363276614372
954,C1_04890W_A,4358,C1,1015786,1016976,1190,434.67775635815633,544.9411644435094
956,C1_04900W_A,1293,C1,1017681,1019972,2291,66.98855162393984,83.98133742149776
958,C1_04910C_A,236,C1,1020126,1021085,959,29.209259563064208,36.61868518920418
960,C1_04930C_A,23,C1,1021667,1022368,701,3.894367841234721,4.882240499155424
962,C1_04940C_A,14,C1,1023215,1023751,536,3.100204898919334,3.8866246154048767
964,C1_04950C_A,944,C1,1028271,1032458,4187,26.760620894175855,33.54890766319256
966,C1_04960C_A,348,C1,1033844,1035829,1985,20.808744850148454,26.087237001160165
968,C1_04970W_A,4363,C1,1036804,1040895,4091,126.58518647302422,158.69567261930635
970,C1_04980C_A,755,C1,1041964,1043523,1559,57.481486231772934,72.06264314863216
972,C1_04990C_A,674,C1,1044362,1045495,1133,70.6085249403098,88.51957855627458
974,C1_05000W_A,619,C1,1048309,1050273,1964,37.40901884576129,46.89845291669667
976,C1_05010C_A,117,C1,1050452,1051426,974,14.257850514889212,17.87459686720964
978,C1_05020C_A,318,C1,1051994,1053736,1742,21.667366106732928,27.163662147225292
980,C1_05030C_A,143,C1,1054104,1054799,695,24.42184019448809,30.61685544928602
982,C1_05050C_A,1060,C1,1055313,1057673,2360,53.31151378238525,66.8348862435967
984,C1_05060W_A,686,C1,1058030,1059178,1148,70.92663890698378,88.91838754267741
986,C1_05070C_A,488,C1,1059228,1061885,2657,21.799946099266958,27.329873310452786
988,C1_05080W_A,351,C1,1064009,1065736,1727,24.123589579910984,30.242948492175202
990,C1_05090W_A,576,C1,1066117,1067232,1115,61.31613450818446,76.87001519933634
992,C1_05100W_A,272,C1,1067544,1068347,803,40.20504115132962,50.403733848879895
994,C1_05110C_A,7083,C1,1068523,1069635,1112,756.0310056711501,947.8111326367697
996,C1_05120W_A,666,C1,1070515,1071795,1280,61.75774241052612,77.42364445919483
998,C1_05130W_A,5,C1,1072175,1072615,440,1.3487904430363338,1.690934085922901
1000,C1_05140W_A,134,C1,1082624,1083892,1268,12.543325634293728,15.72515358139026
1002,C1_05150C_A,4,C1,1084950,1085183,233,2.0376576650162637,2.554544198475799
1004,C1_05160C_A,2511,C1,1092614,1093810,1196,249.1969286094085,312.4099691456618
1006,C1_05170C_A,2750,C1,1094679,1095959,1280,255.00569313655683,319.6922256197985
1008,C1_05180C_A,94,C1,1097142,1097528,386,28.904649079783812,36.23680507449284
1010,C1_05190C_A,214,C1,1098256,1098588,332,76.50729404596457,95.91467080150625
1012,C1_05200C_A,858,C1,1099257,1100150,893,114.04151580180888,142.9700864765092
1014,C1_05210C_A,2205,C1,1101241,1102398,1157,226.2050972919362,283.5858686538286
1016,C1_05220C_A,113,C1,1102611,1103048,437,30.691927152295886,38.477456637110585
1018,C1_05230W_A,132,C1,1103297,1103884,587,26.690885496269253,33.46148269519662
1020,C1_05240C_A,2187,C1,1104007,1105341,1334,194.5898152211399,243.95083241407633
1022,C1_05250W_A,1,C1,1104248,1104862,614,0.19331198532116833,0.24234885922022034
1024,C1_05260C_A,659,C1,1105631,1107547,1916,40.824141634949406,51.179879702944085
1026,C1_05270C_A,1339,C1,1108146,1108865,719,221.04405491496144,277.11564007297255
1028,C1_05280W_A,325,C1,1109135,1110883,1748,22.068310452425138,27.666312847479958
1030,C1_05290W_A,6145,C1,1111172,1113130,1958,372.5086414587986,467.00179586499894
1032,C1_05300C_A,1778,C1,1113320,1115428,2108,100.1124989939454,125.50773758056964
1034,C1_05310W_A,1,C1,1116052,1116144,92,1.2901473802956234,1.6174152126219052
1036,C1_05320C_A,240,C1,1116245,1117987,1742,16.352729137156924,20.500877092245503
1038,C1_05330C_A,605,C1,1118242,1119618,1376,52.187211618644184,65.42538570823783
1040,C1_05340C_A,2186,C1,1119919,1122246,2327,111.50155562785278,139.78582219201402
1042,C1_05350W_A,229,C1,1123169,1123828,659,41.24556146899574,51.70819984752398
1044,C1_05360C_A,567,C1,1123871,1125682,1811,37.16137379665428,46.58798848769137
1046,C1_05370C_A,369,C1,1125926,1128109,2183,20.06318060754733,25.152547704117474
1048,C1_05380C_A,918,C1,1128387,1133384,4997,21.805220562386864,27.336485730877655
1050,C1_05390C_A,523,C1,1133457,1135511,2054,30.222361903750837,37.88877817454508
1052,C1_05400C_A,143,C1,1135748,1136341,593,28.62256144210662,35.88316110835377
1054,C1_05410C_A,613,C1,1136528,1137082,554,131.33420877103245,164.64936521845664
1056,C1_05420W_A,100,C1,1137313,1137870,557,21.309436083877443,26.714937084598795
1058,C1_05430W_A,651,C1,1138277,1140532,2255,34.265856718698664,42.9579742413974
1060,C1_05440C_A,445,C1,1141075,1142832,1757,30.061829111726137,37.68752350867433
1062,C1_05450W_A,1,C1,1142087,1142581,494,0.24027036232226184,0.3012190274518528
1064,C1_05460W_A,1803,C1,1143981,1148279,4298,49.79164421915236,62.422141882008184
1066,C1_05470W_A,1421,C1,1149114,1150163,1049,160.78507847550756,201.57094907196083
1068,C1_05480C_A,227,C1,1150297,1151418,1121,24.03518099027101,30.132113559675176
1070,C1_05490C_A,767,C1,1151708,1152454,746,122.0347985833517,152.99100142553903
1072,C1_05500W_A,1501,C1,1152769,1155042,2273,78.3805684292931,98.26313310223675
1074,C1_05510C_A,48,C1,1155542,1155790,248,22.972946900747875,28.800425721525542
1076,C1_05520W_A,219,C1,1158880,1160955,2075,12.527175623227095,15.704906845255975
1078,C1_05530C_A,320,C1,1161281,1162890,1609,23.60592844990874,29.593973809564257
1080,C1_05540C_A,1871,C1,1163603,1164622,1019,217.93488603046737,273.2177776045474
1082,C1_05550C_A,1,C1,1166517,1166614,97,1.2236449380123438,1.5340432944455185
1084,C1_05560W_A,1542,C1,1166877,1167580,703,260.3491720601114,326.39116888107253
1086,C1_05570W_A,2,C1,1167998,1168103,105,2.2608296949942353,2.834327610689815
1088,C1_05580W_A,1,C1,1168190,1168292,102,1.1636623430117388,1.458845093737405
1090,C1_05590W_A,1,C1,1168844,1168916,72,1.648521652599963,2.06669721612799
1092,C1_05600W_A,391,C1,1169206,1173921,4715,9.842880501377342,12.339694597759316
1094,C1_05610W_A,248,C1,1174224,1175690,1466,20.07912866904839,25.172541262743106
1096,C1_05620C_A,132,C1,1175776,1177029,1253,12.504030156672028,15.675890137334731
1098,C1_05630C_A,3448,C1,1177543,1180872,3329,122.936434781573,154.1213529850016
1100,C1_05640C_A,486,C1,1181156,1182355,1199,48.11098387637858,60.31515345016734
1102,C1_05650W_A,198,C1,1182507,1183265,758,31.00438612066633,38.86917613868157
1104,C1_05660C_A,1348,C1,1183318,1187598,4280,37.38292465297711,46.86573948797154
1106,C1_05670W_A,1042,C1,1188181,1189434,1253,98.7060562367595,123.74452669017265
1108,C1_05680C_A,336,C1,1189532,1189963,431,92.53140561414922,116.00357088762956
1110,C1_05690C_A,48,C1,1190242,1190988,746,7.637119076924227,9.57440426131144
1112,C1_05700W_A,778,C1,1191581,1192072,491,188.07248246851233,235.78026732917616
1114,C1_05710C_A,152,C1,1192511,1194184,1673,10.783873858968319,13.519386929650164
1116,C1_05720W_A,11123,C1,1195171,1196708,1537,858.96451308692,1076.8554754192567
1118,C1_05730W_A,1,C1,1195918,1195999,81,1.4653525800888563,1.837064192113769
1120,C1_05740C_A,116,C1,1196996,1198138,1142,12.056438566125125,15.11475932495707
1122,C1_05750C_A,837,C1,1198353,1203407,5054,19.6570061084852,24.643340133109852
1124,C1_05760C_A,15,C1,1204128,1204523,395,4.507350341285975,5.650716439033492
1126,C1_05770C_A,1249,C1,1206048,1207700,1652,89.73865325363771,112.50238937769849
1128,C1_05780W_A,833,C1,1208498,1210402,1904,51.92843205689884,65.10096230803168
1130,C1_05790W_A,176,C1,1210686,1210895,209,99.95247072606094,125.30711541997077
1132,C1_05800C_A,89,C1,1211015,1211707,692,15.265501083613534,19.137855145878845
1134,C1_05810W_A,281,C1,1211852,1212328,476,70.06909679706399,87.843315287188
1136,C1_05820C_A,337,C1,1212362,1213378,1016,39.369812380595974,49.356635090678694
1138,C1_05830W_A,3,C1,1213935,1214855,920,0.38704421408868706,0.4852245637865716
1140,C1_05840W_A,493,C1,1215414,1216451,1037,56.428085420143006,70.74202929959415
1142,C1_05850W_A,1001,C1,1216759,1217970,1211,98.11086089693191,122.99834992632246
1144,C1_05860W_A,153,C1,1218269,1219270,1001,18.141972552488706,22.74399254032561
1146,C1_05870W_A,92,C1,1219787,1220767,980,11.142660639614446,13.969186081256947
1148,C1_05880W_A,164,C1,1221543,1222529,986,19.7421335435095,24.75006159030356
1150,C1_05890W_A,2,C1,1223689,1224744,1055,0.22501148623165373,0.28208947784116645
1152,C1_05900W_A,636,C1,1226686,1229604,2918,25.870151993097164,32.43255617578236
1154,C1_05910W_A,1458,C1,1231376,1232920,1544,112.08238925086381,140.51399414524087
1156,C1_05920W_A,35,C1,1236305,1238380,2075,2.002060031109353,2.5099166191048363
1158,C1_05930C_A,446,C1,1238529,1241924,3395,15.592732638671581,19.548094552077174
1160,C1_05940W_A,801,C1,1244647,1247667,3020,31.481304883690427,39.467073459779286
1162,C1_05950C_A,87,C1,1248213,1249460,1247,8.28094597585098,10.381548806596415
1164,C1_05960W_A,230,C1,1251550,1252941,1391,19.62582211865952,24.604245793730783
1166,C1_05970W_A,55,C1,1254843,1256615,1772,3.684055160437841,4.6185784288187595
1168,C1_05980W_A,233,C1,1257107,1259197,2090,13.232344135893293,16.588953348212037
1170,C1_05990C_A,198,C1,1259288,1260358,1070,21.96385484062157,27.5353602926361
1172,C1_06000W_A,857,C1,1261683,1263329,1646,61.79852980074613,77.47477826486119
1174,C1_06010W_A,533,C1,1263838,1264770,932,67.87947096585428,85.09825361172506
1176,C1_06020W_A,503,C1,1265500,1267533,2033,29.36687662103309,36.816284495470384
1178,C1_06030C_A,31,C1,1267647,1268351,704,5.226562966765792,6.552369582951241
1180,C1_06040W_A,112,C1,1268617,1271166,2549,5.215252493748962,6.53819001602829
1182,C1_06050C_A,735,C1,1271299,1271640,341,255.83509048560134,320.73201371698894
1184,C1_06060C_A,164,C1,1272151,1272585,434,44.851943949079185,56.229402599168914
1186,C1_06070W_A,394,C1,1272827,1273369,542,86.28277166228,108.16986462568049
1188,C1_06080C_A,113,C1,1273457,1274497,1040,12.896511697647407,16.1679312984782
1190,C1_06090C_A,472,C1,1274861,1277509,2648,21.15685794635844,26.52365490668188
1192,C1_06100C_A,4188,C1,1278575,1280680,2105,236.14661522013424,296.04922173984306
1194,C1_06110C_A,543,C1,1281140,1282936,1796,35.88563615258806,44.988638286046715
1196,C1_06120C_A,93,C1,1283082,1283711,629,17.549286145960817,22.00096114339113
1198,C1_06130C_A,2154,C1,1284280,1285402,1122,227.86624425884415,285.66839381003365
1200,C1_06140C_A,4,C1,1286026,1286367,341,1.3922998121665378,1.7454803467591238
1202,C1_06150W_A,4,C1,1288905,1289630,725,0.6548610151017785,0.8209776527515327
1204,C1_06160W_A,14,C1,1289661,1291016,1355,1.226354114996873,1.5374397002634792
1206,C1_06180W_A,31,C1,1292811,1293806,995,3.6979902800031335,4.636048428540376
1208,C1_06190C_A,1,C1,1293014,1293619,605,0.1961877008052849,0.24595404886151287
1210,C1_06200W_A,697,C1,1294855,1296609,1754,47.16614060095584,59.130634603287945
1212,C1_06210W_A,82,C1,1297212,1298261,1049,9.27823816677806,11.63182112871273
1214,C1_06220C_A,21,C1,1298404,1299762,1358,1.835467407018516,2.301064941668278
1216,C1_06230C_A,2669,C1,1300699,1302570,1871,169.31753550872781,212.26780899459303
1218,C1_06250W_A,158,C1,1306250,1308475,2225,8.42857632358525,10.566628103672816
1220,C1_06260W_A,2,C1,1309503,1310432,929,0.25552972871301904,0.32034919173566256
1222,C1_06270W_A,162,C1,1310816,1313557,2741,7.015088126933956,8.794584578225784
1224,C1_06280C_A,31,C1,1314438,1316969,2531,1.4537733420004417,1.8225476832863192
1226,C1_06290C_A,1,C1,1324455,1324766,311,0.3816513150713741,0.47846366418397196
1228,C1_06300W_A,1,C1,1334325,1334415,90,1.3188173220799706,1.6533577729023918
1230,C1_06310W_A,1,C1,1334422,1334490,68,1.745493514517608,2.188267640606107
1232,C1_06320W_A,302,C1,1337607,1340003,2396,14.960540406566613,18.755536004794248
1234,C1_06330W_A,6,C1,1340304,1340657,353,2.017454260405621,2.5292158565645657
1236,C1_06340W_A,81,C1,1344841,1348191,3350,2.8699039635710406,3.5979039296890862
1238,C1_06350W_A,275,C1,1350783,1353404,2621,12.453540145547223,15.612592475900117
1240,C1_06360W_A,222,C1,1353982,1355679,1697,15.527383674223817,19.46616871101343
1242,C1_06370C_A,5,C1,1356733,1357260,527,1.1261248480758763,1.4117855745845853
1244,C1_06380C_A,103,C1,1359377,1359700,323,37.849648841118665,47.45085620682716
1246,C1_06390W_A,80,C1,1359948,1360724,776,12.23644938012344,15.340432944455184
1248,C1_06400C_A,703,C1,1361000,1363132,2132,39.137697921200626,49.06564084968778
1250,C1_06410W_A,168,C1,1364407,1366992,2585,7.713933427407798,9.67070387863991
1252,C1_06420C_A,473,C1,1367104,1369278,2174,25.824311591970723,32.375087577026136
1254,C1_06430C_A,8,C1,1370780,1372147,1367,0.6946221447677973,0.8708248694145737
1256,C1_06440C_A,571,C1,1372798,1375413,2615,25.917408100072535,32.491799598261544
1258,C1_06450C_A,6631,C1,1375843,1376671,828,950.551919860031,1191.6755860995393
1260,C1_06460C_A,3165,C1,1377036,1377428,392,958.3293729451011,1201.4259224776692
1262,C1_06470W_A,2353,C1,1377812,1378198,386,723.5387157950138,907.0766206412942
1264,C1_06480C_A,631,C1,1378615,1379223,608,123.18361138309463,154.43123013672178
1266,C1_06490C_A,1,C1,1380091,1380163,72,1.648521652599963,2.06669721612799
1268,C1_06500W_A,140,C1,1380391,1381107,716,23.208237790792776,29.095402148840975
1270,C1_06510C_A,489,C1,1381134,1382531,1397,41.54699380439478,52.08609562307392
1272,C1_06520C_A,551,C1,1382826,1389647,6821,9.588059082531263,12.02023339073884
1274,C1_06530C_A,1596,C1,1390212,1394330,4118,46.00168046225522,57.67078933941224
1276,C1_06540C_A,299,C1,1395028,1396152,1124,31.574176278622783,39.58350326405994
1278,C1_06550W_A,6378,C1,1398176,1404556,6380,118.65635097497567,148.75555310367258
1280,C1_06560W_A,244,C1,1404816,1406129,1313,22.057295044079325,27.652503193401774
1282,C1_06570W_A,612,C1,1407257,1408294,1037,70.04865776293613,87.81769154432376
1284,C1_06580W_A,11011,C1,1408972,1409409,437,2990.6974325126553,3749.338717090484
1286,C1_06590C_A,1273,C1,1409768,1410970,1202,125.70457619858755,157.59168056691104
1288,C1_06600W_A,3978,C1,1411658,1412701,1043,452.69700637686583,567.5313037914807
1290,C1_06610C_A,143,C1,1413016,1415442,2426,6.996363946895806,8.771110691365948
1292,C1_06620C_A,9,C1,1417195,1417896,701,1.5238830683092384,1.910441934452122
1294,C1_06630W_A,558,C1,1418523,1421138,2615,25.327344518109417,31.752056349964867
1296,C1_06640C_A,141,C1,1421365,1421508,143,117.03350921115263,146.7210499170025
1298,C1_06650W_A,145,C1,1421838,1422404,566,30.407360517921582,38.12070483458695
1300,C1_06660W_A,1169,C1,1422905,1424605,1700,81.61927673884337,102.32339487474157
1302,C1_06670W_A,1334,C1,1425323,1427644,2321,68.21939150750593,85.52440078184453
1304,C1_06680W_A,531,C1,1427895,1430957,3062,20.58337028811293,25.804692347160458
1306,C1_06690W_A,415,C1,1431951,1432876,925,53.251704842904765,66.75990574908577
1308,C1_06700W_A,595,C1,1433430,1435013,1583,44.61318231041215,55.930075008795384
1310,C1_06710W_A,289,C1,1435371,1436402,1031,33.271036418331754,41.710800846936195
1312,C1_06720C_A,391,C1,1436436,1437638,1202,38.60996802328966,48.404043284887834
1314,C1_06730W_A,448,C1,1440080,1440790,710,74.8939639806541,93.89209211749922
1316,C1_06740C_A,453,C1,1441424,1442053,629,85.48200671097044,107.16597202103422
1318,C1_06750W_A,122,C1,1442282,1442668,386,37.51454455035771,47.03074701157582
1320,C1_06760C_A,809,C1,1442821,1444427,1606,59.79021744747364,74.95702331570558
1322,C1_06770W_A,949,C1,1444436,1445959,1523,73.95941397166796,92.7204775992077
1324,C1_06780W_A,1021,C1,1447122,1449623,2501,48.455067463386044,60.74651969292316
1326,C1_06790C_A,1035,C1,1449873,1450304,431,285.02977622215604,357.33242818064457
1328,C1_06800W_A,262,C1,1450584,1451759,1175,26.466138259272945,33.17972449790502
1330,C1_06810W_A,10186,C1,1453350,1454807,1457,829.7958763511272,1040.2877177285786
1332,C1_06820W_A,1142,C1,1455538,1456530,992,136.6411737534066,171.30253215615713
1334,C1_06830W_A,6,C1,1456981,1457044,63,11.304148474971177,14.171638053449074
1336,C1_06840C_A,245,C1,1457212,1457505,293,99.24888038178618,124.42504741466807
1338,C1_06850W_A,1562,C1,1459268,1461322,2054,90.2625799113935,113.15921894577326
1340,C1_06860W_A,12,C1,1462710,1464203,1493,0.9540004741100926,1.1959989248054812
1342,C1_06870C_A,17,C1,1464434,1464637,203,9.939854693509139,12.461267943550046
1344,C1_06880C_A,31,C1,1465177,1468227,3050,1.206393550361678,1.5124157988189095
1346,C1_06890C_A,5785,C1,1468465,1469275,810,847.7064675814033,1062.7416351378154
1348,C1_06900C_A,3339,C1,1469637,1470274,637,622.1629410647598,779.9851559417548
1350,C1_06910C_A,1005,C1,1470485,1473181,2696,44.24592981533136,55.46966267026015
1352,C1_06920C_A,605,C1,1473495,1474850,1355,52.99601711236487,66.43935847567177
1354,C1_06930W_A,6636,C1,1475649,1479446,3797,207.4402047508669,260.0609418720634
1356,C1_06940C_A,1336,C1,1479745,1482981,3236,49.00327404415812,61.43378819956231
1358,C1_06950C_A,3,C1,1483972,1484082,110,3.2370970632872007,4.058241806214962
1360,C1_06960W_A,2172,C1,1484762,1485664,902,285.81198461218696,358.31305703654056
1362,C1_06970C_A,1187,C1,1485816,1487471,1655,85.12945892314396,106.72399448891997
1364,C1_06980C_A,1013,C1,1487707,1489140,1433,83.90549564133352,105.18955209735596
1366,C1_06990C_A,6,C1,1489602,1489717,115,6.192707425418993,7.763593020585145
1368,C1_07000W_A,1788,C1,1490452,1492731,2279,93.12158116239968,116.74345450436724
1370,C1_07010W_A,212,C1,1493064,1494020,956,26.3211658005082,32.99797730855402
1372,C1_07020C_A,818,C1,1494130,1497066,2936,33.06925451346302,41.457833528976195
1374,C1_07030C_A,1084,C1,1497905,1498981,1076,119.57603897966723,149.9085356174325
1376,C1_07040C_A,11,C1,1502167,1503120,953,1.3700200932415225,1.7175489980832825
1378,C1_07050C_A,498,C1,1504795,1506954,2159,27.37813449542579,34.32306409517611
1380,C1_07060C_A,75,C1,1507743,1508261,518,17.185360857219695,21.54472001368947
1382,C1_07070C_A,587,C1,1509898,1511547,1649,42.25173991842622,52.96961257879526
1384,C1_07080W_A,299,C1,1513268,1513834,566,62.70207444730037,78.60752238304482
1386,C1_07090C_A,1338,C1,1514079,1516313,2234,71.08862216869743,89.1214606145506
1388,C1_07100C_A,130,C1,1516783,1517724,941,16.39762238930463,20.557158281570654
1390,C1_07110W_A,2128,C1,1518188,1521970,3782,66.78474180982442,83.72582778060976
1392,C1_07120W_A,1505,C1,1526934,1528757,1823,97.98892280621612,122.8454801643604
1394,C1_07130C_A,808,C1,1528942,1530747,1805,53.13262917543239,66.6106245127213
1396,C1_07140C_A,1870,C1,1531432,1534566,3134,70.82225759606224,88.7875281363984
1398,C1_07150W_A,23,C1,1534761,1535003,242,11.280792796303881,14.14235780953699
1400,C1_07160C_A,36,C1,1535148,1535354,206,20.74256370650051,26.00426788448423
1402,C1_07170C_A,662,C1,1536685,1538385,1700,46.220668264426266,57.94532712324972
1404,C1_07180W_A,1048,C1,1540676,1541422,746,166.7437665128456,209.04115970529975
1406,C1_07190W_A,1493,C1,1542214,1544679,2465,71.89025702551142,90.12644379103222
1408,C1_07200W_A,315,C1,1545381,1546280,899,41.5889555961815,52.13870173724452
1410,C1_07210C_A,975,C1,1546391,1548133,1742,66.43296211970001,83.28481318724737
1412,C1_07220W_A,1199,C1,1549757,1551385,1628,87.4162022270575,109.59080913630044
1414,C1_07230W_A,933,C1,1551710,1552636,926,119.5908105130185,149.92705420152686
1416,C1_07240W_A,929,C1,1553508,1554062,554,199.03667202004755,249.52571009452888
1418,C1_07250C_A,564,C1,1554222,1555904,1682,39.79974272816843,49.89562458533022
1420,C1_07260C_A,675,C1,1556089,1557885,1796,44.60921621178075,55.92510284177077
1422,C1_07270W_A,706,C1,1558121,1560640,2519,33.26623765183062,41.7047847916705
1424,C1_07280C_A,78,C1,1560696,1560905,209,44.29711770814065,55.533835242941585
1426,C1_07290W_A,11,C1,1560957,1561400,443,2.947244128350273,3.6948627430550065
1428,C1_07310C_A,1,C1,1569972,1570092,120,0.9891129915599779,1.2400183296767942
1430,C1_07320W_A,2,C1,1570830,1570893,63,3.7680494916570586,4.723879351149692
1432,C1_07330W_A,326,C1,1578886,1580409,1523,25.406500479203114,31.85129156727261
1434,C1_07340W_A,3087,C1,1581153,1584276,3123,117.325333523368,147.08690043082663
1436,C1_07350C_A,71,C1,1584338,1584853,515,16.36357803512818,20.51447799775978
1438,C1_07360W_A,831,C1,1585929,1589840,3911,25.21972577815418,31.617138285699284
1440,C1_07370C_A,359,C1,1590522,1592492,1970,21.629942982946115,27.116746011409283
1442,C1_07380C_A,821,C1,1595184,1598036,2852,34.16809674911958,42.83541579234143
1444,C1_07390W_A,1208,C1,1600375,1602015,1640,87.42793857105758,109.60552260362687
1446,C1_07400C_A,284,C1,1602167,1603606,1439,23.42527501901602,29.367494562463616
1448,C1_07410C_A,750,C1,1604432,1604926,494,180.20277174169638,225.91427058888962
1450,C1_07420C_A,330,C1,1605356,1606747,1391,28.158788257207135,35.301743964918074
1452,C1_07430W_A,42,C1,1609045,1610016,971,5.134015939713995,6.436346427982536
1454,C1_07440W_A,913,C1,1611003,1614224,3221,33.64396751173896,42.1783322568735
1456,C1_07450W_A,8,C1,1615492,1615589,97,9.78915950409875,12.272346355564148
1458,C1_07460C_A,220,C1,1615681,1616832,1151,22.68686618347821,28.441775763220996
1460,C1_07470C_A,254,C1,1617098,1619065,1967,15.326977113750957,19.214925616954083
1462,C1_07480C_A,45,C1,1619304,1621175,1871,2.854735518131417,3.5788877500025054
1464,C1_07490C_A,335,C1,1621424,1623418,1994,19.940994112693637,24.999366526081804
1466,C1_07500C_A,846,C1,1623838,1624812,974,103.09522679996815,129.24708503982353
1468,C1_07510W_A,97,C1,1625174,1626007,833,13.821458849649632,17.327507031738154
1470,C1_07520C_A,680,C1,1626202,1629063,2861,28.21098221296547,35.367177805531774
1472,C1_07530W_A,4,C1,1630610,1630705,95,4.997623536303046,6.265355770998538
1474,C1_07540C_A,3392,C1,1631817,1634681,2864,140.5756117613734,176.23500730155106
1476,C1_07550W_A,731,C1,1635159,1636253,1094,79.30986436895911,99.42816076713747
1478,C1_07560W_A,198,C1,1636861,1637820,959,24.506073701214888,30.722456218061136
1480,C1_07570C_A,108,C1,1637846,1639054,1208,10.611675803491154,13.303507907790772
1482,C1_07580C_A,45,C1,1639501,1640733,1232,4.3353978526167865,5.435145276180752
1484,C1_07590C_A,362,C1,1641986,1645111,3125,13.749461873076942,17.237246797171178
1486,C1_07600W_A,189,C1,1645623,1646147,524,42.81122642858836,53.67102236082001
1488,C1_07610C_A,43,C1,1646303,1647247,944,5.406592199628694,6.778066293572306
1490,C1_07620C_A,8,C1,1647560,1648828,1268,0.7488552617488792,0.938815139187478
1492,C1_07630W_A,426,C1,1649647,1650174,527,95.94583705606466,120.28413095460668
1494,C1_07640C_A,446,C1,1651145,1653661,2516,21.040273174996035,26.377496424603343
1496,C1_07650W_A,59,C1,1658863,1659375,512,13.67757808641532,17.14712846506192
1498,C1_07660W_A,64,C1,1660186,1662414,2228,3.4095097734203907,4.274389933535807
1500,C1_07670W_A,20,C1,1666415,1667008,593,4.003155446448478,5.01862393123829
1502,C1_07680W_A,305,C1,1668121,1669215,1094,33.090983081439845,41.48507391788908
1504,C1_07690C_A,305,C1,1669743,1672880,3137,11.540177077174114,14.46753932616215
1506,C1_07700C_A,409,C1,1674155,1675270,1115,43.53871356570737,54.58304898702874
1508,C1_07710C_A,2213,C1,1677049,1678674,1625,161.64236679302633,202.64570315628887
1510,C1_07770W_A,85,C1,1691292,1692819,1527,6.607041593917338,8.283030100002161
1512,C1_07780W_A,830,C1,1696626,1699202,2576,38.24365448733455,47.944808088435046
1514,C1_07790C_A,307,C1,1699242,1700171,929,39.22381335744843,49.17360093142421
1516,C1_07800W_A,472,C1,1700387,1702474,2087,26.843967341618185,33.653396355004126
1518,C1_07810C_A,181,C1,1702555,1704825,2270,9.464111972106926,11.864844987039634
1520,C1_07820W_A,271,C1,1705110,1706270,1160,27.729271108215936,34.76327248369771
1522,C1_07830C_A,84,C1,1706353,1707135,782,12.749691758215574,15.983867983557655
1524,C1_07840W_A,613,C1,1707470,1708372,902,80.66424795914853,101.12610679714521
1526,C1_07850C_A,116,C1,1708433,1709872,1439,9.56807007818964,11.995173835372462
1528,C1_07860W_A,63,C1,1710121,1711374,1253,5.967832574775286,7.481674838273394
1530,C1_07870C_A,3590,C1,1711666,1713528,1862,228.84526141999922,286.8957553301627
1532,C1_07880C_A,956,C1,1714644,1716962,2318,48.95213217936181,61.3696733306824
1534,C1_07890C_A,2542,C1,1718492,1720900,2408,125.29859922984038,157.0827206331434
1536,C1_07900W_A,92,C1,1722824,1723399,575,18.990969437951577,23.808351929794444
1538,C1_07910C_A,964,C1,1723764,1724978,1214,94.25089856973496,118.15924248518249
1540,C1_07920W_A,112,C1,1725659,1725850,191,69.60041155270211,87.25574005683826
1542,C1_07930C_A,83,C1,1726172,1727575,1403,7.021785741936836,8.802981157220861
1544,C1_07940W_A,8,C1,1729104,1729195,91,10.434598592281086,13.081512049337608
1546,C1_07950C_A,186,C1,1729610,1730410,800,27.596252464523385,34.59651139798255
1548,C1_07960W_A,133,C1,1730691,1731389,698,22.61639447750322,28.3534277100883
1550,C1_07970C_A,1353,C1,1731592,1735263,3671,43.74622318433071,54.843196950782975
1552,C1_07980C_A,796,C1,1737039,1737770,731,129.24770581916428,162.0335852951127
1554,C1_07990C_A,4203,C1,1741763,1743058,1295,385.2270489754367,482.9464438268632
1556,C1_08000W_A,425,C1,1747219,1749510,2291,22.01866546030505,27.604074558496944
1558,C1_08010W_A,927,C1,1750206,1750925,719,153.03049955651173,191.8492892812887
1560,C1_08020W_A,675,C1,1751228,1753102,1874,42.75248255942274,53.59737710982941
1562,C1_08030W_A,1772,C1,1753563,1753943,380,553.4868066455624,693.8881516380882
1564,C1_08040W_A,59,C1,1754691,1754915,224,31.263035626092158,39.193436491570104
1566,C1_08050W_A,1276,C1,1755407,1755907,500,302.90596253532766,379.7432132802214
1568,C1_08060W_A,936,C1,1756486,1756893,407,272.9660226339478,342.2084982538022
1570,C1_08070W_A,2613,C1,1757979,1762451,4472,69.35292254775194,86.94547125524498
1572,C1_08080C_A,1095,C1,1762963,1763349,386,336.7084121528008,422.1202293252092
1574,C1_08090C_A,11760,C1,1763704,1766757,3053,457.20152430050473,573.1784693219429
1576,C1_08100W_A,1479,C1,1767333,1768439,1106,158.72312273242758,198.98594317453654
1578,C1_08110W_A,2545,C1,1768990,1772265,3275,92.23667408318084,115.63407568955509
1580,C1_08120W_A,688,C1,1772645,1774756,2111,38.683642152151485,48.49640610995552
1582,C1_08130C_A,478,C1,1774766,1777369,2603,21.79620483898592,27.32518301585129
1584,C1_08140W_A,240,C1,1777560,1778540,980,29.067810364211596,36.441354994583335
1586,C1_08150C_A,25,C1,1778537,1779175,638,4.651001527711495,5.83080719283759
1588,C1_08160W_A,464,C1,1779285,1780343,1058,52.05464212671037,65.25918770926644
1590,C1_08170C_A,737,C1,1780648,1782873,2225,39.31557437014133,49.2886386861194
1592,C1_08180C_A,5957,C1,1785337,1789293,3956,178.73041731211694,224.06842840903929
1594,C1_08190C_A,580,C1,1790347,1793517,3170,21.716802590717496,27.225639036436867
1596,C1_08200W_A,242,C1,1794134,1795096,962,29.858462863723247,37.432569951989706
1598,C1_08210C_A,4280,C1,1795204,1800024,4820,105.39594034547815,132.13141371825756
1600,C1_08220W_A,1265,C1,1801629,1803992,2363,63.54098693136042,79.6592392911288
1602,C1_08230C_A,1061,C1,1804089,1806353,2264,55.624499154335865,69.7345997060289
1604,C1_08240C_A,142,C1,1806847,1807839,992,16.990408645344786,21.300314856544933
1606,C1_08260C_A,417,C1,1808933,1809601,668,74.09463188272649,92.88999583387242
1608,C1_08270C_A,1296,C1,1810097,1813534,3437,44.756139786851264,56.109296081272916
1610,C1_08290C_A,1614,C1,1816300,1819245,2945,65.0497128031703,81.55067914831969
1612,C1_08300W_A,1826,C1,1820165,1822153,1988,109.02134743995089,136.67646700139792
1614,C1_08310W_A,2371,C1,1823757,1825340,1583,177.77790799661716,222.87429890059468
1616,C1_08320W_A,16537,C1,1826586,1828619,2033,965.4871544374239,1210.399397021061
1618,C1_08330C_A,1933,C1,1829194,1830240,1046,219.34478921821463,274.98532672259
1620,C1_08340C_A,325,C1,1831872,1832345,473,81.55477097428994,102.24252612557075
1622,C1_08350C_A,91,C1,1832850,1833041,191,56.55033438657047,70.8952887961811
1624,C1_08360C_A,19168,C1,1834255,1835715,1460,1558.3000949771226,1953.5894254721743
1626,C1_08370W_A,5292,C1,1839237,1841123,1886,333.04682617192384,417.5298197656157
1628,C1_08380W_A,5493,C1,1842502,1843878,1376,473.8253775557231,594.0192457774386
1630,C1_08390C_A,840,C1,1844112,1845788,1676,59.48841858546885,74.57866803784059
1632,C1_08400C_A,3645,C1,1846393,1849392,2999,144.26076108980806,180.85495745269412
1634,C1_08410C_A,1242,C1,1850368,1851303,935,157.66566872951776,197.66024797329345
1636,C1_08420W_A,1252,C1,1851770,1854430,2660,55.866291673673345,70.03772701151937
1638,C1_08430W_A,605,C1,1854820,1855782,962,74.6461571593081,93.58142487997426
1640,C1_08440C_A,64,C1,1855865,1856236,371,20.4754387471176,25.669382134549267
1642,C1_08450C_A,1304,C1,1856784,1857359,575,269.1763494248789,337.4575099614343
1644,C1_08460C_A,5516,C1,1858136,1860274,2138,306.2271615404025,383.90689091658726
1646,C1_08470W_A,1093,C1,1861221,1861655,434,298.92179717282653,374.74839659080254
1648,C1_08480C_A,280,C1,1861721,1862316,595,55.85579246456346,70.02456449939542
1650,C1_08490W_A,1603,C1,1862511,1863896,1385,137.3760108711028,172.2237732105618
1652,C1_08500C_A,29870,C1,1864127,1865449,1322,2681.827993152485,3362.1192896319976
1654,C1_08510W_A,206,C1,1866411,1867046,635,38.50531204939001,48.27283954269347
1656,C1_08520C_A,838,C1,1867125,1867568,443,224.5264163234117,281.48136169819054
1658,C1_08530W_A,219,C1,1867837,1868310,473,54.955368748829216,68.89573298923077
1660,C1_08540C_A,3254,C1,1868417,1870555,2138,180.64959819660442,226.47444217595628
1662,C1_08550C_A,1455,C1,1871363,1872100,737,234.32717547676006,293.7682501513816
1664,C1_08560W_A,2317,C1,1872858,1874522,1664,165.27222125801458,207.19633196113932
1666,C1_08570C_A,162,C1,1874780,1875544,764,25.16800596325389,31.552298859838842
1668,C1_08580C_A,866,C1,1877922,1879172,1250,82.23089766633032,103.09016385600995
1670,C1_08590C_A,12751,C1,1880547,1882037,1490,1015.7460205676198,1273.4072796007088
1672,C1_08600C_A,2904,C1,1882757,1884955,2198,156.8180597355874,196.5976285376566
1674,C1_08610C_A,3959,C1,1885503,1886144,641,733.085491466949,919.0450983819834
1676,C1_08620W_A,352,C1,1886878,1887366,488,85.61502615469973,107.33273410972906
1678,C1_08630W_A,948,C1,1887736,1889073,1337,84.15968131627756,105.50821629321773
1680,C1_08640W_A,505,C1,1889477,1890301,824,72.74301855404693,91.19552278933703
1682,C1_08650C_A,508,C1,1890487,1891423,936,64.41915380929088,80.76016813792452
1684,C1_08660C_A,233,C1,1891687,1892457,770,35.91636265456751,45.02715908800411
1686,C1_08670W_A,993,C1,1892915,1895104,2189,53.84317225869666,67.50140893754535
1688,C1_08680C_A,503,C1,1895260,1895835,575,103.83106116619177,130.16957631181094
1690,C1_08690W_A,618,C1,1896172,1896639,467,157.071990265713,196.9159728668759
1692,C1_08700W_A,2717,C1,1897121,1901266,4145,77.80226773660199,97.5381366001983
1694,C1_08710W_A,276,C1,1901480,1902264,784,41.784977398554176,52.38444780471354
1696,C1_08730W_A,472,C1,1902971,1904146,1175,47.67945518464438,59.774160164164776
1698,C1_08740C_A,7581,C1,1904314,1907100,2786,322.9776994551124,404.9064877507441
1700,C1_08750W_A,229,C1,1907474,1908382,908,29.934829304039862,37.52830803911707
1702,C1_08760W_A,137,C1,1908828,1909877,1049,15.501446693275536,19.433652373581026
1704,C1_08770W_A,292,C1,1910142,1911194,1052,32.94536047933615,41.302511665280285
1706,C1_08780W_A,1846,C1,1912020,1913675,1655,132.3917280304328,165.97514222960933
1708,C1_08790W_A,2430,C1,1914832,1916589,1757,164.15785335167308,205.79928567658118
1710,C1_08800W_A,260,C1,1916963,1918639,1676,18.41308194312131,23.083873440283995
1712,C1_08810C_A,2639,C1,1918866,1920872,2006,156.14770795972774,195.75723062913613
1714,C1_08820C_A,118,C1,1921091,1921723,632,22.16113917798938,27.78268915858133
1716,C1_08830C_A,39,C1,1921987,1922570,583,7.940049400515776,9.95417801524425
1718,C1_08840W_A,60,C1,1922753,1923817,1064,6.693245807548723,8.3911014790159
1720,C1_08850C_A,228,C1,1923990,1926056,2066,13.098805154443852,16.421539932215435
1722,C1_08860C_A,464,C1,1926303,1928510,2207,24.95415105122772,31.284196011057492
1724,C1_08870C_A,721,C1,1928994,1930622,1628,52.56637348265927,65.90072842975198
1726,C1_08880W_A,647,C1,1931304,1932899,1595,48.1471678148694,60.360516060254724
1728,C1_08890C_A,20,C1,1932950,1933345,395,6.009800455047968,7.534288585377989
1730,C1_08900W_A,71,C1,1933791,1935467,1676,5.02818776139082,6.30367313176986
1732,C1_08910C_A,178,C1,1936147,1938249,2102,10.051119647821661,12.600757146477793
1734,C1_08920W_A,664,C1,1938480,1939367,887,88.85290097801472,111.39195096803489
1736,C1_08930C_A,260,C1,1939545,1939769,224,137.7693095387112,172.7168387764106
1738,C1_08940C_A,1898,C1,1940406,1942679,2273,99.11147160479568,124.25278256365448
1740,C1_08950W_A,1250,C1,1948142,1951585,3443,43.09234642288607,54.02345322437384
1742,C1_08960W_A,9,C1,1952350,1952526,176,6.0695569936635,7.6092033866530535
1744,C1_08970W_A,41,C1,1952884,1952999,115,42.316834073696455,53.051218973998495
1746,C1_08980C_A,659,C1,1953260,1954783,1523,51.358539312254145,64.38650657310629
1748,C1_08990C_A,1337,C1,1956445,1959255,2810,56.47447984550991,70.80019246026507
1750,C1_09000W_A,187,C1,1960295,1961950,1655,13.411296393115352,16.813299889998344
1752,C1_09010W_A,688,C1,1962465,1964288,1823,44.79493613998452,56.1579337894219
1754,C1_09020W_A,548,C1,1964983,1965726,743,87.5424903431819,109.74913238162313
1756,C1_09030C_A,1497,C1,1966282,1966779,497,357.5135971908138,448.20300350732253
1758,C1_09040C_A,180,C1,1967483,1968947,1464,14.593470367278364,18.295352405067455
1760,C1_09050W_A,512,C1,1969726,1971693,1967,30.895323945828697,38.732448487718464
1762,C1_09060C_A,110,C1,1972141,1972821,680,19.20042865969369,24.070944046667176
1764,C1_09070W_A,470,C1,1973678,1977250,3572,15.617573550947021,19.579236784370433
1766,C1_09080C_A,1563,C1,1978117,1978776,659,281.51446539755614,352.9253989593012
1768,C1_09090C_A,1278,C1,1980940,1984239,3299,45.98071184772301,57.644501679064305
1770,C1_09100W_A,297,C1,1985645,1986385,740,47.63782029621299,59.72196387794722
1772,C1_09110W_A,114,C1,1986752,1988347,1595,8.483426786545767,10.635392319735764
1774,C1_09120W_A,910,C1,1991466,1993010,1544,69.95540069841296,87.70077823879916
1776,C1_09130W_A,2150,C1,1996613,1998733,2120,120.37318482192185,150.90789106444004
1778,C1_09140C_A,360,C1,1999453,2000619,1166,36.64638184853435,45.94236007035807
1780,C1_09150W_A,1516,C1,2004765,2005862,1097,164.0286558109309,205.63731498158828
1782,C1_09160W_A,222,C1,2007208,2008347,1139,23.134302102860243,29.002711415794376
1784,C1_09170W_A,1513,C1,2010260,2012542,2282,78.69559804891745,98.65807534448673
1786,C1_09180W_A,559,C1,2014803,2017433,2630,25.228022613628635,31.627539754646136
1788,C1_09190C_A,4818,C1,2017549,2019336,1787,320.01430733089916,401.19138079794925
1790,C1_09200W_A,454,C1,2020180,2022249,2069,26.04488921227047,32.65161846340828
1792,C1_09210C_A,4612,C1,2022447,2024309,1862,293.99285394680675,368.56914305925073
1794,C1_09220W_A,1342,C1,2025818,2027191,1373,116.01366071436185,145.4424994982891
1796,C1_09230C_A,287,C1,2027229,2028242,1013,33.62788887396411,42.158174999080735
1798,C1_09240C_A,125,C1,2028519,2029943,1424,10.419027298735724,13.0619908322696
1800,C1_09250W_A,489,C1,2030997,2034590,3593,16.153952225087533,20.25167703463242
1802,C1_09260C_A,393,C1,2034691,2035818,1127,41.39003432295347,51.88932069880888
1804,C1_09270W_A,104,C1,2036746,2038410,1664,7.418347436699834,9.300137472575955
1806,C1_09280W_A,423,C1,2038862,2041054,2192,22.90482456732869,28.715022999267365
1808,C1_09290C_A,2021,C1,2041212,2043785,2573,93.22956965142862,116.87883611084963
1810,C1_09300C_A,75,C1,2044586,2045479,893,9.968663968689588,12.497385181513042
1812,C1_09310C_A,295,C1,2045895,2048825,2930,11.95037539290895,14.981791423398809
1814,C1_09320C_A,1029,C1,2050005,2051678,1673,73.00398816367368,91.52269178032907
1816,C1_09330W_A,71,C1,2054912,2055511,599,14.06885256776463,17.637656375369424
1818,C1_09340C_A,818,C1,2055982,2059482,3500,27.740380357579266,34.77719978316403
1820,C1_09350W_A,734,C1,2060785,2061315,530,164.37938169170351,206.07700844892838
1822,C1_09360C_A,1437,C1,2061654,2064530,2876,59.305509132337484,74.34936049007871
1824,C1_09370W_A,690,C1,2065803,2067635,1832,44.704451801946604,56.04449655962802
1826,C1_09380W_A,556,C1,2067844,2070201,2357,27.998989731388093,35.10140982436814
1828,C1_09390W_A,178,C1,2070405,2071802,1397,15.123445597509757,18.959764868930794
1830,C1_09400C_A,596,C1,2072063,2073337,1274,55.526971080352915,69.61233197683227
1832,C1_09410W_A,8,C1,2074852,2075229,377,2.5186962119299174,3.1576063567366637
1834,C1_09420W_A,55,C1,2075333,2076733,1400,4.662961245925611,5.845800697047743
1836,C1_09430W_A,690,C1,2077583,2080183,2600,31.49944450044853,39.489814498937896
1838,C1_09440W_A,283,C1,2080806,2081780,974,34.48693757020211,43.23513601213955
1840,C1_09450C_A,969,C1,2082040,2086968,4928,23.3388917732537,29.259198736773055
1842,C1_09460W_A,850,C1,2087338,2088633,1295,77.90696921939595,97.66939739539227
1844,C1_09470C_A,919,C1,2088739,2089725,986,110.6281751614953,138.6908939115181
1846,C1_09480W_A,112,C1,2089906,2090313,407,32.66260099893392,40.94802543207889
1848,C1_09490C_A,3695,C1,2090366,2091958,1592,275.4853646091044,345.36691418259454
1850,C1_09500W_A,4,C1,2092602,2092937,335,1.4172365252202668,1.7767426813279439
1852,C1_09510W_A,856,C1,2093170,2094570,1400,72.57263320931496,90.98191630314307
1854,C1_09520C_A,381,C1,2094630,2095979,1349,33.522791678370794,42.02641811180358
1856,C1_09530W_A,188,C1,2096586,2097506,920,24.25477074955772,30.40740599729182
1858,C1_09540W_A,1281,C1,2102573,2104153,1580,96.23192978645557,120.64279597336504
1860,C1_09550W_A,58,C1,2104221,2104577,356,19.3377146664535,24.24305498469238
1862,C1_09560C_A,1,C1,2105679,2105747,68,1.745493514517608,2.188267640606107
1864,C1_09570W_A,577,C1,2106955,2108577,1622,42.22329441159857,52.93395138521654
1866,C1_09580C_A,69,C1,2108735,2110141,1406,5.824932837920781,7.302526152008431
1868,C1_09590C_A,5,C1,2111646,2113043,1397,0.4248158875704988,0.5325776648576066
1870,C1_09600C_A,209,C1,2114091,2115482,1391,17.83389922956452,22.357771177781448
1872,C1_09610W_A,582,C1,2117863,2118681,818,84.44945150433847,105.87149161934876
1874,C1_09620C_A,193,C1,2118745,2119209,464,49.37038121665752,61.89401835197101
1876,C1_09630W_A,7222,C1,2120305,2121618,1313,652.8597738046758,818.4687625522444
1878,C1_09640W_A,4384,C1,2122166,2123452,1286,404.62874230161214,507.2697067467868
1880,C1_09650W_A,917,C1,2124235,2125830,1595,68.23949441458306,85.54960313331311
1882,C1_09660W_A,1833,C1,2126282,2128567,2285,95.21457051358108,119.36736621256351
1884,C1_09670C_A,218,C1,2128602,2128934,332,77.9373369253284,97.70746838658113
1886,C1_09680W_A,5628,C1,2129681,2131222,1541,433.4895197793295,543.4515114409602
1888,C1_09690W_A,17257,C1,2132251,2133906,1655,1237.6403307807038,1551.5888566935903
1890,C1_09700W_A,9,C1,2134158,2134862,704,1.517389248415875,1.9023008466632634
1892,C1_09710C_A,990,C1,2134881,2136464,1583,74.23033695345886,93.06012480455031
1894,C1_09720W_A,1873,C1,2136910,2138244,1334,166.65145126163466,208.92542712005715
1896,C1_09730W_A,494,C1,2138426,2139259,833,70.38969764666926,88.2452419966871
1898,C1_09740C_A,28,C1,2139280,2139498,218,15.24504427358498,19.112209117954254
1900,C1_09750W_A,514,C1,2139718,2140614,896,68.0898318297092,85.36197608757217
1902,C1_09760C_A,1054,C1,2140691,2141770,1079,115.9434765268823,145.35451189760974
1904,C1_09770W_A,214,C1,2142201,2142542,341,74.4880399509098,93.38319855161312
1906,C1_09780C_A,1238,C1,2142636,2144831,2195,66.94424875906621,83.92579638122302
1908,C1_09790C_A,633,C1,2145394,2146539,1145,65.6183605579877,82.26357408056705
1910,C1_09800C_A,286,C1,2146924,2147445,521,65.15615714076478,81.68412490308555
1912,C1_09810W_A,303,C1,2148118,2149359,1241,28.979974515004674,36.331238087871256
1914,C1_09820C_A,1,C1,2148315,2148767,452,0.2625963694407021,0.32920840610888336
1916,C1_09830W_A,1054,C1,2149689,2153891,4202,29.77225396775488,37.324492702884555
1918,C1_09840C_A,426,C1,2153952,2154935,983,51.437900435957346,64.48599899600988
1920,C1_09850C_A,1193,C1,2155954,2157804,1850,76.5413058766089,95.95731031163776
1922,C1_09860C_A,1166,C1,2158652,2159836,1184,116.8890960971893,146.5400039597779
1924,C1_09870W_A,338,C1,2161357,2163096,1739,23.06982342591875,28.9218766254691
1926,C1_09880C_A,120,C1,2163426,2163878,452,31.51156433288425,39.505008733066006
1928,C1_09890C_A,2,C1,2164157,2164251,94,2.525394872068029,3.166004245983304
1930,C1_09900W_A,31,C1,2166008,2167423,1415,2.600353589118811,3.259977516888815
1932,C1_09910C_A,612,C1,2167566,2168384,818,88.80251601487136,111.32878500178943
1934,C1_09920W_A,747,C1,2169696,2172581,2885,30.732786330480565,38.52868044098018
1936,C1_09930W_A,88,C1,2172939,2173751,812,12.86334136807065,16.126346750476532
1938,C1_09940W_A,52,C1,2173813,2174097,284,21.732623476529092,27.24547315909576
1940,C1_09950C_A,287,C1,2174079,2174675,596,57.156126559271215,71.65475045984695
1942,C1_09960W_A,445,C1,2174942,2175366,424,124.57224940873309,156.17211982250188
1944,C1_09970C_A,676,C1,2175531,2178041,2510,31.966870866671474,40.07581151529144
1946,C1_09980C_A,420,C1,2178865,2179779,914,54.54189800286969,68.37737835416895
1948,C1_09990W_A,572,C1,2180946,2182802,1856,36.58012701545091,45.85929857166764
1950,C1_10000C_A,738,C1,2183212,2185005,1793,48.85434831709517,61.24708492815219
1952,C1_10010C_A,2334,C1,2189027,2192563,3536,78.3458050554634,98.21955140720489
1954,C1_10020W_A,1780,C1,2195272,2196825,1553,136.04284288294352,170.55242448098082
1956,C1_10030W_A,1099,C1,2196988,2198682,1694,77.00367256607431,96.53696417814379
1958,C1_10040W_A,2094,C1,2199783,2201525,1742,142.6775617216942,178.87015262984204
1960,C1_10050W_A,91,C1,2202127,2202978,851,12.692260714259648,15.911868578226313
1962,C1_10060C_A,220,C1,2203460,2203972,512,51.00113862731136,63.938445123959696
1964,C1_10070C_A,784,C1,2205458,2207278,1820,51.12953310217733,64.09940904175428
1966,C1_10080W_A,209,C1,2208542,2209030,488,50.83392177935296,63.72881087765163
1968,C1_10090C_A,2005,C1,2209373,2211919,2546,93.47234319298143,117.1831932915305
1970,C1_10100C_A,542,C1,2212261,2212744,483,133.19235811813866,166.9788657602043
1972,C1_10110W_A,323,C1,2213970,2216138,2168,17.68358835464241,22.169331392192134
1974,C1_10120C_A,1468,C1,2216358,2217212,854,204.03061427775845,255.7864507679907
1976,C1_10130W_A,8,C1,2217638,2217738,100,9.495484718975788,11.904175964897222
1978,C1_10140C_A,1305,C1,2217841,2220072,2231,69.42854974374386,87.04028257614789
1980,C1_10150W_A,21,C1,2230403,2232760,2357,1.0575157992071043,1.3257726732225377
1982,C1_10160W_A,7623,C1,2236246,2237169,923,980.2827737371674,1228.948176874479
1984,C1_10170W_A,4,C1,2239042,2239758,716,0.6630925083083651,0.8312972042525995
1986,C1_10180C_A,784,C1,2240080,2242266,2186,42.56896168616776,53.36730304482744
1988,C1_10190W_A,422,C1,2245299,2246132,833,60.13047045930046,75.3835872927165
1990,C1_10200C_A,302,C1,2246376,2248130,1754,20.436405253211863,25.620447130836382
1992,C1_10210C_A,934,C1,2249405,2252335,2930,37.836103786362564,47.43387521848979
1994,C1_10220C_A,860,C1,2255500,2256717,1217,83.87548128922738,105.15192409420307
1996,C1_10230C_A,1032,C1,2259255,2263580,4325,28.321792572205243,35.506097097612525
1998,C1_10240C_A,324,C1,2263977,2264711,734,52.39334211423971,65.68380471094517
2000,C1_10250C_A,514,C1,2264987,2265808,821,74.3099748104987,93.15996415890946
2002,C1_10260C_A,632,C1,2266205,2266927,722,103.89796299156335,130.25344892339066
2004,C1_10270C_A,1221,C1,2267309,2268271,962,150.64951717605817,188.86433021231173
2006,C1_10280C_A,1707,C1,2268532,2269221,689,294.0637230640724,368.65798933380916
2008,C1_10290W_A,982,C1,2271400,2274240,2840,41.04122356529148,51.45202815813853
2010,C1_10300W_A,1796,C1,2276260,2278746,2486,85.74965082100019,107.50150861300992
2012,C1_10310W_A,108,C1,2279973,2281007,1034,12.39739300833396,15.542202662099855
2014,C1_10320W_A,51,C1,2282222,2283286,1064,5.689258936416414,7.132436257163514
2016,C1_10330C_A,130,C1,2283308,2284648,1340,11.51504676741467,14.436034285789543
2018,C1_10340W_A,196,C1,2285484,2287037,1553,14.979998429807265,18.779929886669798
2020,C1_10350C_A,4254,C1,2287135,2289441,2306,218.96027750717153,274.50327707433206
2022,C1_10360C_A,888,C1,2292855,2294669,1814,58.10357242592683,72.84253208950341
2024,C1_10370W_A,6,C1,2295437,2295772,335,2.1258547878304004,2.6651140219919154
2026,C1_10380C_A,2438,C1,2296797,2298995,2198,131.65372921327895,165.04993745688938
2028,C1_10390C_A,4681,C1,2299892,2300570,678,819.4757369012844,1027.3496993304555
2030,C1_10400C_A,277,C1,2301144,2301896,752,43.72089872267775,54.81144850858595
2032,C1_10410W_A,202,C1,2304069,2305031,962,24.92317974575246,31.245368307032727
2034,C1_10420C_A,985,C1,2305152,2307086,1934,60.45147652657156,75.78602201023632
2036,C1_10430W_A,68,C1,2308995,2310503,1508,5.352229450351075,6.70991350806541
2038,C1_10440W_A,1259,C1,2311138,2313651,2513,59.464859038950046,74.54913221152808
2040,C1_10450W_A,2706,C1,2315103,2316224,1121,286.5162985007637,359.19603212546707
2042,C1_10460W_A,628,C1,2316584,2317816,1232,60.50288558762981,75.85047185425584
2044,C1_10470W_A,1705,C1,2318202,2319212,1010,200.3688297754173,251.1957923285862
2046,C1_10480W_A,1140,C1,2319689,2321215,1526,88.6701554688106,111.16284895136661
2048,C1_10490W_A,2075,C1,2321499,2323370,1871,131.6350266693931,165.02649069455995
2050,C1_10500W_A,128,C1,2323932,2324456,524,28.993846470155077,36.34862890044953
2052,C1_10510W_A,116,C1,2325501,2326049,548,25.12491394619506,31.498275819527326
2054,C1_10520W_A,146,C1,2327281,2329134,1853,9.352001949342048,11.724296349669418
2056,C1_10530W_A,211,C1,2330114,2330713,599,41.81025199715967,52.41613373525279
2058,C1_10540C_A,349,C1,2330849,2332411,1562,26.519879696883407,33.247098365469995
2060,C1_10550C_A,204,C1,2332801,2335641,2840,8.525875363869106,10.68860870087603
2062,C1_10560C_A,79,C1,2337547,2339439,1892,4.956020697668389,6.213199664553915
2064,C1_10570C_A,2,C1,2340437,2342245,1808,0.13129818472035104,0.16460420305444168
2066,C1_10580C_A,167,C1,2344169,2344501,332,59.70429021343964,74.84929917687636
2068,C1_10590W_A,1,C1,2346741,2346828,87,1.3642937814620384,1.710370109899026
2070,C1_10600C_A,6,C1,2348535,2348957,422,1.6875861467374031,2.1156710838087482
2072,C1_10610W_A,650,C1,2349806,2351599,1793,43.02889756925727,53.94390948956494
2074,C1_10620W_A,3648,C1,2352465,2353904,1439,300.8993072865156,377.227535788265
2076,C1_10630C_A,161,C1,2354068,2356800,2732,6.994752195072757,8.769090091272204
2078,C1_10640C_A,579,C1,2357212,2359116,1904,36.094312318060545,45.25024871110486
2080,C1_10650W_A,157,C1,2360939,2362294,1355,13.752685432464933,17.241288067240443
2082,C1_10660W_A,1211,C1,2362524,2363240,716,200.75125689035758,251.67522858747446
2084,C1_10670C_A,3151,C1,2364210,2369207,4997,74.84558822666779,93.83144503049617
2086,C1_10680C_A,4529,C1,2369620,2373397,3777,142.32542458380112,178.4286899160032
2088,C1_10690W_A,266,C1,2373907,2374881,974,32.41528407658573,40.637972364767215
2090,C1_10700C_A,587,C1,2374926,2375831,905,76.9868719618617,96.5159018148435
2092,C1_10710C_A,852,C1,2376074,2377636,1562,64.74194126574402,81.16483612429926
2094,C1_10720C_A,1281,C1,2378686,2380479,1793,84.80002736341316,106.31099700943489
2096,C1_10730W_A,624,C1,2381413,2383287,1874,39.52229498826636,49.54779750597564
2098,C1_10740C_A,14063,C1,2383419,2384576,1157,1442.6858427285706,1808.647651192196
2100,C1_10750C_A,266,C1,2386240,2386703,463,68.19111596240712,85.48895266367876
2102,C1_10760W_A,525,C1,2386721,2388169,1448,43.03461220184987,53.95107373593786
2104,C1_10770W_A,299,C1,2388397,2389050,653,54.34819929122819,68.13454466891787
2106,C1_10780C_A,949,C1,2389133,2389591,458,245.93927397128886,308.3259549860116
2108,C1_10790W_A,16198,C1,2390629,2393109,2480,775.2412372881543,971.8943663276472
2110,C1_10800C_A,220,C1,2393472,2395103,1631,16.010167367984927,20.07141870230985
2112,C1_10810W_A,10,C1,2396156,2396764,608,1.9521966938683777,2.447404598046304
2114,C1_10820C_A,407,C1,2396747,2398237,1490,32.42166342804653,40.64596994725814
2116,C1_10830W_A,78,C1,2398464,2399432,968,9.56415041425764,11.990259881998751
2118,C1_10840C_A,1249,C1,2399586,2401076,1490,99.49547327181844,124.73419278654893
2120,C1_10850W_A,44,C1,2403460,2404254,794,6.577476820449224,8.245965718757523
2122,C1_10860C_A,301,C1,2404309,2405646,1337,26.721586578269562,33.4999716289647
2124,C1_10870W_A,5816,C1,2406453,2407245,792,871.6183574110352,1092.7191826363992
2126,C1_10880W_A,860,C1,2407718,2409013,1295,78.82352179844766,98.81844912945571
2128,C1_10890C_A,569,C1,2409010,2409846,836,80.78544864080777,101.27805209369795
2130,C1_10900C_A,1,C1,2410214,2410321,107,1.1092855980111902,1.3906747622543485
2132,C1_10910C_A,614,C1,2410846,2412303,1457,50.01911133708935,62.70730990431448
2134,C1_10920W_A,325,C1,2412526,2414079,1553,24.839283110649802,31.140189863100428
2136,C1_10930C_A,606,C1,2414144,2415460,1316,54.65676044547234,68.5213776094958
2138,C1_10940C_A,1176,C1,2415772,2416490,718,194.40616346649597,243.7205942673944
2140,C1_10950C_A,945,C1,2416729,2418210,1481,75.73626822613201,94.94806116498883
2142,C1_10960W_A,241,C1,2418401,2419166,765,37.39234995544387,46.877555678761944
2144,C1_10970W_A,1681,C1,2419611,2421629,2018,98.87208754087153,123.95267465926803
2146,C1_10980W_A,19,C1,2423223,2423756,533,4.231102477967635,5.304393605371652
2148,C1_10990C_A,1140,C1,2424019,2425581,1562,86.62654113022086,108.60083706772434
2150,C1_11000C_A,473,C1,2426349,2426756,407,137.94116314728342,172.9322859765475
2152,C1_11010C_A,567,C1,2427065,2428255,1190,56.55398987037051,70.89987155563787
2154,C1_11020W_A,376,C1,2429970,2432009,2039,21.887581255118295,27.439738614525233
2156,C1_11030W_A,2360,C1,2432310,2433429,1119,250.32779196584966,313.82769523187494
2158,C1_11040W_A,4019,C1,2433984,2434175,191,2497.5361966991945,3131.0787436467235
2160,C1_11050W_A,105,C1,2434511,2435489,978,12.743173510895424,15.975696271909616
2162,C1_11060C_A,13626,C1,2435729,2436897,1168,1384.6904407187938,1735.940728785205
2164,C1_11070W_A,1036,C1,2438057,2440174,2117,58.085274969644054,72.81959317213936
2166,C1_11080W_A,3361,C1,2441889,2442974,1085,367.67654539720763,460.9439564287968
2168,C1_11090C_A,1016,C1,2443283,2444914,1631,73.93786384487585,92.69346091612185
2170,C1_11100W_A,136,C1,2445467,2446003,536,30.116276160930674,37.755781978218806
2172,C1_11110C_A,112,C1,2446099,2446473,374,35.5445952047222,44.561086499615264
2174,C1_11120C_A,1288,C1,2446811,2447839,1028,148.71333071547681,186.43699711560825
2176,C1_11130W_A,42,C1,2448571,2449272,701,7.111454318776447,8.915395694109902
2178,C1_11140W_A,516,C1,2449578,2451047,1469,41.692223578893014,52.26816540067195
2180,C1_11150W_A,428,C1,2451373,2452068,695,73.09473848420213,91.63646246359734
2182,C1_11160C_A,123,C1,2452098,2452403,305,47.86658280467304,60.00875588862125
2184,C1_11170W_A,1222,C1,2452925,2454238,1313,110.46727272075795,138.4891758292499
2186,C1_11180C_A,1,C1,2454370,2454459,89,1.3336354942381725,1.671934826530509
2188,C1_11190W_A,314,C1,2454869,2455636,767,48.591626495410644,60.91771924670351
2190,C1_11200W_A,23601,C1,2456985,2464640,7655,365.9420882634676,458.76952473471476
2192,C1_11210C_A,1034,C1,2464977,2466881,1904,64.45858192897167,80.8095978709541
2194,C1_11220C_A,4545,C1,2468077,2469486,1409,382.86886131782256,479.9900617499811
2196,C1_11230W_A,184,C1,2469709,2470272,563,38.79150062814266,48.631624723381194
2198,C1_11240C_A,1701,C1,2470408,2471229,821,245.91686216470487,308.29785804339485
2200,C1_11250W_A,1024,C1,2472572,2473468,896,135.6497816996541,170.0596566413889
2202,C1_11260C_A,155,C1,2473804,2473941,137,134.28833316069776,168.35285351816327
2204,C1_11270W_A,5528,C1,2475446,2476084,638,1028.4294578075658,1289.3080864802478
2206,C1_11280W_A,724,C1,2476659,2477750,1091,78.76639478160484,98.74683087288714
2208,C1_11290W_A,286,C1,2477968,2479077,1109,30.609880856932776,38.374597903072655
2210,C1_11300C_A,505,C1,2479082,2480827,1745,34.34971191320038,43.06310073261532
2212,C1_11310C_A,1146,C1,2481346,2483355,2009,67.70672901907822,84.88169273128557
2214,C1_11320C_A,57,C1,2485116,2485428,312,21.684400199584132,27.185017227529713
2216,C1_11330C_A,977,C1,2486989,2487297,308,376.5052179561423,472.0121719847641
2218,C1_11340W_A,95,C1,2487814,2489685,1871,6.026663871610769,7.5554296944497334
2220,C1_11350C_A,862,C1,2489747,2491225,1478,69.22452493028696,86.78450339767765
2222,C1_11360W_A,5373,C1,2491976,2492601,625,1020.3847879011381,1279.2227491878555
2224,C1_11370C_A,447,C1,2492859,2495039,2180,24.337624251044595,30.51127669901983
2226,C1_11380W_A,467,C1,2495591,2496394,803,69.02850815320194,86.538763630246
2228,C1_11390W_A,3,C1,2496926,2497660,734,0.48512353809481207,0.6081833769531961
2230,C1_11400C_A,2401,C1,2497783,2501832,4049,70.38360956489525,88.2376095693944
2232,C1_11410C_A,20,C1,2503463,2503804,341,6.96149906083269,8.727401733795618
2234,C1_11420W_A,529,C1,2504035,2505111,1076,58.35398950207008,73.15647171736329
2236,C1_11430W_A,353,C1,2506060,2508006,1946,21.53074322840733,26.992382551443473
2238,C1_11440C_A,957,C1,2508110,2511814,3704,30.666775364672752,38.445924670648765
2240,C1_11450C_A,4736,C1,2513459,2514616,1157,485.85366928553725,609.0987183421915
2242,C1_11470C_A,89,C1,2517426,2518211,785,13.456976751414732,16.870567848341604
2244,C1_11480W_A,2590,C1,2522233,2523870,1637,187.79249711474716,235.42925892702968
2246,C1_11490C_A,13,C1,2524641,2526899,2258,0.6833552997491433,0.8566999974737817
2248,C1_11500C_A,455,C1,2528376,2529182,806,67.00442846051465,84.00124168778282
2250,C1_11510C_A,628,C1,2529466,2530416,950,78.46268951995782,98.36608560467707
2252,C1_11520C_A,539,C1,2531200,2531787,587,108.98778244309945,136.63438767205287
2254,C1_11530C_A,14,C1,2532303,2533463,1160,1.4325084705351405,1.7958886153939775
2256,C1_11540C_A,7577,C1,2534053,2538045,3992,225.2858458031048,282.4334333856032
2258,C1_11550W_A,1734,C1,2538443,2539003,560,367.5261272925004,460.7553822127631
2260,C1_11560C_A,259,C1,2539189,2540280,1091,28.177481006126598,35.32517844762123
2262,C1_11570W_A,94,C1,2540442,2541055,613,18.200969893632223,22.817955560773633
2264,C1_11580W_A,337,C1,2541281,2541658,377,106.10007792754777,133.01416777753195
2266,C1_11590W_A,4454,C1,2542175,2547307,5132,103.01268739847565,129.1436081148973
2268,C1_11600W_A,230,C1,2547617,2548264,647,42.19400087643801,52.897227046490755
2270,C1_11610C_A,595,C1,2548322,2549842,1520,46.46228131406739,58.24822943350204
2272,C1_11620W_A,109,C1,2550020,2550913,893,14.487791634495535,18.162866463798956
2274,C1_11630C_A,127,C1,2550972,2552126,1154,13.062462730826747,16.375978634553153
2276,C1_11640C_A,352,C1,2552572,2553426,854,48.92287208839985,61.33299091984517
2278,C1_11650W_A,4116,C1,2554159,2554632,473,1032.8598071697766,1294.862269331844
2280,C1_11660W_A,6608,C1,2555723,2557429,1706,459.74621206764374,576.3686604340626
2282,C1_11670W_A,1394,C1,2558239,2559036,797,207.60203416330376,260.2638220681733
2284,C1_11680C_A,106,C1,2559106,2559327,221,56.92994231965122,71.37119073976842
2286,C1_11690W_A,1203,C1,2560903,2562321,1418,100.69700385162089,126.24051203959236
2288,C1_11700C_A,3774,C1,2562559,2563638,1079,415.1524482091593,520.462929697893
2290,C1_11710C_A,11,C1,2564631,2565422,791,1.6506057507701277,2.0693099812558384
2292,C1_11720W_A,366,C1,2568085,2568453,368,118.04848529704955,147.99349195490433
2294,C1_11730W_A,2644,C1,2568686,2572051,3365,93.26174441668643,116.91917255270528
2296,C1_11740W_A,173,C1,2572482,2573666,1184,17.342893331744207,21.742213280481625
2298,C1_11750W_A,380,C1,2574666,2576585,1919,23.503675046969775,29.46578209132976
2300,C1_11760C_A,419,C1,2576806,2577432,626,79.44504986523273,99.5976383644556
2302,C1_11770C_A,4187,C1,2578004,2580928,2924,169.96235686709826,213.07620026087838
2304,C1_11780W_A,24,C1,2583710,2583821,111,25.663472213448077,32.17344855377628
2306,C1_11790W_A,145,C1,2584053,2584727,674,25.53496447053949,32.01234263557302
2308,C1_11800C_A,33,C1,2584789,2585226,437,8.963129168369594,11.236779371899553
2310,C1_11810W_A,574,C1,2585501,2587936,2435,27.979508360842416,35.076986672746436
2312,C1_11820W_A,1,C1,2588555,2588663,108,1.0990144350666422,1.3777981440853266
2314,C1_11830W_A,1,C1,2589041,2589134,93,1.2762748278193263,1.6000236511958632
2316,C1_11850W_A,4341,C1,2593187,2594629,1442,357.31535337269327,447.95447177200805
2318,C1_11860W_A,9230,C1,2595221,2598883,3662,299.1648141594297,375.0530589705126
2320,C1_11870W_A,3734,C1,2600115,2601776,1661,266.8282656581547,334.51379479926425
2322,C1_11880W_A,448,C1,2602121,2602543,422,126.0064322897261,157.9701075910532
2324,C1_11890W_A,287,C1,2603042,2604070,1028,33.13720956160082,41.54302653119532
2326,C1_11900C_A,579,C1,2604245,2605468,1223,56.192617051175205,70.44683037280757
2328,C1_11910W_A,26,C1,2605723,2606970,1247,2.474765464047419,3.102531827258699
2330,C1_11920W_A,916,C1,2607298,2608521,1223,88.8988553003048,111.44956238599607
2332,C1_11930W_A,4055,C1,2610679,2613744,3065,157.0317721674014,196.86555276369592
2334,C1_11940C_A,252,C1,2613981,2615726,1745,17.140846340844547,21.488913632909025
2336,C1_11950W_A,140,C1,2616918,2617940,1022,16.259391642081827,20.383862953591134
2338,C1_11960C_A,75,C1,2618147,2618401,254,35.04731072456615,43.937657350752545
2340,C1_11970C_A,379,C1,2619019,2620410,1391,32.339941665095466,40.54351806879985
2342,C1_11980W_A,80,C1,2620858,2621370,512,18.54586859174959,23.25034368143989
2344,C1_11990W_A,146,C1,2623918,2624403,485,35.730432189960446,44.794064197809135
2346,C1_12000C_A,23,C1,2624649,2626028,1379,1.979660519728455,2.4818350905786453
2348,C1_12010C_A,318,C1,2626511,2629225,2714,13.907351421491807,17.43518771572088
2350,C1_12020W_A,5,C1,2631951,2632376,425,1.3963948116140867,1.750614112484886
2352,C1_12030W_A,3295,C1,2632863,2634254,1391,281.161234265144,352.4825647406214
2354,C1_12040W_A,31,C1,2634434,2634865,431,8.537123732257815,10.702710409275344
2356,C1_12050W_A,4678,C1,2635306,2638164,2858,194.27868052558054,243.56077310964488
2358,C1_12060C_A,113,C1,2638267,2638986,719,18.654203290060227,23.38615931907834
2360,C1_12070C_A,191,C1,2639138,2641018,1880,12.058760514124838,15.117670274570278
2362,C1_12080W_A,636,C1,2641810,2643402,1592,47.417778590362765,59.44610484983224
2364,C1_12090C_A,13,C1,2643534,2644889,1355,1.1387573924970964,1.4276225788160875
2366,C1_12100C_A,693,C1,2645318,2647321,2003,41.06571960964941,51.48273804089975
2368,C1_12110C_A,11,C1,2647733,2648113,380,3.4358661812083446,4.307432092561495
2370,C1_12120W_A,294,C1,2648544,2650742,2198,15.876208526949966,19.903478922200772
2372,C1_12130C_A,750,C1,2650824,2653223,2399,37.10719851621426,46.520070725682146
2374,C1_12140W_A,393,C1,2653555,2654043,488,95.58723090567328,119.83455825319182
2376,C1_12150C_A,124,C1,2654122,2654799,677,21.74003148362256,27.25476033322112
2378,C1_12160W_A,684,C1,2655467,2655976,509,159.50175706727504,199.96209135534627
2380,C1_12170C_A,407,C1,2656050,2657330,1280,37.74084258421041,47.31444939173017
2382,C1_12180C_A,459,C1,2657594,2658760,1166,46.72413685688129,58.576509089706526
2384,C1_12190W_A,222,C1,2659187,2661355,2168,12.154045246844012,15.23712560082555
2386,C1_12200W_A,286,C1,2661669,2664584,2915,11.645405787423138,14.599461089024896
2388,C1_12210W_A,558,C1,2664810,2666372,1562,42.4014122374239,53.15725182788612
2390,C1_12220W_A,71,C1,2666903,2668348,1445,5.832001860270598,7.3113883521427585
2392,C1_12230W_A,2218,C1,2669523,2672528,3005,87.60809112599127,109.83137391906006
2394,C1_12240C_A,530,C1,2672727,2674139,1412,44.55211491729079,55.85351683246749
2396,C1_12250C_A,2666,C1,2674414,2676231,1817,174.15356536041176,218.33058009367085
2398,C1_12260W_A,90,C1,2677427,2678068,641,16.66524229149417,20.892664524975626
2400,C1_12270W_A,88,C1,2678223,2679232,1009,10.351866393333367,12.97779342060153
2402,C1_12280C_A,45,C1,2679385,2680083,698,7.652163545019887,9.59326501469153
2404,C1_12290C_A,968,C1,2680478,2682487,2009,57.19032608243258,71.69762527389567
2406,C1_12300W_A,9,C1,2683626,2683973,347,3.0785072936160693,3.85942304337446
2408,C1_12310C_A,102,C1,2685652,2686530,878,13.78900115796598,17.286815894355307
2410,C1_12320C_A,867,C1,2687249,2687452,203,506.9325893689661,635.5246651210525
2412,C1_12330W_A,17,C1,2687808,2689043,1235,1.6338384637913808,2.048289386672599
2414,C1_12340C_A,1577,C1,2689209,2690219,1010,185.32647774535667,232.33769179013518
2416,C1_12350W_A,1109,C1,2690712,2693726,3014,43.67324383437355,54.751705147109405
2418,C1_12360C_A,706,C1,2693848,2694471,623,134.50666556173567,168.6265696472199
2420,C1_12370W_A,55,C1,2695803,2696300,497,13.135102101198902,16.467044217035898
2422,C1_12380C_A,1090,C1,2696433,2697707,1274,101.5510041570213,127.31114405158922
2424,C1_12390C_A,5442,C1,2698188,2699014,826,781.9980000100824,980.3650968669898
2426,C1_12400C_A,491,C1,2699565,2699942,377,154.58498000719868,193.79809014471275
2428,C1_12410C_A,2068,C1,2700195,2703026,2831,86.70373719022399,108.69761522168605
2430,C1_12420C_A,15,C1,2703220,2703618,398,4.473375338713468,5.608123099040776
2432,C1_12430W_A,819,C1,2704534,2707485,2951,32.94138421230588,41.297526750469444
2434,C1_12440W_A,134,C1,2707766,2708623,857,18.558852863809157,23.266621635009162
2436,C1_12450C_A,1230,C1,2708975,2716906,7931,18.4079028564182,23.077380590126694
2438,C1_12460C_A,42,C1,2718577,2718870,293,17.014093779734775,21.330008128228815
2440,C1_12470W_A,105,C1,2719965,2720702,737,16.910208539560006,21.199770629481147
2442,C1_12480W_A,36,C1,2720860,2721362,502,8.511888692308974,10.671074072119024
2444,C1_12490W_A,1214,C1,2723178,2727197,4019,35.853192488294994,44.947964734340715
2446,C1_12500C_A,2,C1,2727470,2727566,96,2.4727824788999446,3.100045824191985
2448,C1_12510W_A,402,C1,2729345,2733526,4181,11.412296271909433,14.307219379002284
2450,C1_12520W_A,125,C1,2734096,2736375,2279,6.510177653970896,8.16159497373932
2452,C1_12530C_A,204,C1,2736499,2737875,1376,17.59701019868333,22.060791214017385
2454,C1_12540W_A,38,C1,2738222,2738758,536,8.414841868495333,10.549409670384666
2456,C1_12550C_A,585,C1,2738857,2741595,2738,25.360018994707982,31.793019263444464
2458,C1_12560C_A,8,C1,2741867,2742981,1114,0.8523774433550977,1.0685974833839518
2460,C1_12570C_A,344,C1,2743121,2744461,1340,30.47058529223574,38.19996764855079
2462,C1_12580W_A,267,C1,2744834,2746261,1427,22.208255255488226,27.84175703072493
2464,C1_12590W_A,264,C1,2746753,2747097,344,91.09040573436077,114.19703687256056
2466,C1_12600C_A,526,C1,2747573,2749495,1922,32.483252875788665,40.7231826062431
2468,C1_12610W_A,454,C1,2749614,2750276,662,81.40011447158247,102.04863836977606
2470,C1_12620W_A,3888,C1,2752402,2756802,4400,104.8819448505053,131.4870345213648
2472,C1_12630C_A,120,C1,2756957,2757631,674,21.132384389411992,26.492973215646636
2474,C1_12640W_A,17,C1,2758065,2758466,401,5.0318965156667215,6.308322674664987
2476,C1_12650C_A,61,C1,2758614,2759110,496,14.597393343183546,18.300270510552686
2478,C1_12660W_A,118,C1,2759575,2761665,2090,6.701358832769994,8.401272511111676
2480,C1_12670C_A,129,C1,2761699,2764434,2735,5.598343367220643,7.018458407092056
2482,C1_12680W_A,1186,C1,2764631,2766184,1553,90.64427621301745,113.63773900811417
2484,C1_12690C_A,32,C1,2766270,2766920,650,5.843375211677408,7.325646747629061
2486,C1_12700W_A,271,C1,2767655,2769733,2078,15.479285122969435,19.405869143931348
2488,C1_12710C_A,343,C1,2770318,2771721,1403,29.017741078124512,36.378584782250066
2490,C1_12720C_A,12,C1,2772373,2772915,542,2.6279016749932995,3.2945136434217406
2492,C1_12730W_A,122,C1,2774634,2775641,1007,14.379954514834237,18.027674624099568
2494,C1_12740W_A,893,C1,2776562,2779384,2822,37.559655625643956,47.08730127858443
2496,C1_12750C_A,139,C1,2779463,2781025,1562,10.562358962369036,13.241681010889197
2498,C1_12760W_A,366,C1,2781193,2782158,965,45.01745346042926,56.43689641389097
2500,C1_12770W_A,2598,C1,2782398,2785190,2792,110.4462271664537,138.46279171204776
2502,C1_12780W_A,736,C1,2785529,2786701,1172,74.53793465407615,93.44574989509765
2504,C1_12790C_A,199,C1,2787011,2788024,1013,23.316898557208564,29.231626567306854
2506,C1_12800W_A,92,C1,2789387,2789872,485,22.51506685942713,28.22639661779754
2508,C1_12810W_A,472,C1,2790164,2791078,914,61.294704422272595,76.84314900754225
2510,C1_12820C_A,290,C1,2791182,2792130,948,36.30921108258147,45.51966020332535
2512,C1_12830C_A,602,C1,2792654,2796280,3626,19.705880449611918,24.70461228236393
2514,C1_12840W_A,38,C1,2797709,2798062,353,12.777210315902265,16.018367091575584
2516,C1_12850W_A,449,C1,2799737,2799970,233,228.7270728980756,286.74758627890844
2518,C1_12860C_A,190,C1,2800779,2802220,1441,15.650087583322344,19.61999855421992
2520,C1_12870C_A,48,C1,2802305,2802952,647,8.80570453073489,11.03942129665894
2522,C1_12880C_A,143,C1,2803586,2805145,1559,10.887221895554346,13.64895095397934
2524,C1_12890W_A,172,C1,2805473,2806783,1310,15.584192477708356,19.537388033991622
2526,C1_12900W_A,207,C1,2807779,2809950,2171,11.317165688783902,14.18795730500763
2528,C1_12910W_A,16,C1,2811809,2811973,164,11.579859413385106,14.517287762069785
2530,C1_12920C_A,179,C1,2812364,2813373,1009,21.0566373228031,26.398011616905386
2532,C1_12930C_A,65,C1,2813599,2815155,1556,4.958278492395777,6.21603018732583
2534,C1_12940C_A,3,C1,2815280,2815492,212,1.679625834724491,2.1056915032247447
2536,C1_12950W_A,388,C1,2815725,2819678,3953,11.650164656471686,14.605427126170385
2538,C1_12960C_A,2040,C1,2819824,2825022,5198,46.58231249208977,58.39870856192367
2540,C1_12970C_A,926,C1,2827148,2829403,2255,48.740680985430046,61.104583943984636
2542,C1_12980W_A,4,C1,2830700,2830795,95,4.997623536303046,6.265355770998538
2544,C1_12990W_A,5,C1,2830952,2831055,103,5.761823251805698,7.223407745690063
2546,C1_13000W_A,8,C1,2831214,2831305,91,10.434598592281086,13.081512049337608
2548,C1_13010W_A,922,C1,2831895,2835419,3524,31.054330699828594,38.93179001005689
2550,C1_13020C_A,230,C1,2835573,2836151,578,47.231000981064696,59.211947922282896
2552,C1_13030C_A,2659,C1,2836350,2838695,2345,134.5868543057389,168.72709963039293
2554,C1_13040C_A,1,C1,2839166,2839269,103,1.1523646503611393,1.4446815491380123
2556,C1_13050W_A,3740,C1,2839748,2840497,749,592.6754480802646,743.0176586901805
2558,C1_13060C_A,5916,C1,2840957,2843242,2285,307.30463674759716,385.2576860412034
2560,C1_13070C_A,760,C1,2843540,2844841,1301,69.33674468122213,86.92518959763537
2562,C1_13080W_A,13,C1,2848507,2849721,1214,1.271018341708044,1.5934337679537058
2564,C1_13090W_A,4,C1,2853410,2853805,395,1.2019600910095933,1.5068577170755981
2566,C1_13100W_A,5,C1,2854902,2855117,215,2.76031532528366,3.460516268865472
2568,C1_13110C_A,3835,C1,2856152,2859793,3641,125.01779695575442,156.73068808493835
2570,C1_13120C_A,560,C1,2861151,2866055,4904,13.553913750577184,16.992094566533556
2572,C1_13130C_A,901,C1,2866542,2868221,1679,63.69439943267708,79.8515674834157
2574,C1_13140C_A,2867,C1,2868818,2869627,809,420.6358882772495,527.337337629177
2576,C1_13150W_A,9,C1,2871131,2871499,368,2.9028316056651526,3.639184228399287
2578,C1_13160W_A,1506,C1,2874071,2875447,1376,129.90733999616222,162.8605469034813
2580,C1_13170C_A,1841,C1,2875520,2879164,3644,59.96565370346606,75.17696196273253
2582,C1_13180W_A,33,C1,2879441,2880202,761,5.147026868038782,6.4526577996322
2584,C1_13190W_A,567,C1,2880525,2881034,509,132.21856177945168,165.75804941298443
2586,C1_13200C_A,133,C1,2881257,2882471,1214,13.003495342089991,16.30205316444945
2588,C1_13210C_A,10,C1,2882858,2883161,303,3.9172791744949627,4.910963681888294
2590,C1_13220C_A,2005,C1,2883615,2886056,2441,97.49307077809533,122.223846833362
2592,C1_13240W_A,679,C1,2887954,2889222,1268,63.55909034093612,79.68193493853721
2594,C1_13250W_A,1161,C1,2891491,2892429,938,146.91175051613664,184.17841544836986
2596,C1_13260W_A,579,C1,2893242,2893804,562,122.28393354730832,153.30333371164352
2598,C1_13270W_A,267,C1,2894167,2895063,896,35.36962081426528,44.34172687817465
2600,C1_13280C_A,857,C1,2895365,2895955,590,172.40742381699684,216.14150004061273
2602,C1_13290W_A,76,C1,2896606,2898192,1586,5.687711527759772,7.1304963219750075
2604,C1_13300C_A,2913,C1,2898258,2901239,2981,115.98602392811334,145.4078521710232
2606,C1_13310W_A,264,C1,2902523,2904391,1868,16.774678572066435,21.02986117995762
2608,C1_13320C_A,686,C1,2904794,2906515,1721,47.31190090948134,59.31336949389522
2610,C1_13330C_A,498,C1,2907207,2908241,1034,57.16575664953992,71.66682338634934
2612,C1_13350W_A,3828,C1,2911530,2913284,1754,259.04158711687086,324.75189277099895
2614,C1_13360C_A,102,C1,2913583,2914710,1127,10.74245165633907,13.467457280606885
2616,C1_13370W_A,80,C1,2914941,2916115,1174,8.088147120081592,10.139843240968675
2618,C1_13380W_A,95,C1,2916409,2917254,845,13.344246276667159,16.729241370787516
2620,C1_13390W_A,104,C1,2917513,2919603,2090,5.9062823610854185,7.404511365725545
2622,C1_13400C_A,597,C1,2919985,2922180,2195,32.28248506394388,40.471486623255366
2624,C1_13410W_A,350,C1,2925344,2925812,468,88.76655052461341,111.2836962530456
2626,C1_13420C_A,1343,C1,2925999,2930585,4586,34.75914734404842,43.57639642623465
2628,C1_13430C_A,363,C1,2931984,2933711,1727,24.948327685207087,31.276895449172642
2630,C1_13440C_A,4,C1,2935419,2937365,1946,0.2439744275173635,0.3058626918010592
2632,C1_13450W_A,254,C1,2944587,2947346,2759,10.927206952790188,13.699078901249976
2634,C1_13460W_A,7,C1,2951046,2951402,356,2.3338621149168017,2.925885946428391
2636,C1_13470W_A,317,C1,2952022,2954022,2000,18.812929099470782,23.585148630452622
2638,C1_13480W_A,10779,C1,2955558,2957528,1970,649.4405443263961,814.1821873453501
2640,C1_13490C_A,175,C1,2957814,2959928,2114,9.825625743973292,12.318062877584047
2642,C1_13500C_A,14,C1,2960256,2960366,110,15.106452962006935,18.93846176233649
2644,C1_13510C_A,190,C1,2960894,2962522,1628,13.852442387940723,17.366350071640603
2646,C1_13520C_A,183,C1,2963189,2964004,815,26.651437171358427,33.41202763153668
2648,C1_13540W_A,145,C1,2966485,2968239,1754,9.812181330184501,12.301208059507536
2650,C1_13550C_A,953,C1,2968355,2969704,1349,83.85097236085922,105.12119805918323
2652,C1_13560W_A,213,C1,2969916,2971433,1517,16.665608480074514,20.893123603519353
2654,C1_13570W_A,821,C1,2976150,2978966,2816,34.604904804150934,43.38302764195942
2656,C1_13580W_A,1299,C1,2981409,2983799,2390,64.51168749973614,80.87617457322956
2658,C1_13590W_A,52,C1,2984915,2986141,1226,5.034310821642955,6.31134941042675
2660,C1_13600W_A,21,C1,2986247,2987143,896,2.781880288762438,3.4875515522159835
2662,C1_13610C_A,483,C1,2987589,2989826,2237,25.627621363798085,32.12850352618104
2664,C1_13620W_A,1323,C1,2993143,2996184,3041,51.63813829005659,64.73703058845373
2666,C1_13630W_A,1968,C1,2997002,2998684,1682,138.87569803020477,174.10388153179053
2668,C1_13640W_A,549,C1,2999684,3001459,1775,36.71141627265992,46.023891582595596
2670,C1_13650C_A,234,C1,3001541,3002887,1346,20.63469004680846,25.869030235753627
2672,C1_13660W_A,582,C1,3003281,3005827,2546,27.13262031836169,34.015271070159976
2674,C1_13670W_A,1453,C1,3006268,3008214,1946,88.6237107956823,111.10462279673474
2676,C1_13680C_A,980,C1,3008286,3008819,533,218.23581202148856,273.59503859285365
2678,C1_13690C_A,906,C1,3009398,3009805,407,264.21711165209047,331.240277155924
2680,C1_13700W_A,17252,C1,3011259,3013047,1788,1145.2468006974993,1435.7581358110103
2682,C1_13710C_A,10,C1,3013321,3013620,299,3.9696842470634572,4.976662192682786
2684,C1_13720W_A,1281,C1,3013880,3015796,1916,79.35618427066795,99.48623049995658
2686,C1_13730C_A,247,C1,3015898,3016878,980,29.915621499834437,37.504227848592016
2688,C1_13740W_A,688,C1,3017711,3019987,2276,35.879248059398854,44.98062974433924
2690,C1_13750C_A,92,C1,3020078,3020674,596,18.321824541647914,22.969467046362094
2692,C1_13760W_A,575,C1,3020866,3022500,1634,41.76792926416063,52.363075120990686
2694,C1_13770C_A,137,C1,3022624,3023331,707,23.000024867391847,28.83437247508698
2696,C1_13780W_A,4036,C1,3025935,3030620,4685,102.25127087989938,128.1890453423831
2698,C1_13790C_A,63,C1,3030836,3031201,365,20.486833469023104,25.68366732152483
2700,C1_13800C_A,176,C1,3031379,3033394,2015,10.367278601363145,12.997115197406396
2702,C1_13810W_A,1935,C1,3035056,3037140,2084,110.20731124770963,138.16327070583088
2704,C1_13820C_A,368,C1,3037435,3038457,1022,42.73897231632938,53.58043976372527
2706,C1_13830C_A,1873,C1,3038900,3040153,1253,177.42460972308112,222.43138050930264
2708,C1_13840W_A,828,C1,3041388,3043343,1955,50.270213218107116,63.02210804945588
2710,C1_13850C_A,77,C1,3043435,3044964,1529,5.977373474175407,7.49363594912595
2712,C1_13860C_A,12428,C1,3045790,3047977,2187,674.4963653831225,845.5938436885157
2714,C1_13870W_A,332,C1,3051419,3053002,1583,24.89340592782661,31.208041853647174
2716,C1_13880C_A,4671,C1,3053314,3056847,3533,156.92544976767587,196.732259878414
2718,C1_13890C_A,1,C1,3060917,3060989,72,1.648521652599963,2.06669721612799
2720,C1_13900C_A,1230,C1,3061337,3063046,1709,85.42602548522689,107.09579020497063
2722,C1_13910C_A,334,C1,3063729,3065366,1637,24.217256384681686,30.360375475532013
2724,C1_13920W_A,990,C1,3065854,3066933,1079,108.90326542847579,136.52843147877954
2726,C1_13930W_A,1342,C1,3067395,3069419,2024,78.69899019803302,98.66232796993623
2728,C1_13940W_A,5626,C1,3074020,3075138,1118,597.2897700017642,748.8024818706594
2730,C1_13950C_A,40,C1,3075627,3076121,494,9.610814492890475,12.048761098074113
2732,C1_13960W_A,604,C1,3076534,3078465,1931,37.12631259879193,46.54403342049406
2734,C1_13970C_A,780,C1,3078503,3080161,1658,55.838948136317214,70.00344732071648
2736,C1_13980C_A,290,C1,3080843,3082867,2024,17.006488194805943,21.32047325728875
2738,C1_13990W_A,81,C1,3083624,3084232,608,15.812793220333859,19.823977244175065
2740,C1_14000C_A,726,C1,3084235,3086670,2435,35.38871614977629,44.36566607040752
2742,C1_14010W_A,4,C1,3087546,3088738,1192,0.39830053351408506,0.49933624013830635
2744,C1_14020W_A,55,C1,3089131,3089538,407,16.039670133405046,20.108405346110175
2746,C1_14030W_A,711,C1,3089848,3090855,1007,83.80448901677987,105.06292342405568
2748,C1_14040W_A,449,C1,3091015,3093318,2303,23.14086321548051,29.010936866255175
2750,C1_14050C_A,781,C1,3093320,3096691,3371,27.499160358647618,34.47479022762063
2752,C1_14060W_A,4386,C1,3097094,3098602,1508,345.2187995476443,432.789421270219
2754,C1_14080W_A,1913,C1,3099207,3104663,5456,41.61671157304042,52.173498489846935
2756,C1_14090W_A,2773,C1,3104890,3105271,381,863.8772679041948,1083.0144340767717
2758,C1_14100W_A,440,C1,3105687,3106352,665,78.53408414190501,98.4555906871199
2760,C1_14110C_A,14580,C1,3106574,3107665,1091,1586.2072319278986,1988.5756824954342
2762,C1_14120C_A,121,C1,3108041,3108856,815,17.621988512209672,22.092105701726442
2764,C1_14130W_A,436,C1,3113601,3114746,1145,45.196848662373846,56.661798260864515
2766,C1_14140C_A,17566,C1,3115346,3118555,3209,649.7261007071078,814.5401799602081
2768,C1_14150C_A,811,C1,3119756,3120121,365,263.72733243456724,330.62625710724814
2770,C1_14160W_A,488,C1,3120934,3122688,1754,33.02306544227611,41.399927814066736
2772,C1_14170W_A,1921,C1,3123050,3124726,1676,136.04434774129243,170.55431107225212
2774,C1_14180W_A,273,C1,3125262,3126833,1571,20.625933547743397,25.858052501726146
2776,C1_14190C_A,225,C1,3126893,3127267,374,71.40655286662943,89.52003984297711
2778,C1_14200W_A,442,C1,3127604,3128596,992,52.88563817776334,66.30098004642859
2780,C1_14210C_A,3674,C1,3128660,3131260,2600,167.72312912267813,210.26895430304037
2782,C1_14220C_A,1139,C1,3132914,3134062,1148,117.76303457005034,147.6356317946204
2784,C1_14230C_A,887,C1,3135405,3138674,3269,32.20593050524443,40.37551269831691
2786,C1_14240W_A,1255,C1,3139007,3140692,1685,88.40380802904018,110.82893795212178
2788,C1_14250C_A,1067,C1,3140868,3143546,2678,47.2912723821283,59.287508189625356
2790,C1_14260C_A,2287,C1,3144084,3144923,839,323.5425141879861,405.6145773498205
2792,C1_14270W_A,119,C1,3145303,3146106,803,17.589705503706707,22.051633558884955
2794,C1_14280C_A,3233,C1,3146581,3147441,860,446.2049723321035,559.3924548621036
2796,C1_14290C_A,3055,C1,3147891,3150121,2230,162.60485323133986,203.85234065449
2798,C1_14300C_A,2212,C1,3150921,3154691,3770,69.64195025986221,87.30781576376876
2800,C1_14310W_A,414,C1,3155030,3156043,1013,48.508522626554495,60.813534667663504
2802,C1_14320C_A,1295,C1,3156047,3156742,695,221.16281854449,277.2645301176601
2804,C1_14330W_A,608,C1,3157023,3158294,1271,56.77866551079149,71.18153999466475
2806,C1_14340C_A,16138,C1,3158465,3160450,1985,964.9756448037234,1209.7581342664444
2808,C1_14350W_A,1229,C1,3162078,3162521,443,329.2875485220441,412.8169373831458
2810,C1_14360C_A,1771,C1,3162712,3164187,1475,142.51274099411967,178.66352232061848
2812,C1_14370W_A,16,C1,3164722,3165045,323,5.8795571015329955,7.371006789410045
2814,C1_14380C_A,629,C1,3165464,3167263,1799,41.49986025733582,52.02700584991907
2816,C1_14390W_A,252,C1,3167371,3167592,221,135.34288174105762,169.67490628699662
2818,C1_14400C_A,905,C1,3167604,3169514,1910,56.23961826356734,70.50575424235593
2820,C1_14410W_A,411,C1,3169513,3169746,233,209.36932508042108,262.47941639338836
2822,C1_14420W_A,2692,C1,3169830,3170801,971,329.06597404071607,412.53915676497587
2824,C1_14430C_A,702,C1,3170798,3171577,779,106.96133300258349,134.09389485490775
2826,C1_14440C_A,7602,C1,3171639,3172988,1349,668.8720796298549,838.5428621677974
2828,C1_14450C_A,2595,C1,3173044,3174396,1352,227.81788873652152,285.6077720868
2830,C1_14460W_A,2234,C1,3174488,3175426,938,282.6880711912568,354.3967098291631
2832,C1_14470W_A,711,C1,3175481,3176209,728,115.92186873612269,145.32742292311
2834,C1_14480W_A,292,C1,3176297,3176611,314,110.37744975879501,138.3765677448244
2836,C1_14490C_A,505,C1,3176578,3177333,755,79.39105601130419,99.52994805087909
2838,C1_14500C_A,2323,C1,3177391,3178053,662,416.5032288931412,522.1563588832373
2840,C1_14520W_A,5190,C1,3179521,3180582,1061,580.6028003238023,727.88257843799
2842,C1_14530W_A,609,C1,3181102,3181422,320,225.88867944751001,283.18918603993785
2844,C1_14550C_A,193,C1,3182585,3182917,332,68.99956892930449,86.50248347986312
2846,C1_14560C_A,556,C1,3183132,3184109,977,67.54720450039072,84.68170210443776
2848,C1_14570C_A,308,C1,3184381,3185097,716,51.05812313974412,64.00988472745016
2850,C1_14580C_A,354,C1,3185175,3185702,527,79.72963924377203,99.95441868058863
2852,C1_14590C_A,264,C1,3186463,3186663,200,156.67549786310053,196.41890342080418
2854,C1_14630C_A,1856,C1,3187660,3188340,680,323.96359629446806,406.1424740964935
2856,C2_00010W_A,20,C2,4248,4778,530,4.479002225931976,5.615177341932652
2858,C2_00030W_A,1853,C2,5665,7335,1670,131.7000986845968,165.10806933349218
2860,C2_00040C_A,3,C2,7396,7467,71,5.015220802275945,6.287416882868251
2862,C2_00050C_A,8,C2,7510,8043,533,1.781516832828478,2.2334288864722747
2864,C2_00060C_A,1672,C2,8144,9289,1145,173.32369487038775,217.29019883524188
2866,C2_00070C_A,2781,C2,9360,11063,1703,193.82665152283963,242.99407925997633
2868,C2_00080C_A,378,C2,11100,12443,1343,33.40742017659017,41.88178066577765
2870,C2_00090W_A,173,C2,12627,13253,626,32.80189409710086,41.122652594393365
2872,C2_00100C_A,3904,C2,13261,14415,1154,401.54216142635914,503.40016212043713
2874,C2_00110W_A,343,C2,14823,15446,623,65.34813921767045,81.92480649999493
2876,C2_00120C_A,1608,C2,15457,17610,2153,88.64804591333643,111.13513093099591
2878,C2_00130W_A,13,C2,18818,19147,329,4.690019048126339,5.879722171111851
2880,C2_00140W_A,3945,C2,19683,21197,1514,309.2774704124792,387.73096252905833
2882,C2_00150W_A,745,C2,21533,22759,1226,72.12618388700002,90.42221751476785
2884,C2_00160C_A,1076,C2,22785,23423,638,200.17910575270272,250.95794157972986
2886,C2_00170C_A,1138,C2,23503,24807,1304,103.58379610999278,129.8595882673796
2888,C2_00180C_A,842,C2,24905,25816,911,109.70359678070272,137.53178049455903
2890,C2_00190C_A,1064,C2,26026,27414,1388,90.98699334465273,114.06739217084515
2892,C2_00200W_A,507,C2,27574,28386,812,74.11038720013431,92.9097477555864
2894,C2_00210W_A,3182,C2,28553,28789,236,1600.3512910900931,2006.3076228974026
2896,C2_00220C_A,1490,C2,28893,30038,1145,154.45712042875465,193.6377968089177
2898,C2_00230W_A,582,C2,30161,31549,1388,49.76920124679313,62.394005867887095
2900,C2_00240C_A,244,C2,31623,32573,950,30.485503571448582,38.21867020309109
2902,C2_00250W_A,4021,C2,33340,33609,269,1774.2260248606713,2224.288641024709
2904,C2_00260C_A,1954,C2,33671,34845,1174,197.5529934079929,247.66567116065985
2906,C2_00270C_A,347,C2,34967,35674,707,58.255537437846506,73.03304561208162
2908,C2_00280C_A,223,C2,35745,36395,650,40.72102100637694,51.050600772540015
2910,C2_00290W_A,388,C2,36538,37167,629,73.2163766089548,91.78895616812645
2912,C2_00300C_A,316,C2,37264,38145,881,42.57339913729213,53.37286613092398
2914,C2_00310W_A,1,C2,37590,38036,446,0.26612905602510617,0.33363721874711944
2916,C2_00320W_A,281,C2,38515,39114,599,55.68095171185719,69.80537241519448
2918,C2_00330C_A,1510,C2,39143,41932,2789,64.2621993799455,80.56339954730551
2920,C2_00340C_A,3915,C2,42098,43573,1475,315.04087012534075,394.9563466319714
2922,C2_00350W_A,894,C2,44274,47528,3254,32.60972395038551,40.88173522056744
2924,C2_00360C_A,1938,C2,47572,49671,2099,109.58938414349142,137.3885958788162
2926,C2_00370W_A,414,C2,50247,53261,3014,16.303627545023126,20.439320045900175
2928,C2_00380C_A,4082,C2,53348,55222,1874,258.54167971490904,324.1251753515906
2930,C2_00390C_A,971,C2,55482,56696,1214,94.9352930614239,119.0172452833114
2932,C2_00400C_A,1428,C2,57065,57796,731,231.8664873238274,290.6833665846996
2934,C2_00410C_A,2008,C2,59132,62923,3791,62.86907582334273,78.81688649931952
2936,C2_00420W_A,321,C2,63244,64164,920,41.41373090748951,51.91902832516316
2938,C2_00430C_A,536,C2,64196,64981,785,81.0442644804303,101.60252097428202
2940,C2_00440W_A,137,C2,65221,66279,1058,15.369581834826121,19.26833775036531
2942,C2_00450C_A,580,C2,66331,68124,1793,38.39501629256802,48.134565390688714
2944,C2_00460W_A,68,C2,69092,70399,1307,6.175334361996496,7.741812984057108
2946,C2_00470W_A,956,C2,70659,74444,3785,29.979139337321183,37.583858066188064
2948,C2_00480C_A,226,C2,74565,74909,344,77.9789079392634,97.75958459544957
2950,C2_00490W_A,603,C2,75586,77595,2009,35.62579197077153,44.662880206775924
2952,C2_00500W_A,492,C2,78116,80620,2504,23.321577884065935,29.23749288503112
2954,C2_00510W_A,269,C2,80938,81942,1004,31.80136191987658,39.86831840833357
2956,C2_00520W_A,1875,C2,82824,84179,1355,164.2438546870812,205.90710271385876
2958,C2_00530W_A,35,C2,84514,84822,308,13.487904430363335,16.90934085922901
2960,C2_00540W_A,694,C2,84801,86633,1832,44.963608044276725,56.369392191857756
2962,C2_00550W_A,165,C2,87920,89629,1709,11.459588784603605,14.366508442130206
2964,C2_00560W_A,5,C2,89853,90329,476,1.2467810817982916,1.563048314718648
2966,C2_00570W_A,754,C2,90640,92419,1779,50.3063201103692,63.06737406922784
2968,C2_00580C_A,733,C2,92547,94091,1544,56.34869089223812,70.64249499894483
2970,C2_00590W_A,253,C2,95115,96695,1580,19.005993939089194,23.82718765125789
2972,C2_00600C_A,785,C2,96803,97516,713,130.679444326718,163.8285086333156
2974,C2_00610C_A,1144,C2,97951,98402,451,301.07634474801284,377.44948181381443
2976,C2_00620C_A,305,C2,98606,99577,971,37.28273480030401,46.74013477463508
2978,C2_00630C_A,242,C2,99682,100710,1028,27.941479839398603,35.02931156985807
2980,C2_00640W_A,130,C2,101391,104714,3323,4.643443475274046,5.82133191181402
2982,C2_00650W_A,575,C2,105000,108470,3470,19.66824104254711,24.657424999336826
2984,C2_00660C_A,403,C2,108666,109364,698,68.52937574762254,85.91301779823748
2986,C2_00670C_A,2,C2,110755,111075,320,0.7418347436699835,0.9300137472575956
2988,C2_00680C_A,267,C2,111314,112000,686,46.19705575740772,57.91572490210566
2990,C2_00690W_A,120,C2,115251,116162,911,15.634716880860244,19.600728811576104
2992,C2_00700W_A,4458,C2,117031,119571,2540,208.32121494682121,261.1654352928731
2994,C2_00710W_A,1288,C2,119808,121157,1349,113.32639286546343,142.07356044095278
2996,C2_00720C_A,761,C2,121277,122833,1556,58.04999896481825,72.77536880853782
2998,C2_00730C_A,1245,C2,123700,126801,3101,47.65349272462454,59.74161188446083
3000,C2_00740C_A,2173,C2,127116,128738,1622,159.01424394524037,199.3509122358328
3002,C2_00750W_A,447,C2,130083,130937,854,62.12648813498504,77.8859288101443
3004,C2_00760C_A,5980,C2,131108,131473,365,1944.6232403929864,2437.9100092494996
3006,C2_00770W_A,363,C2,132166,132792,626,68.82709570663361,86.28625948996988
3008,C2_00780W_A,940,C2,133183,134364,1181,94.47243475695642,118.43697509529414
3010,C2_00790C_A,500,C2,134595,135632,1037,57.22929555795437,71.74648001987237
3012,C2_00800C_A,253,C2,136177,137634,1457,20.61048073010359,25.83867981399277
3014,C2_00810C_A,172,C2,137837,138739,902,22.63336158070726,28.37469880768185
3016,C2_00820W_A,442,C2,138889,140388,1499,34.99836762664525,43.87629900337369
3018,C2_00830C_A,707,C2,140471,142381,1910,43.93525979264321,55.080185910879166
3020,C2_00840W_A,693,C2,142772,144541,1769,46.49781592884555,58.2927780078701
3022,C2_00850W_A,1321,C2,144760,146100,1340,117.0105906134983,146.69231762713835
3024,C2_00860C_A,29,C2,146138,147394,1256,2.740535995723506,3.4357195758560852
3026,C2_00870W_A,242,C2,148523,148981,458,62.715810643890315,78.6247429995941
3028,C2_00880W_A,515,C2,149617,150696,1079,56.651698682489936,71.02236587027421
3030,C2_00890W_A,258,C2,150838,151794,956,32.03236215344866,40.15791578116479
3032,C2_00900W_A,29,C2,152002,152691,689,4.995810175077973,6.263082419847959
3034,C2_00910W_A,30,C2,152901,153590,689,5.168079491459972,6.47905077915306
3036,C2_00920W_A,248,C2,153786,154454,668,44.065872198839735,55.243930376020046
3038,C2_00930C_A,479,C2,154508,155250,742,76.62293093647915,96.05964095663359
3040,C2_00940W_A,1457,C2,155804,156277,473,365.6163117216629,458.3611094306357
3042,C2_00950C_A,558,C2,156333,157421,1088,60.87408631880159,76.31583396613799
3044,C2_00960C_A,1061,C2,157848,158405,557,226.0931168499397,283.4454824675932
3046,C2_00970C_A,1567,C2,158667,160769,2102,88.48373307941877,110.92913735129609
3048,C2_00980W_A,3,C2,161335,161679,344,1.0351182469813722,1.2976936008245519
3050,C2_00990W_A,6,C2,163138,163450,312,2.282568442061488,2.8615807607926014
3052,C2_01000W_A,12054,C2,164439,166079,1640,872.3976585559006,1093.6961667749324
3054,C2_01010W_A,7515,C2,167263,168915,1652,539.9407359496297,676.9058896504437
3056,C2_01020W_A,884,C2,170189,171841,1652,63.5139867703889,79.62539007997235
3058,C2_01030W_A,1562,C2,172317,172958,641,289.23453843682097,362.6037998667992
3060,C2_01040W_A,25,C2,173128,173500,372,7.97671767387079,10.000147819974146
3062,C2_01050W_A,87,C2,173661,173918,257,40.18030985169716,50.37272903434137
3064,C2_01060C_A,136,C2,173925,174374,449,35.951723880309224,45.07149029025675
3066,C2_01070W_A,819,C2,174572,175753,1181,82.31162134675245,103.19136447132543
3068,C2_01080C_A,2,C2,175896,176014,118,2.0117552370711413,2.522071179003649
3070,C2_01090C_A,233,C2,176492,176908,416,66.47980587504082,83.34353965808452
3072,C2_01110C_A,2857,C2,178287,179666,1379,245.90826542887802,308.2870805992691
3074,C2_01120W_A,13236,C2,180775,182838,2063,761.5259072974039,954.6999095454414
3076,C2_01130W_A,925,C2,183377,185773,2396,45.822847271768595,57.446592067664504
3078,C2_01140C_A,6,C2,185863,186258,395,1.8029401365143902,2.2602865756133967
3080,C2_01150W_A,285,C2,186639,188039,1400,24.16261736525089,30.291876339247402
3082,C2_01160W_A,373,C2,188329,189579,1250,35.418158001779695,44.40257634906664
3084,C2_01170C_A,885,C2,189661,192597,2936,35.777860934492395,44.853524050298205
3086,C2_01180W_A,75,C2,193352,193537,185,48.11901040021515,60.325216038330524
3088,C2_01190C_A,116,C2,193702,194592,890,15.4701717331628,19.394443987753903
3090,C2_01200C_A,5215,C2,195354,198389,3035,203.94955852330614,255.6848338424177
3092,C2_01210C_A,907,C2,201446,203062,1616,66.61822896125494,83.5170761151128
3094,C2_01220W_A,817,C2,204898,207780,2882,33.64768830414304,42.18299689157283
3096,C2_01230W_A,51,C2,208012,208767,755,8.017710607082206,10.051539308108582
3098,C2_01240C_A,284,C2,208760,211288,2528,13.334244759637679,16.716702798807415
3100,C2_01250W_A,176,C2,211504,212085,581,35.955363824004706,45.07605356759706
3102,C2_01260W_A,180,C2,212467,214584,2117,10.092036191636998,12.652052867746221
3104,C2_01270W_A,377,C2,215536,216597,1061,42.17480842429161,52.87316610233569
3106,C2_01290C_A,1,C2,216899,217014,115,1.0321179042364987,1.2939321700975241
3108,C2_01300C_A,326,C2,219289,221418,2129,18.17477699850932,22.78511839218233
3110,C2_01310W_A,656,C2,223575,225620,2045,38.07480425212786,47.73312611841429
3112,C2_01320W_A,117,C2,225984,227225,1241,11.190287188962202,14.028893915118605
3114,C2_01330C_A,256,C2,227542,229101,1559,19.490411225607776,24.434485623907065
3116,C2_01340W_A,698,C2,230474,232207,1733,47.80617667228146,59.93302671305728
3118,C2_01350C_A,645,C2,232520,234412,1892,40.463713291090016,50.728022577687035
3120,C2_01360C_A,1642,C2,235005,236363,1358,143.51607058687634,179.92136353425295
3122,C2_01370C_A,1295,C2,237215,239071,1856,82.8168959528128,103.82481057746432
3124,C2_01380W_A,648,C2,241111,243219,2108,36.486445077658395,45.741852616540555
3126,C2_01390W_A,1522,C2,243991,245559,1568,115.21147753731785,144.4368289108225
3128,C2_01400C_A,359,C2,245788,248499,2711,15.717811758171836,19.704902118213308
3130,C2_01410C_A,1136,C2,248998,250476,1478,91.22860826079581,114.37029682106939
3132,C2_01420C_A,321,C2,254547,256163,1616,23.577124031491554,29.557862660365167
3134,C2_01430W_A,621,C2,256700,257266,566,130.2273853905469,163.26177725709312
3136,C2_01440C_A,119,C2,257408,257812,404,34.96171663236754,43.83035086085302
3138,C2_01450C_A,206,C2,258044,258733,689,35.487479174691806,44.489482016851014
3140,C2_01460C_A,7,C2,259015,260121,1106,0.751225056880996,0.9417860731722486
3142,C2_01470W_A,1010,C2,260750,265747,4997,23.99049321134067,30.076089965344696
3144,C2_01480W_A,3877,C2,265919,268789,2870,160.33969623462167,201.0125880483734
3146,C2_01490C_A,532,C2,268951,270369,1418,44.531010847100845,55.82705935582972
3148,C2_01500W_A,11,C2,270227,270661,434,3.0083620941455553,3.7714843206759636
3150,C2_01510C_A,184,C2,270663,271475,812,26.896077405965904,33.718725023723664
3152,C2_01520W_A,242,C2,271716,272798,1082,26.546988239280743,33.281083450844825
3154,C2_01530C_A,1570,C2,272823,274967,2144,86.91645877327419,108.96429725331531
3156,C2_01540W_A,826,C2,275532,276701,1169,83.86730515263048,105.14167394145751
3158,C2_01550W_A,3064,C2,277093,279438,2345,155.08616833124634,194.42641341388642
3160,C2_01560W_A,1368,C2,280217,282055,1838,88.3421048392198,110.75158269844533
3162,C2_01570W_A,55,C2,282280,282825,545,11.978249072102486,15.016735735535486
3164,C2_01580W_A,272,C2,283127,283840,713,45.280011282633495,56.76605649460107
3166,C2_01590W_A,1754,C2,284195,284599,404,515.3180754048122,646.0372723524049
3168,C2_01600C_A,1769,C2,285006,286565,1559,134.68178694570372,168.84611354957653
3170,C2_01610C_A,7854,C2,287835,288194,359,2596.710897731053,3255.4107948573396
3172,C2_01620W_A,2419,C2,289871,290344,473,607.0184338055611,760.9989867623251
3174,C2_01630W_A,390,C2,291098,292192,1094,42.313060333644394,53.04648796057949
3176,C2_01640W_A,3887,C2,292446,296219,3773,122.2798472788858,153.29821089171585
3178,C2_01650W_A,36,C2,296539,298170,1631,2.6198455693066243,3.284413969468884
3180,C2_01660C_A,26,C2,298173,298751,578,5.339156632642095,6.693524547736328
3182,C2_01670C_A,2342,C2,299220,301475,2255,123.2728670279451,154.5431269943974
3184,C2_01680C_A,907,C2,301846,304188,2342,45.96714688359863,57.62749573100865
3186,C2_01690W_A,1909,C2,305456,305986,530,427.5207624652071,535.9686772874717
3188,C2_01700C_A,3931,C2,306372,308888,2516,185.44689204239776,232.48865122223265
3190,C2_01710W_A,77,C2,309725,310045,320,28.560637631294366,35.80552926941743
3192,C2_01720C_A,223,C2,310184,310579,395,67.00927507378483,84.00731772696459
3194,C2_01730W_A,61,C2,310853,311611,758,9.551856330104272,11.974847194240281
3196,C2_01740C_A,244,C2,311792,312133,341,84.9302885421588,106.47430115230654
3198,C2_01750C_A,840,C2,314646,315143,497,200.6088320910378,251.49667531473006
3200,C2_01760C_A,40,C2,322580,323239,659,7.2044648854141045,9.031999973366633
3202,C2_01770C_A,2,C2,323374,323492,118,2.0117552370711413,2.522071179003649
3204,C2_01780W_A,1381,C2,327675,331904,4229,38.75994442216116,48.59206374888586
3206,C2_01800W_A,27,C2,332986,333273,287,11.166293005764212,13.99881319913872
3208,C2_01820C_A,174,C2,334153,335997,1844,11.19993452482231,14.040988461850032
3210,C2_01830W_A,47,C2,336552,338495,1943,2.8711257191962307,3.599435604414369
3212,C2_01840C_A,574,C2,338553,340511,1958,34.795762440577775,43.62229956493237
3214,C2_01850W_A,1657,C2,341194,342629,1435,137.05590748556517,171.8224701553545
3216,C2_01860C_A,57,C2,342785,343582,797,8.488748886160915,10.642064460463327
3218,C2_01870C_A,160,C2,343945,345300,1355,14.015475599964265,17.570739431582616
3220,C2_01880C_A,165,C2,345450,346557,1107,17.691451881560578,22.179189636495504
3222,C2_01890W_A,687,C2,350675,354109,3434,23.74562464304152,29.769106318740505
3224,C2_01900C_A,407,C2,354235,355758,1523,31.71915857372904,39.765262784907826
3226,C2_01910W_A,65,C2,356072,356839,767,10.05877618535571,12.610355895018243
3228,C2_01920C_A,692,C2,357352,359910,2558,32.10943816229107,40.254543430946434
3230,C2_01930C_A,652,C2,360838,361875,1037,74.6270014075725,93.55740994591356
3232,C2_01940C_A,8,C2,364136,364561,425,2.2342316985825383,2.8009825799758175
3234,C2_01950C_A,117,C2,365021,366994,1973,7.038594222758283,8.824053395165834
3236,C2_01960C_A,31,C2,367186,367519,333,11.049550536345699,13.852457016209229
3238,C2_01970C_A,1473,C2,369820,372591,2771,63.09477170268556,79.09983397822812
3240,C2_01980C_A,411,C2,374511,376388,1877,25.989905564058663,32.58268727738918
3242,C2_01990C_A,1924,C2,377896,385770,7874,29.002591756587215,36.35959257756899
3244,C2_02000W_A,791,C2,386830,387852,1022,91.86556277776234,115.1688256877899
3246,C2_02010C_A,177,C2,388066,389232,1166,18.01780440886272,22.588327034592712
3248,C2_02020W_A,1238,C2,389582,391966,2384,61.63700756130467,77.2722831614029
3250,C2_02030W_A,2826,C2,392597,393825,1228,273.14983525881087,342.43893807817136
3252,C2_02040W_A,974,C2,394268,397570,3302,35.01136476484864,43.89259308680306
3254,C2_02050C_A,490,C2,398041,401169,3128,18.593300480731042,23.309807476021575
3256,C2_02060C_A,347,C2,402391,404049,1658,24.8411730811565,31.142559256780277
3258,C2_02070W_A,9,C2,405503,406978,1475,0.7242318853456109,0.9079456244413135
3260,C2_02080W_A,6,C2,407445,407548,103,6.914187902166836,8.668089294828075
3262,C2_02090W_A,585,C2,408135,409331,1196,58.05663211330305,72.78368456798573
3264,C2_02100W_A,2250,C2,410199,415271,5072,52.65388559171806,66.01043947411955
3266,C2_02110C_A,56,C2,415440,415994,554,11.997904879572296,15.04137757297483
3268,C2_02120W_A,403,C2,416496,417551,1055,45.33981447567823,56.84102978499503
3270,C2_02130C_A,44,C2,417791,418816,1025,5.095138141889448,6.387606615310705
3272,C2_02140C_A,14,C2,418909,419430,521,3.189462237659814,3.9985235966545374
3274,C2_02150C_A,596,C2,419670,422045,2375,29.785836276366155,37.34152039515129
3276,C2_02160W_A,190,C2,422849,423919,1070,21.076426362212615,26.42282048283262
3278,C2_02170W_A,286,C2,424993,426369,1376,24.67031821972271,30.928364152985157
3280,C2_02180W_A,270,C2,427326,429101,1775,18.054794888193403,22.634700778325705
3282,C2_02190C_A,219,C2,429572,430366,794,32.737895992690454,41.04242028199767
3284,C2_02200W_A,397,C2,433118,434554,1436,32.81430565314579,41.13821255278724
3286,C2_02210C_A,179,C2,434764,436032,1268,16.755636481631175,21.005988739319825
3288,C2_02220C_A,49,C2,437551,438750,1199,4.850695905231585,6.08115744662181
3290,C2_02230C_A,21,C2,443447,446347,2900,0.8595050823210844,1.0775331692363865
3292,C2_02240C_A,782,C2,448737,450545,1808,51.337590225657266,64.3602433942867
3294,C2_02250C_A,520,C2,451417,452715,1298,47.55057833077244,59.61259150372261
3296,C2_02260W_A,1087,C2,455522,456319,797,161.8819305132792,202.94603628988835
3298,C2_02270C_A,469,C2,456427,456894,467,119.20188258029029,149.43946808182008
3300,C2_02280W_A,778,C2,457206,458084,878,105.17493040095621,131.8543408412591
3302,C2_02290C_A,90,C2,458105,459010,905,11.803779346793108,14.798008796142957
3304,C2_02300W_A,156,C2,459062,459790,728,25.43433406868515,31.886185620260417
3306,C2_02310W_A,811,C2,460211,460957,746,129.03549107053223,161.7675386650745
3308,C2_02320C_A,1571,C2,461263,461838,575,324.29144551110795,406.5534878446421
3310,C2_02330W_A,14,C2,461588,462091,503,3.3035980632619544,4.1416119162167275
3312,C2_02340C_A,2553,C2,462350,463794,1444,209.8508698714092,263.08311321314585
3314,C2_02350C_A,1117,C2,464454,468125,3671,36.115692015445234,45.27705173246458
3316,C2_02360C_A,158,C2,468489,469331,842,22.272663087858888,27.922503005548712
3318,C2_02370C_A,2772,C2,469529,470626,1097,299.92574796035655,376.007016575833
3320,C2_02380W_A,1817,C2,471161,472777,1616,133.45680487607524,167.31039393733178
3322,C2_02390W_A,327,C2,474604,475146,542,71.6103206435674,89.77549678324242
3324,C2_02400W_A,786,C2,476572,478212,1640,56.88605936825434,71.31617613116782
3326,C2_02410W_A,977,C2,478612,479181,569,203.8024729885621,255.50043755941533
3328,C2_02420C_A,1758,C2,479261,481102,1841,113.34235562166917,142.09357242184493
3330,C2_02430W_A,1545,C2,481327,484155,2828,64.84496062065769,81.293988091258
3332,C2_02440W_A,393,C2,484479,487583,3104,15.027889394964097,18.83996920990902
3334,C2_02450C_A,2496,C2,487815,491342,3527,83.99748319592986,105.30487386016254
3336,C2_02460W_A,4485,C2,491786,493972,2186,243.52269536028368,305.29637009700394
3338,C2_02470C_A,4,C2,494231,495081,850,0.5585579246456346,0.7002456449939544
3340,C2_02480W_A,1,C2,496117,496190,73,1.6259391642081829,2.038386295359113
3342,C2_02490C_A,1305,C2,496573,500625,4052,38.22682489592609,47.92370938484352
3344,C2_02500W_A,785,C2,501159,502925,1766,52.76016070495466,66.14367307789014
3346,C2_02510W_A,920,C2,503320,504282,962,113.51151171332805,142.30563783401047
3348,C2_02520W_A,376,C2,504703,506571,1868,23.891208875367347,29.95162046842449
3350,C2_02530W_A,10,C2,507675,509003,1328,0.8937767996023898,1.1204984906718019
3352,C2_02540W_A,1650,C2,509371,514539,5168,37.89558288097439,47.50844219736943
3354,C2_02550C_A,1711,C2,514896,517007,2111,96.20306936385347,120.60661461356672
3356,C2_02560W_A,13,C2,517641,517973,332,4.647639357932427,5.8265921514933705
3358,C2_02570W_A,398,C2,519036,520763,1727,27.35381382565405,34.29257407374851
3360,C2_02580W_A,363,C2,521088,522620,1532,28.12386547803697,35.25796242866916
3362,C2_02590W_A,1989,C2,524004,525116,1112,212.30349714526577,266.1578911216342
3364,C2_02600C_A,192,C2,525523,526410,887,25.692405102076542,32.20972076184142
3366,C2_02610C_A,242,C2,526810,528321,1511,19.0098221541375,23.831986958182725
3368,C2_02620W_A,435,C2,529061,529480,419,123.2260099270426,154.4843837926698
3370,C2_02630W_A,402,C2,530019,531332,1313,36.3402975726225,45.55863231044063
3372,C2_02640C_A,1,C2,532052,533413,1361,0.08721055032123244,0.1093329901258011
3374,C2_02650C_A,1,C2,586142,586920,778,0.15256241515063926,0.1912624673023333
3376,C2_02660W_A,186,C2,536192,536950,758,29.12533241638352,36.51346849391299
3378,C2_02670C_A,51,C2,536947,537440,493,12.278644033158347,15.393330989091236
3380,C2_02680W_A,657,C2,537502,538596,1094,71.28123240821634,89.36292971820698
3382,C2_02690W_A,495,C2,538929,539834,905,64.92078640736209,81.38904837878627
3384,C2_02700C_A,272,C2,539908,540801,893,36.15302132644757,45.3238502582873
3386,C2_02710C_A,801,C2,540983,541825,842,112.91394388212005,141.55648675597797
3388,C2_02720W_A,2593,C2,542265,545273,3008,102.31795161363124,128.27264077866732
3390,C2_02730W_A,1334,C2,545624,546715,1091,145.13034618599568,181.94512760280585
3392,C2_02740C_A,564,C2,546837,547478,641,104.43551836003012,130.92736435651392
3394,C2_02750C_A,25,C2,548118,549434,1316,2.25481685006074,2.8267895053422354
3396,C2_02760W_A,2001,C2,550317,553115,2798,84.88413564452534,106.41644078698778
3398,C2_02770W_A,2198,C2,553446,555599,2153,121.17438116760789,151.9123244939857
3400,C2_02780C_A,104,C2,555635,556579,944,13.076409040962421,16.393462663523717
3402,C2_02790C_A,39,C2,556999,558633,1634,2.8329552022648086,3.551582486467195
3404,C2_02800W_A,152,C2,560211,560501,290,62.211796434668955,77.9928770113956
3406,C2_02810C_A,311,C2,560749,561198,449,82.21313328511889,103.06789323727828
3408,C2_02820C_A,354,C2,561952,563013,1061,39.601809501854724,49.647482228718395
3410,C2_02830C_A,2597,C2,563521,564555,1034,298.1113855800305,373.7324103099382
3412,C2_02840C_A,359,C2,564861,568430,3569,11.939195202130527,14.967775187020534
3414,C2_02850W_A,112,C2,570077,571711,1634,8.13566622188868,10.19941637139297
3416,C2_02860W_A,1518,C2,572923,573951,1028,175.26928262895484,219.72931802910975
3418,C2_02870W_A,283,C2,574346,575000,654,51.36128011219702,64.38994262358399
3420,C2_02880C_A,429,C2,575277,576455,1178,43.22541324745982,54.19027471287042
3422,C2_02890W_A,1328,C2,577820,579976,2156,73.10994727968372,91.65552922880052
3424,C2_02900W_A,116,C2,580559,580909,350,39.33843669289969,49.31730042600279
3426,C2_02910W_A,567,C2,581973,582236,263,255.8906765997753,320.8017001947113
3428,C2_02920W_A,1269,C2,583204,583761,557,270.41674390440477,339.0125516035587
3430,C2_02930C_A,1665,C2,584177,585442,1265,156.22511914125187,195.85427847385253
3432,C2_02940W_A,850,C2,586142,587827,1685,59.87508910333397,75.06342411099881
3434,C2_02950W_A,110,C2,588152,589513,1361,9.593160535335569,12.02662891383812
3436,C2_02960C_A,1397,C2,589813,591033,1220,135.91385402058583,170.39071539919487
3438,C2_02970C_A,61832,C2,591403,592902,1499,4895.970740024274,6137.917013521724
3440,C2_02980C_A,3011,C2,595308,597062,1754,203.75502058748646,255.44094804949785
3442,C2_02990C_A,1940,C2,597477,601388,3911,58.87637546283889,73.81136976444839
3444,C2_03000C_A,260,C2,602011,603051,1040,29.67338974679934,37.20054989030382
3446,C2_03010C_A,3340,C2,603455,604696,1241,319.44922402678424,400.48295449996704
3448,C2_03020C_A,15090,C2,606159,608219,2060,869.4591286974797,1090.0122288246305
3450,C2_03030W_A,2378,C2,610668,613454,2786,101.31130052819644,127.01063551922826
3452,C2_03040W_A,1804,C2,613973,614860,887,241.40155627159416,302.6371679914683
3454,C2_03050W_A,947,C2,615026,616600,1574,71.41219845036588,89.52711752507679
3456,C2_03060W_A,3366,C2,616878,618113,1235,323.5000158306933,405.5612985611746
3458,C2_03070C_A,291,C2,618202,619698,1496,23.088118760210183,28.9448128825626
3460,C2_03080W_A,5981,C2,620854,621963,1109,640.1318091094927,802.5121330709005
3462,C2_03090C_A,599,C2,622122,622790,668,106.43329615768147,133.43191248079037
3464,C2_03100W_A,68929,C2,623498,626224,2726,3001.2576402892614,3762.577701230744
3466,C2_03110W_A,134,C2,628185,629063,878,18.11496230556315,22.710130684741284
3468,C2_03120W_A,281,C2,630696,632825,2129,15.665988762518769,19.639933338046735
3470,C2_03130W_A,203,C2,633048,633668,620,38.86256850709849,48.72072017891404
3472,C2_03140C_A,1314,C2,633926,636181,2255,69.16334213267288,86.70780054254409
3474,C2_03150C_A,531,C2,636492,638513,2021,31.18569016437496,39.09647103760778
3476,C2_03160C_A,6486,C2,639344,641908,2564,300.25211528508663,376.4161725249775
3478,C2_03170W_A,262,C2,643405,644115,710,43.79959500654325,54.91010744371606
3480,C2_03180C_A,6044,C2,644266,654126,9860,72.75698483961672,91.21303186085042
3482,C2_03200W_A,1033,C2,655510,656850,1340,91.50033315953348,114.71094936323537
3484,C2_03210W_A,151,C2,657092,657531,439,40.8262583304483,51.182533334267674
3486,C2_03220C_A,11280,C2,658895,660025,1130,1184.834818916448,1485.3883283632817
3488,C2_03230C_A,649,C2,663649,664527,878,87.7358995247051,109.99160309251562
3490,C2_03240C_A,2767,C2,665418,669563,4145,79.2340356375332,99.33309678790897
3492,C2_03250W_A,321,C2,672719,674041,1322,28.820448135317967,36.13124512795016
3494,C2_03260W_A,156,C2,674262,674963,701,26.413973184026805,33.11432686383678
3496,C2_03270W_A,6541,C2,675806,676552,746,1040.7165808783618,1304.7120473591276
3498,C2_03280W_A,3097,C2,677031,679187,2156,170.49812253402143,213.74787200421324
3500,C2_03290W_A,256,C2,679560,680408,848,35.832017807455806,44.921418735461216
3502,C2_03300W_A,783,C2,680927,681952,1025,90.6702992068054,113.67036317700641
3504,C2_03310C_A,272,C2,682113,682763,650,49.66868929925797,62.26799735484701
3506,C2_03320W_A,719,C2,683898,691313,7415,11.509193379877937,14.428696086920267
3508,C2_03330C_A,1001,C2,691444,692577,1133,104.86518318286367,131.46602097155915
3510,C2_03340W_A,338,C2,692973,695063,2090,19.195417673527608,24.064661938608022
3512,C2_03350W_A,66,C2,695735,697408,1673,4.682471544025717,5.870260114190202
3514,C2_03360W_A,2841,C2,698119,700455,2336,144.35291142235775,180.9704832848513
3516,C2_03370W_A,523,C2,700790,702436,1646,37.71368854817996,47.28040727248821
3518,C2_03380W_A,8078,C2,702727,706917,4190,228.83211682543683,286.87927638556016
3520,C2_03390C_A,2659,C2,707074,709512,2438,129.4529012907948,162.29083208911874
3522,C2_03400C_A,273,C2,710171,711886,1715,18.89407673673754,23.686880746479165
3524,C2_03410W_A,1627,C2,712666,715701,3035,63.62913359873809,79.76974586032858
3526,C2_03420C_A,568,C2,715773,718100,2327,28.972041901473187,36.32129323195973
3528,C2_03430W_A,332,C2,718272,719168,896,43.980202660434735,55.13652930170031
3530,C2_03440W_A,612,C2,719546,720286,740,98.16278121643889,123.06344071819426
3532,C2_03450W_A,412,C2,720617,721876,1259,38.84173653909874,48.69460382781628
3534,C2_03460C_A,531,C2,721980,723086,1106,56.98578645768698,71.44120069349485
3536,C2_03470C_A,1421,C2,723706,724234,528,319.4385365924383,400.46955601607374
3538,C2_03480C_A,43,C2,724850,725209,359,14.216777260304976,17.823104682819658
3540,C2_03490C_A,787,C2,725206,726486,1280,72.97799290853462,91.49010238646596
3542,C2_03500W_A,1770,C2,728326,731385,3059,68.6785221991956,86.0999977846849
3544,C2_03520C_A,5933,C2,740722,742359,1637,430.1825812284923,539.305711665663
3546,C2_03530W_A,712,C2,747174,748787,1613,52.39294110284223,65.6833019761843
3548,C2_03540W_A,3023,C2,749770,751692,1922,186.68607118537858,234.0421692370207
3550,C2_03550C_A,857,C2,751790,754894,3104,32.77074099614308,41.08359697936904
3552,C2_03560C_A,2373,C2,755206,756342,1136,247.93997841251698,310.8341721467992
3554,C2_03570C_A,145,C2,756676,757386,710,24.240233877667063,30.38918160052988
3556,C2_03580W_A,14,C2,757870,757953,83,20.020600311093528,25.099166191048358
3558,C2_03590C_A,306,C2,758090,758620,530,68.52873405675922,85.91221333156959
3560,C2_03600W_A,617,C2,759431,761515,2084,35.141039297073306,44.05516177028303
3562,C2_03610W_A,212,C2,763392,765050,1658,15.176739749870832,19.026577989733195
3564,C2_03620W_A,398,C2,766541,768199,1658,28.49218122853109,35.71970773544251
3566,C2_03630W_A,4,C2,768418,769167,749,0.633877484577823,0.7946712927167705
3568,C2_03640W_A,267,C2,769687,770991,1304,24.30305233863627,30.467935032856197
3570,C2_03660W_A,1,C2,771703,771774,71,1.6717402674253148,2.0958056276227506
3572,C2_03670W_A,96,C2,773072,774163,1091,10.444162843969703,13.09350243618393
3574,C2_03680W_A,231,C2,775409,776503,1094,25.062351120697066,31.41984286895862
3576,C2_03690C_A,418,C2,776856,779372,2516,19.719359164009735,24.721510101982506
3578,C2_03700W_A,251,C2,782202,783326,1124,26.505412193760264,33.22896093404363
3580,C2_03710W_A,165,C2,785869,788415,2546,7.692237719123159,9.643504684839169
3582,C2_03720W_A,2,C2,789500,789823,323,0.7349446376916244,0.9213758486762557
3584,C2_03730W_A,1,C2,790147,790219,72,1.648521652599963,2.06669721612799
3586,C2_03740W_A,1,C2,790226,790313,87,1.3642937814620384,1.710370109899026
3588,C2_03750W_A,864,C2,790963,792051,1088,94.25664978395083,118.1664525927298
3590,C2_03760C_A,857,C2,792275,795163,2888,35.2217382451621,44.15633137948805
3592,C2_03770C_A,708,C2,795612,798083,2471,34.00851467540903,42.63535301065982
3594,C2_03780C_A,770,C2,798539,800725,2186,41.80880165605762,52.41431549045552
3596,C2_03790C_A,1112,C2,801061,801405,344,383.6838302144287,481.01176137230055
3598,C2_03800C_A,1923,C2,801900,803990,2090,109.20943250353135,136.91226304125215
3600,C2_03810C_A,8877,C2,804382,805193,811,1299.189547631752,1628.7510795374944
3602,C2_03820C_A,8754,C2,805679,806736,1057,983.0117458599108,1232.369399204237
3604,C2_03830W_A,408,C2,807027,808910,1883,25.717988351979034,32.241793638330236
3606,C2_03840C_A,372,C2,809042,809518,476,92.7605124857929,116.29079461506741
3608,C2_03850W_A,1,C2,810292,810364,72,1.648521652599963,2.06669721612799
3610,C2_03860W_A,1,C2,810371,810458,87,1.3642937814620384,1.710370109899026
3612,C2_03870W_A,141,C2,810975,811424,449,37.273478434732354,46.728530374457364
3614,C2_03880C_A,54,C2,811574,812026,452,14.180203949797914,17.777253929879702
3616,C2_03890W_A,52,C2,812259,813371,1112,5.55041822602002,6.958376238474096
3618,C2_03900C_A,949,C2,813428,815788,2360,47.72889299951284,59.836138721861566
3620,C2_03910C_A,301,C2,816220,818748,2528,14.132421382573735,17.71735050155293
3622,C2_03920C_A,250,C2,819247,822291,3044,9.748156947043148,12.220942802333713
3624,C2_03930C_A,458,C2,822952,824469,1517,35.834970346826886,44.925120236675404
3626,C2_03940C_A,1315,C2,825401,827764,2363,66.05248839109798,82.80782582437499
3628,C2_03950W_A,1780,C2,830390,831187,797,265.0872459187093,332.3311357828898
3630,C2_03960W_A,2784,C2,831558,832282,724,456.4128014093335,572.189673450861
3632,C2_03970W_A,290,C2,832702,833439,737,46.70438549021334,58.551747452852695
3634,C2_03980C_A,405,C2,833964,835820,1856,25.90026475744339,32.470307555114324
3636,C2_03990W_A,715,C2,836081,837178,1097,77.36180006913958,96.98593681519502
3638,C2_04000C_A,3,C2,837207,837875,668,0.5330549056311259,0.6682733513228232
3640,C2_04010C_A,107,C2,838065,838634,569,22.32022989741673,27.98213594560639
3642,C2_04020C_A,501,C2,839032,840156,1124,52.90522513575256,66.32553556954524
3644,C2_04030C_A,391,C2,840690,841022,332,139.78669145781376,175.24596394106985
3646,C2_04040C_A,262,C2,841309,846615,5306,5.860857982405901,7.347564320587713
3648,C2_04050C_A,1043,C2,847533,853277,5744,21.55246901525885,27.019619453751318
3650,C2_04060C_A,358,C2,854661,857303,2642,16.083381573586927,20.163204936758163
3652,C2_04070C_A,1,C2,857706,857920,214,0.5546427990055951,0.6953373811271742
3654,C2_04080W_A,1803,C2,858566,860644,2078,102.98579733104756,129.10989692438457
3656,C2_04090W_A,37,C2,860981,862354,1373,3.198588261126221,4.009964591234498
3658,C2_04100W_A,174,C2,862515,863651,1136,18.1801754082503,22.791886200397414
3660,C2_04110W_A,455,C2,864185,867989,3804,14.197047670655836,17.79837034709594
3662,C2_04120C_A,913,C2,868107,869474,1367,79.27375227162486,99.38288822193823
3664,C2_04130W_A,1111,C2,870626,872458,1832,71.98064630719227,90.23976185180688
3666,C2_04140W_A,3868,C2,872931,874619,1688,271.9826339825115,340.97565634050994
3668,C2_04150C_A,280,C2,874851,875207,356,93.35448459667207,117.03543785713562
3670,C2_04160W_A,695,C2,875525,876382,857,96.2567368682639,120.67389579351766
3672,C2_04170C_A,977,C2,876638,876868,230,504.1895962195297,632.0858650926406
3674,C2_04180C_A,269,C2,877101,878081,980,32.580170783220495,40.844685389762155
3676,C2_04190C_A,1195,C2,878553,879968,1415,100.23943674183805,125.6668752478108
3678,C2_04200W_A,1050,C2,880756,883416,2660,46.852720652841064,58.7377103531113
3680,C2_04210W_A,372,C2,884415,885788,1373,32.1587792740258,40.316400755114415
3682,C2_04220C_A,1038,C2,886061,886970,909,135.5378594375257,169.9193433933349
3684,C2_04230W_A,1748,C2,887776,888957,1181,175.67852761187214,220.2423749644406
3686,C2_04240C_A,316,C2,889091,890104,1013,37.0258288647131,46.418060277733495
3688,C2_04250W_A,479,C2,890702,892699,1997,28.469812095577133,35.69166429134808
3690,C2_04260W_A,195,C2,893030,894856,1826,12.675380067088437,15.89070586770919
3692,C2_04270W_A,74,C2,895055,896074,1019,8.619551879345048,10.806047858223682
3694,C2_04280W_A,307,C2,897773,900651,2878,12.661196181052672,15.872923997669593
3696,C2_04290W_A,1,C2,899422,900651,1229,0.09657734661285382,0.12107583365436558
3698,C2_04300C_A,294,C2,900914,901672,758,46.036815754928796,57.714837296830204
3700,C2_04310W_A,9819,C2,902492,903700,1208,964.7781918007375,1209.5105939499776
3702,C2_04320W_A,183,C2,903918,905699,1781,12.195913135686197,15.28961399197215
3704,C2_04330C_A,163,C2,905838,906848,1010,19.155495163280367,24.014612404433752
3706,C2_04340C_A,43,C2,907655,908230,575,8.87621397643389,11.127816662838708
3708,C2_04350C_A,509,C2,908645,910807,2162,27.944043258317972,35.03252524359787
3710,C2_04360W_A,630,C2,911437,914340,2903,25.758505739557126,32.29258895059098
3712,C2_04370W_A,139,C2,914705,915937,1232,13.391562255860743,16.78855985309166
3714,C2_04380C_A,403,C2,916040,917584,1544,30.980248880725732,38.83891607718248
3716,C2_04390W_A,37,C2,918662,919405,743,5.910715588864471,7.410069157153386
3718,C2_04400W_A,1240,C2,920773,921963,1190,123.68068331439054,155.0543928200899
3720,C2_04410W_A,502,C2,922531,924594,2063,28.882291135033,36.20877565667963
3722,C2_04420W_A,220,C2,925532,927565,2033,12.844359555919045,16.10254987873456
3724,C2_04430W_A,13,C2,928590,928910,320,4.821925833854893,6.045089357174371
3726,C2_04440W_A,35,C2,928957,929604,647,6.420826220327522,8.04957802881381
3728,C2_04450W_A,92,C2,929893,930708,815,13.398536720027186,16.797303508750684
3730,C2_04460W_A,1910,C2,931947,933200,1253,180.92952726699676,226.82538001749495
3732,C2_04470W_A,24,C2,935501,936349,848,3.359251669448982,4.2113830064494895
3734,C2_04480W_A,218,C2,937444,938493,1049,24.66653561411728,30.923622025114334
3736,C2_04490W_A,2139,C2,938705,939382,677,375.01554309248917,470.1446157480642
3738,C2_04500W_A,3024,C2,940654,946401,5747,62.45507610532187,78.29786870943362
3740,C2_04510W_A,391,C2,946908,948107,1199,38.706573447868365,48.52515431896178
3742,C2_04520C_A,60,C2,948352,949059,707,10.073003591558473,12.628192324855613
3744,C2_04530W_A,39,C2,949282,950001,719,6.43817635674645,8.071329322513764
3746,C2_04540C_A,338,C2,950284,951336,1052,38.13538302060143,47.809071722139514
3748,C2_04550C_A,3550,C2,952424,953896,1472,286.25145000309146,358.8640003004852
3750,C2_04560W_A,248,C2,955040,956479,1439,20.455873960267507,25.644854406658368
3752,C2_04570W_A,1745,C2,956813,958096,1283,161.4343417245981,202.38490899011745
3754,C2_04580W_A,399,C2,958569,959624,1055,44.88979150321493,56.2768508293127
3756,C2_04590C_A,1259,C2,959841,960128,287,520.680107194709,652.7594747302093
3758,C2_04600C_A,4671,C2,961320,961877,557,995.3637594779154,1247.8547112216097
3760,C2_04610C_A,1,C2,963219,963350,131,0.9060577021923462,1.135894653139048
3762,C2_04620W_A,4232,C2,965382,968297,2915,172.31943109221928,216.03118646417258
3764,C2_04640C_A,257,C2,971681,974749,3068,9.942713383216988,12.464851788537265
3766,C2_04650C_A,289,C2,975240,976046,806,42.55885675843677,53.35463483026205
3768,C2_04660C_A,610,C2,976775,979204,2429,29.807769033425437,37.36901676918127
3770,C2_04670W_A,40,C2,979878,980315,437,10.864398991963146,13.620338632605518
3772,C2_04680W_A,614,C2,981049,981513,464,157.0643215908172,196.90635890212542
3774,C2_04690C_A,135,C2,982318,984330,2012,7.96403104536364,9.984243012308184
3776,C2_04700C_A,83,C2,984870,985955,1085,9.079783775057495,11.383025404221998
3778,C2_04710C_A,172,C2,986357,987391,1034,19.743996272531863,24.752396832233103
3780,C2_04720C_A,392,C2,988585,990066,1481,31.416526078988092,39.38586240918055
3782,C2_04730W_A,113,C2,991582,993189,1607,8.346217900157624,10.463378064976556
3784,C2_04740C_A,24,C2,993261,994097,836,3.4074705929338953,4.2718334802262765
3786,C2_04750W_A,749,C2,995291,996994,1703,52.20286299554363,65.44500732316516
3788,C2_04760W_A,953,C2,997716,1000391,2675,42.28596699618657,53.012521937135766
3790,C2_04770W_A,326,C2,1000715,1001686,971,39.84974277016101,49.95830798862635
3792,C2_04780W_A,2341,C2,1001834,1004284,2450,113.41290677103225,142.18202007053264
3794,C2_04790C_A,864,C2,1004405,1005511,1106,92.72263559216864,116.24330960297469
3796,C2_04800C_A,174,C2,1005765,1007186,1421,14.5339051821058,18.220677497291668
3798,C2_04810W_A,304,C2,1007626,1008294,668,54.01623043728741,67.71836626737941
3800,C2_04820W_A,724,C2,1008544,1009959,1415,60.73083866200063,76.13624910411298
3802,C2_04830W_A,506,C2,1010657,1011961,1304,46.05746997509345,57.74073081133047
3804,C2_04850C_A,2603,C2,1013027,1014433,1406,219.7434808276492,275.4851532417094
3806,C2_04860W_A,166,C2,1015779,1017017,1238,15.91529143123971,19.95247587008218
3808,C2_04870C_A,4197,C2,1017114,1021940,4826,103.22355306035378,129.40796343937436
3810,C2_04880C_A,331,C2,1023076,1023824,748,52.52348666412075,65.8469626400565
3812,C2_04890C_A,1,C2,1023950,1024021,71,1.6717402674253148,2.0958056276227506
3814,C2_04910W_A,21,C2,1026161,1026466,305,8.172343405675884,10.245397346837773
3816,C2_04920W_A,2,C2,1027101,1027171,70,3.3912445424913527,4.251491416034723
3818,C2_04930C_A,872,C2,1027317,1029554,2237,46.26767252428972,58.00425481331235
3820,C2_04940C_A,1106,C2,1030003,1031667,1664,78.89127177875017,98.90338504489429
3822,C2_04950C_A,5239,C2,1032788,1033654,866,718.054914011463,900.201759239269
3824,C2_04960C_A,100,C2,1034743,1035171,428,27.732139950279755,34.76686905635871
3826,C2_04970W_A,27,C2,1036592,1038424,1832,1.7493046357283453,2.193045517550662
3828,C2_04980C_A,270,C2,1038614,1039603,989,32.40370164463427,40.62345185189902
3830,C2_04990W_A,94,C2,1040068,1040901,833,13.393991050175933,16.791604752406048
3832,C2_05000C_A,740,C2,1040957,1041808,851,103.21179042364987,129.39321700975242
3834,C2_05010W_A,1,C2,1042388,1042460,72,1.648521652599963,2.06669721612799
3836,C2_05020W_A,227,C2,1042890,1043339,449,60.00765677081024,75.22961982270795
3838,C2_05030C_A,620,C2,1043453,1044176,723,101.78424145513468,127.60354595844188
3840,C2_05040C_A,1265,C2,1044709,1045575,866,173.38031422494765,217.36118065235257
3842,C2_05050C_A,591,C2,1045870,1047258,1388,50.53882807019714,63.358861628730715
3844,C2_05060C_A,82,C2,1047799,1048197,398,24.454451851633628,30.657739608089585
3846,C2_05070W_A,245,C2,1049141,1051390,2249,12.930156492602647,16.210110668073696
3848,C2_05080C_A,154,C2,1051686,1052672,986,18.538344912807702,23.24091149333383
3850,C2_05090W_A,1448,C2,1052876,1055224,2348,73.19773143673841,91.7655813307665
3852,C2_05100C_A,2054,C2,1055350,1056660,1310,186.10425203030792,233.31276175476043
3854,C2_05110W_A,1766,C2,1056968,1058287,1319,158.91798724138783,199.23023838143
3856,C2_05120C_A,153,C2,1058325,1058669,344,52.79103059604998,66.18237364205214
3858,C2_05130W_A,543,C2,1058903,1060021,1118,57.64812390880873,72.27155130745966
3860,C2_05140W_A,698,C2,1060271,1063651,3380,24.51127342398336,30.72897493897286
3862,C2_05150W_A,296,C2,1063895,1065157,1262,27.83937675135532,34.90130829644986
3864,C2_05160C_A,1897,C2,1065176,1067179,2003,112.41222236580799,140.92749504125084
3866,C2_05170W_A,579,C2,1067412,1068083,671,102.41962839580816,128.4001096064734
3868,C2_05180W_A,4011,C2,1068935,1069132,197,2416.649061409384,3029.6732103555055
3870,C2_05190W_A,838,C2,1069505,1070452,947,105.03189274685468,131.67501925269104
3872,C2_05200C_A,371,C2,1070553,1071908,1355,32.49838404741713,40.74215205698219
3874,C2_05210W_A,68,C2,1072110,1072487,377,21.4089178014043,26.83965403226164
3876,C2_05220C_A,1007,C2,1072541,1075639,3098,38.58115361527041,48.36791961205416
3878,C2_05230C_A,552,C2,1076054,1077037,983,66.65192732546586,83.55932264271702
3880,C2_05240C_A,1,C2,1077341,1077426,85,1.3963948116140865,1.750614112484886
3882,C2_05250C_A,1344,C2,1077700,1079013,1313,121.49592024279761,152.31542742595076
3884,C2_05260W_A,1593,C2,1083758,1086160,2402,78.71725206769584,98.6852222735287
3886,C2_05270W_A,586,C2,1086618,1089464,2846,24.439362461875493,30.638822537903078
3888,C2_05280C_A,54,C2,1089779,1090675,896,7.153406456817698,8.967989705698244
3890,C2_05290C_A,75,C2,1090726,1091367,641,13.887701909578475,17.41055377081302
3892,C2_05300C_A,1981,C2,1091743,1092969,1226,191.78787957066717,240.4381381164498
3894,C2_05310C_A,1,C2,1092308,1092387,79,1.5024501137619917,1.8835721463444972
3896,C2_05320W_A,569,C2,1093474,1095444,1970,34.28255586990624,42.97890941641192
3898,C2_05330C_A,208,C2,1095605,1097107,1502,16.436924280517342,20.606429766133672
3900,C2_05340C_A,618,C2,1097889,1098899,1010,72.6263558951366,91.04926666220896
3902,C2_05350C_A,126,C2,1099417,1100277,860,17.389986549287052,21.80125249385247
3904,C2_05360C_A,216,C2,1100492,1101952,1460,17.560142973448375,22.014571989878423
3906,C2_05370C_A,389,C2,1102511,1104064,1553,29.73071116936238,37.27241186691098
3908,C2_05380W_A,288,C2,1106562,1107680,1118,30.575800526218995,38.331872516663694
3910,C2_05390C_A,28,C2,1107956,1108372,416,7.988989547215207,10.015532662774106
3912,C2_05400W_A,68,C2,1108620,1109912,1292,6.247029420378809,7.831694713748173
3914,C2_05410W_A,5587,C2,1110394,1111214,820,808.7084317822826,1013.8510840835485
3916,C2_05420C_A,2,C2,1111557,1111675,118,2.0117552370711413,2.522071179003649
3918,C2_05430C_A,1,C2,1112160,1112246,86,1.3801576626418297,1.730258134432736
3920,C2_05440W_A,623,C2,1112792,1116265,3473,21.291703786070816,26.69270668777343
3922,C2_05450C_A,100,C2,1116605,1117036,431,27.539108813734885,34.524872287984984
3924,C2_05460W_A,15007,C2,1118612,1120126,1514,1176.5087448618694,1474.9502039730237
3926,C2_05470W_A,1959,C2,1120484,1121404,920,252.73987179991263,316.85164015263126
3928,C2_05480C_A,68,C2,1121552,1121806,254,31.77622839027331,39.836809331348974
3930,C2_05490W_A,108,C2,1121980,1122426,446,28.741938050711468,36.032819624688905
3932,C2_05500W_A,4852,C2,1122648,1123349,701,821.5422941596029,1029.940473995744
3934,C2_05510C_A,400,C2,1123477,1124784,1307,36.32549624703821,45.54007637680651
3936,C2_05520W_A,281,C2,1125205,1126004,799,41.74329170888918,52.3321878306652
3938,C2_05530C_A,1426,C2,1126080,1127237,1157,146.28955498335645,183.39838943326967
3940,C2_05540C_A,659,C2,1127540,1128659,1119,69.9008537735148,87.6323945583922
3942,C2_05550W_A,466,C2,1128947,1129336,389,142.1881709203958,178.2566195257746
3944,C2_05560W_A,395,C2,1129692,1130708,1016,46.14562578734542,57.851248845157514
3946,C2_05570C_A,156,C2,1130820,1131869,1049,17.651282366065576,22.12883043999007
3948,C2_05580W_A,2549,C2,1134957,1139015,4058,74.55640262650716,93.46890258293193
3950,C2_05590C_A,298,C2,1139195,1140115,920,38.446391932809576,48.19897333613278
3952,C2_05600W_A,6,C2,1141059,1141154,95,7.49643530445457,9.398033656497807
3954,C2_05610C_A,13828,C2,1141641,1142261,620,2647.249247862847,3318.76905731046
3956,C2_05620W_A,53,C2,1143167,1143379,212,29.673389746799337,37.20054989030382
3958,C2_05630C_A,1,C2,1143807,1143888,81,1.4653525800888563,1.837064192113769
3960,C2_05640W_A,3526,C2,1149967,1151790,1823,229.57404771742068,287.8094106707872
3962,C2_05650W_A,875,C2,1152540,1155374,2834,36.646741042271586,45.942810379697725
3964,C2_05660W_A,16013,C2,1156982,1159933,2951,644.0664046296141,807.4448056840869
3966,C2_05670C_A,91,C2,1160140,1160940,800,13.5013923347937,16.926250200088237
3968,C2_05680W_A,565,C2,1161273,1163942,2669,25.12621237458468,31.49990361636817
3970,C2_05690C_A,668,C2,1164030,1164677,647,122.54605471939388,153.63194637850359
3972,C2_05700W_A,3359,C2,1165370,1166881,1511,263.85947361879283,330.79191815097425
3974,C2_05710C_A,2536,C2,1167165,1167944,779,386.4016246361136,484.41897058696014
3976,C2_05720C_A,3430,C2,1168416,1169708,1292,315.10751341028396,395.0398951199446
3978,C2_05730C_A,464,C2,1170270,1171727,1457,37.79945873030856,47.38793452052429
3980,C2_05740W_A,375,C2,1172463,1174007,1544,28.82777501308226,36.14043059291175
3982,C2_05750W_A,841,C2,1174515,1175765,1250,79.85702648658638,100.11411986478565
3984,C2_05760C_A,1632,C2,1175951,1176283,332,583.45749478044,731.4614147105522
3986,C2_05770W_A,682,C2,1178196,1179634,1438,56.292772760270246,70.57239228146649
3988,C2_05780C_A,749,C2,1180382,1181722,1340,66.34438483687374,83.17376676966437
3990,C2_05790C_A,2226,C2,1182436,1185167,2731,96.74546404448968,121.28659693272253
3992,C2_05800C_A,860,C2,1185717,1187078,1361,75.0010732762599,94.02637150818893
3994,C2_05810W_A,811,C2,1189182,1190819,1637,58.80297882627798,73.71935482232475
3996,C2_05820W_A,316,C2,1191654,1193099,1445,25.95651532176773,32.540827032071995
3998,C2_05830C_A,294,C2,1193133,1194662,1529,22.822698719578828,28.612064533026356
4000,C2_05840W_A,232,C2,1194847,1196127,1280,21.51320756642952,26.97039867047027
4002,C2_05850C_A,163,C2,1196120,1198435,2315,8.357257069076963,10.477217506901983
4004,C2_05860C_A,276,C2,1198788,1200521,1733,18.903301950644245,23.698446092842133
4006,C2_05870W_A,47,C2,1204055,1204384,329,16.956222712456764,21.257457080173612
4008,C2_05880W_A,1,C2,1204115,1204271,156,0.7608561473538291,0.953860253597534
4010,C2_05890C_A,2182,C2,1204413,1205714,1301,199.06944328214038,249.56679434478997
4012,C2_05900W_A,6,C2,1206361,1207523,1162,0.612875519727353,0.7683418221749497
4014,C2_05910W_A,2102,C2,1208390,1210834,2444,102.08423117474993,127.97963317417124
4016,C2_05920C_A,2384,C2,1211100,1211381,281,1006.994464859354,1262.4357428965736
4018,C2_05930W_A,508,C2,1211755,1211940,185,325.9260971107906,408.6027966329587
4020,C2_05940C_A,285,C2,1212168,1214264,2096,16.139152820301167,20.233123509039295
4022,C2_05950C_A,573,C2,1214551,1215612,1061,64.10123402418859,80.36160259055265
4024,C2_05960C_A,225,C2,1215977,1216873,896,29.805860236740408,37.366623773742674
4026,C2_05970C_A,469,C2,1217596,1218492,896,62.12865978236112,77.88865133282363
4028,C2_05980C_A,1086,C2,1219015,1219995,980,131.53184189805745,164.89713135048956
4030,C2_05990C_A,87,C2,1221317,1222471,1154,8.948301240802573,11.2181900882372
4032,C2_06000W_A,542,C2,1223238,1224716,1478,43.526325420203634,54.56751837765811
4034,C2_06010W_A,1281,C2,1225302,1230872,5570,27.297387623447,34.22183440537106
4036,C2_06020W_A,1782,C2,1232702,1234528,1826,115.8334732284697,145.21660439106552
4038,C2_06030W_A,189,C2,1234771,1236204,1433,15.65462850563873,19.6256913587367
4040,C2_06040C_A,75,C2,1236216,1237487,1271,7.003947225837767,8.78061759802608
4042,C2_06050C_A,1,C2,1237790,1237863,73,1.6259391642081829,2.038386295359113
4044,C2_06060C_A,1,C2,1238401,1238733,332,0.3575107198409559,0.4481993962687208
4046,C2_06070W_A,974,C2,1238997,1241150,2153,53.69601786044135,67.31692632263061
4048,C2_06080C_A,435,C2,1241414,1242331,917,56.30501435052437,70.58773915935512
4050,C2_06090W_A,479,C2,1242516,1245644,3128,18.175899857694226,22.78652608370273
4052,C2_06100W_A,1706,C2,1246014,1248281,2267,89.32122259909956,111.97907033587704
4054,C2_06110W_A,531,C2,1248593,1249798,1205,52.30396665742887,65.57175764896706
4056,C2_06120C_A,177,C2,1249804,1250850,1046,20.084856539898595,25.17972210548289
4058,C2_06130W_A,402,C2,1251040,1251990,950,50.22611653984562,62.96682549853531
4060,C2_06140C_A,59,C2,1252015,1253619,1604,4.3659102121225954,5.473397614782857
4062,C2_06150C_A,1326,C2,1253885,1254724,839,187.58958190348474,235.1748708202282
4064,C2_06160W_A,68,C2,1255039,1255347,308,26.20507146470591,32.85243366935922
4066,C2_06170C_A,4926,C2,1255583,1259896,4313,135.5632904175595,169.95122537411234
4068,C2_06180C_A,7,C2,1260497,1261645,1148,0.7237412133365693,0.9073304851293615
4070,C2_06190W_A,1455,C2,1262842,1264551,1709,101.05273746423181,126.68648353514818
4072,C2_06200C_A,908,C2,1264660,1266624,1964,54.8746189207613,68.79449959347428
4074,C2_06210C_A,1975,C2,1266800,1267978,1178,198.99811460077655,249.47737192988131
4076,C2_06220C_A,185,C2,1268218,1269177,959,22.897089064266435,28.70532525424904
4078,C2_06230W_A,1219,C2,1269257,1271869,2612,55.39335696990565,69.44482437408936
4080,C2_06240W_A,48,C2,1272064,1272479,415,13.728411641892707,17.210856816718877
4082,C2_06250C_A,853,C2,1272572,1274758,2186,46.31546469171059,58.06417027708904
4084,C2_06260W_A,81,C2,1275158,1275673,515,18.66830733585046,23.403841096035805
4086,C2_06270W_A,94,C2,1275898,1277094,1196,9.328757980599123,11.695156152804545
4088,C2_06280C_A,26,C2,1277091,1278281,1190,2.5933046501404466,3.2511404946147877
4090,C2_06290C_A,1861,C2,1278612,1279313,701,315.1051544581658,395.03693777948877
4092,C2_06300W_A,382,C2,1279697,1280149,452,100.31181312634821,125.75761113359344
4094,C2_06310C_A,4536,C2,1280608,1281252,644,836.0155024315641,1048.0850577789945
4096,C2_06320W_A,1682,C2,1285202,1288468,3266,61.1275463002039,76.63358838394493
4098,C2_06330C_A,227,C2,1288828,1290435,1607,16.76629613571487,21.019352396014853
4100,C2_06340W_A,249,C2,1295311,1297473,2162,13.670072242281286,17.137718635866143
4102,C2_06350C_A,6,C2,1297757,1299199,1442,0.4938705644404883,0.6191492353448624
4104,C2_06360C_A,1251,C2,1299920,1300867,947,156.79582079512554,196.56974831159485
4106,C2_06370C_A,38,C2,1301184,1301768,584,7.723211029988868,9.68233490295579
4108,C2_06390C_A,4455,C2,1302199,1304011,1812,291.8210845960067,365.84646746424625
4110,C2_06400C_A,1,C2,1303415,1303501,86,1.3801576626418297,1.730258134432736
4112,C2_06410W_A,1,C2,1304759,1304860,101,1.1751837523484887,1.473289104566488
4114,C2_06420C_A,3103,C2,1305528,1308080,2552,144.3205774048877,180.92994719375042
4116,C2_06430C_A,199,C2,1309685,1310272,587,40.23853192240592,50.44572012381915
4118,C2_06440C_A,368,C2,1310642,1311376,734,59.508487339630285,74.60382757292537
4120,C2_06460W_A,3825,C2,1314688,1316082,1394,325.68354600145614,408.2987183082127
4122,C2_06470W_A,5421,C2,1317087,1318448,1361,472.7683932914011,592.6941394719678
4124,C2_06480W_A,411,C2,1318661,1319632,971,50.24001312434409,62.98424718811481
4126,C2_06490W_A,822,C2,1319860,1321047,1187,82.19553958506843,103.04583659588792
4128,C2_06500W_A,1,C2,1321383,1321469,86,1.3801576626418297,1.730258134432736
4130,C2_06510W_A,401,C2,1321731,1323038,1307,36.41630998765581,45.65392656774852
4132,C2_06520C_A,111,C2,1323080,1323985,905,14.5579945277115,18.25087751524298
4134,C2_06530W_A,54,C2,1324473,1325444,971,6.600877636775136,8.27530255026326
4136,C2_06540C_A,2799,C2,1325586,1329257,3671,90.49939297334933,113.45610366980158
4138,C2_06550W_A,111,C2,1330846,1331601,755,17.450311321296567,21.87687967058927
4140,C2_06560W_A,3,C2,1332428,1332503,75,4.747742359487894,5.952087982448611
4142,C2_06570C_A,163,C2,1332506,1332811,305,63.432951196436626,79.52379845402653
4144,C2_06590C_A,21,C2,1334165,1335724,1559,1.598822795850638,2.0043913988361264
4146,C2_06600W_A,2225,C2,1341011,1343941,2930,90.13418728549968,112.99825734597405
4148,C2_06610C_A,65,C2,1345071,1345313,242,31.880501380858796,39.967532939995834
4150,C2_06620W_A,76,C2,1346884,1348161,1277,7.063986282714955,8.85588658312636
4152,C2_06630C_A,78,C2,1349765,1349971,206,44.94222136408444,56.34258041638249
4154,C2_06640C_A,3846,C2,1350861,1354220,3359,135.90218156140548,170.37608202215958
4156,C2_06650C_A,135,C2,1354541,1356250,1709,9.37602718740295,11.754415998106532
4158,C2_06660W_A,114,C2,1356510,1357319,809,16.725668386329417,20.96841872679672
4160,C2_06670C_A,405,C2,1357769,1359901,2132,22.54732241548543,28.266834344414725
4162,C2_06680W_A,956,C2,1365086,1365943,857,132.40495028210114,165.9917185303638
4164,C2_06690C_A,191,C2,1366921,1367544,623,36.389197057070135,45.61993598104674
4166,C2_06700W_A,371,C2,1371621,1373636,2015,21.85375205173708,27.397328058169165
4168,C2_06710W_A,106,C2,1374467,1375636,1169,10.76263238036178,13.49275718861319
4170,C2_06720W_A,421,C2,1376330,1377367,1037,48.18706685979758,60.41053617673253
4172,C2_06730W_A,2383,C2,1379376,1380329,953,296.7961711085953,372.0835693120421
4174,C2_06740W_A,536,C2,1383179,1385761,2582,24.63971635055685,30.889999599074898
4176,C2_06750C_A,85,C2,1386153,1386893,740,13.633719613394291,17.092144544193648
4178,C2_06760C_A,57,C2,1387411,1388661,1250,5.412426289816199,6.7853802999914175
4180,C2_06770W_A,66,C2,1389019,1390239,1220,6.42112696160248,8.04995505822968
4182,C2_06780C_A,365,C2,1390337,1391983,1646,26.320260650259442,32.99684255154531
4184,C2_06790W_A,24,C2,1392264,1392623,359,7.93494544761208,9.947779357852832
4186,C2_06800C_A,236,C2,1392696,1393475,779,35.958510809985334,45.07999884011143
4188,C2_06810C_A,3056,C2,1395463,1396380,917,395.5589054142586,495.89915142756155
4190,C2_06820C_A,960,C2,1396740,1397597,857,132.95894588997604,166.68624454931933
4192,C2_06830C_A,947,C2,1398004,1401462,3458,32.50514758845457,40.750631285272085
4194,C2_06840W_A,2,C2,1402344,1403921,1577,0.15053082940671828,0.18871553527104035
4196,C2_06850W_A,119,C2,1404233,1404912,679,20.80196394620985,26.078736005573813
4198,C2_06860W_A,416,C2,1407205,1412160,4955,9.964989008814147,12.492778005543
4200,C2_06870C_A,991,C2,1412526,1413122,596,197.35791435622914,247.4211069885308
4202,C2_06880C_A,1675,C2,1413826,1415223,1397,142.3133223361171,178.41351772729823
4204,C2_06890C_A,999,C2,1415603,1416562,959,123.64428094703875,155.00875637294482
4206,C2_06910W_A,261,C2,1417595,1418248,653,47.44107028431625,59.475304878219276
4208,C2_06920C_A,225,C2,1418391,1419161,770,34.68318282093429,43.48116220944602
4210,C2_06930C_A,38,C2,1419414,1420940,1526,2.9556718489603533,3.7054282983788864
4212,C2_06940C_A,1291,C2,1422371,1424200,1829,83.77987132447883,105.03206103528099
4214,C2_06950C_A,272,C2,1426287,1427003,716,45.09029056496883,56.52820988917676
4216,C2_06960W_A,898,C2,1427773,1428666,893,119.35813658511,149.63535857331615
4218,C2_06970W_A,70,C2,1429227,1430270,1043,7.966010670281701,9.986724802766128
4220,C2_06980W_A,10,C2,1431599,1433137,1538,0.7717396553133768,0.967504548512453
4222,C2_06990W_A,67,C2,1434464,1436020,1556,5.110840907546416,6.407292654628165
4224,C2_07000W_A,661,C2,1436457,1437149,692,113.37636198054547,142.1362050722013
4226,C2_07010W_A,1538,C2,1437380,1438551,1171,155.89299207712173,195.43790172941857
4228,C2_07020C_A,277,C2,1438706,1439890,1184,27.76867891845749,34.81267675545324
4230,C2_07030C_A,1267,C2,1440117,1440932,815,184.5211524377657,231.32808201725123
4232,C2_07040W_A,396,C2,1441145,1442233,1088,43.2009644843108,54.15962410500116
4234,C2_07060W_A,494,C2,1442700,1443479,779,75.26908618700321,94.36237045345361
4236,C2_07070W_A,536,C2,1443720,1444874,1154,55.12976396632391,69.1143665206338
4238,C2_07080C_A,195,C2,1444905,1445444,539,42.941083492585314,53.83381987836175
4240,C2_07090C_A,771,C2,1445733,1447313,1580,57.919451885524786,72.61170624158036
4242,C2_07100W_A,1137,C2,1447672,1449081,1409,95.78039500954108,120.07672171831213
4244,C2_07110C_A,696,C2,1449220,1451712,2492,33.150367999634575,41.55952283090122
4246,C2_07120W_A,990,C2,1452374,1453192,818,143.65112884758605,180.09068162054174
4248,C2_07130C_A,4114,C2,1453673,1455391,1718,284.2289299611932,356.3284336407682
4250,C2_07140W_A,820,C2,1457732,1458469,737,132.0606762137067,165.56011348737658
4252,C2_07160W_A,2254,C2,1459884,1461638,1754,152.52866702231634,191.2201583871033
4254,C2_07170C_A,617,C2,1461999,1464395,2396,30.565077585601323,38.318429519728646
4256,C2_07180W_A,89,C2,1466280,1467026,746,14.160491621797004,17.75254123451496
4258,C2_07190C_A,2309,C2,1467249,1467773,524,523.0218085905318,655.6951885245154
4260,C2_07200W_A,148,C2,1468331,1468669,338,51.97232760386156,65.1559927072777
4262,C2_07210C_A,905,C2,1469096,1470337,1241,86.55734962402386,108.5140939588234
4264,C2_07220W_A,1154,C2,1472227,1473021,794,172.5092784272365,216.269191805595
4266,C2_07230C_A,344,C2,1473205,1475970,2765,14.766938260975007,18.51282338121449
4268,C2_07240C_A,192,C2,1476788,1478290,1502,15.172545489708318,19.021319784123392
4270,C2_07250C_A,107,C2,1479002,1479994,992,12.802631866562619,16.0502372510585
4272,C2_07260C_A,866,C2,1480464,1480904,440,233.61050473389295,292.86978368184646
4274,C2_07270W_A,782,C2,1481388,1482407,1019,91.08769688713282,114.19364088014754
4276,C2_07280W_A,150,C2,1482648,1484342,1694,10.51005540028312,13.17610976043819
4278,C2_07290W_A,2230,C2,1484562,1485518,956,276.868866675157,347.1013650852616
4280,C2_07300C_A,156,C2,1485601,1485972,371,49.908881946099164,62.569118952963834
4282,C2_07310W_A,3661,C2,1486613,1488259,1646,263.9958198372597,330.9628509074174
4284,C2_07320W_A,2058,C2,1488635,1489894,1259,194.02013057637186,243.2366375671017
4286,C2_07330W_A,2760,C2,1490143,1497591,7448,43.98418673532018,55.141524004961624
4288,C2_07340W_A,457,C2,1498450,1500138,1688,32.13445287745805,40.28590355419157
4290,C2_07350W_A,1191,C2,1500487,1503123,2636,53.62823549080124,67.23194980174787
4292,C2_07360W_A,638,C2,1503394,1504845,1451,52.18917342097306,65.42784515510361
4294,C2_07370W_A,335,C2,1505218,1506252,1034,38.454876461035894,48.20961010929121
4296,C2_07380W_A,42343,C2,1506829,1508775,1946,2582.652296091931,3237.785989733062
4298,C2_07390C_A,598,C2,1509083,1511452,2369,29.961480909389625,37.56172027758833
4300,C2_07400C_A,8605,C2,1512062,1513321,1259,811.2454925217103,1017.0317134426191
4302,C2_07410W_A,316,C2,1514557,1516023,1466,25.58469620733586,32.07468967349525
4304,C2_07420W_A,780,C2,1516379,1517101,722,128.22849862882816,160.75583886114674
4306,C2_07430C_A,380,C2,1517213,1518205,992,45.46729074106351,57.00084257385263
4308,C2_07440C_A,761,C2,1519101,1520804,1703,53.039223951413504,66.49352546452428
4310,C2_07450C_A,424,C2,1521450,1522565,1115,45.135487901858006,56.58487229951146
4312,C2_07460W_A,602,C2,1523224,1524315,1091,65.49360450072668,82.10717152690339
4314,C2_07470W_A,970,C2,1524598,1528116,3518,32.72676299533298,41.028463210454476
4316,C2_07480W_A,1860,C2,1528366,1530174,1808,122.10731178992648,153.08190884063077
4318,C2_07490W_A,1306,C2,1530892,1532052,1160,133.63257589420667,167.53075226460962
4320,C2_07500C_A,265,C2,1532147,1533118,971,32.3931958101002,40.61028103369933
4322,C2_07510W_A,96,C2,1533370,1534185,815,13.981081794810978,17.52762105260941
4324,C2_07520C_A,518,C2,1534182,1535540,1358,45.27486270645672,56.759601894484184
4326,C2_07530C_A,5,C2,1535671,1537075,1404,0.42269785964101625,0.5299223631097411
4328,C2_07540W_A,702,C2,1537720,1538052,332,250.97252532835103,314.635976180642
4330,C2_07550W_A,2207,C2,1538564,1539199,635,412.53021210195993,517.1755187899246
4332,C2_07560W_A,2245,C2,1539744,1544669,4925,54.10498272614376,67.8296320842494
4334,C2_07570W_A,964,C2,1545974,1547158,1184,96.63901255376541,121.1531422103138
4336,C2_07580W_A,526,C2,1547643,1548842,1199,52.070735635751305,65.27936361067493
4338,C2_07590W_A,1216,C2,1549130,1549471,341,423.2591428986275,530.6260254147735
4340,C2_07600C_A,4912,C2,1549800,1551644,1844,316.17286428693785,396.3754903713066
4342,C2_07610C_A,1683,C2,1552100,1554259,2159,92.52490031285463,115.99541540598672
4344,C2_07620W_A,89,C2,1554569,1556356,1787,5.911430749782073,7.41096573080479
4346,C2_07630C_A,609,C2,1556455,1556820,365,198.0393902005567,248.27545077474002
4348,C2_07640W_A,834,C2,1558200,1560074,1874,52.82306734008676,66.2225370512559
4350,C2_07650C_A,770,C2,1560176,1561576,1400,65.28145744295854,81.84120975866841
4352,C2_07660W_A,1092,C2,1561929,1565840,3911,33.140722683206214,41.547430815864764
4354,C2_07670C_A,1157,C2,1565975,1567477,1502,91.43039131037771,114.62326557411856
4356,C2_07680W_A,1330,C2,1568150,1569013,863,182.92286611004923,229.32436317081846
4358,C2_07690W_A,207,C2,1569249,1570613,1364,18.012878819904586,22.58215198619616
4360,C2_07700C_A,63,C2,1570678,1570995,317,23.588940745089694,29.572676884405563
4362,C2_07710W_A,15,C2,1571237,1572079,842,2.1144933311258436,2.65087053850146
4364,C2_07720C_A,580,C2,1572155,1574203,2048,33.61438682254612,42.1412479226098
4366,C2_07730W_A,1740,C2,1577337,1579364,2027,101.88790954007074,127.73351121683008
4368,C2_07740W_A,3058,C2,1580583,1584782,4199,86.44079623311491,108.36797481738422
4370,C2_07750W_A,401,C2,1585672,1586235,563,84.54017256459349,105.9852256199775
4372,C2_07760W_A,743,C2,1587535,1588641,1106,79.73717389465428,99.9638646238544
4374,C2_07770C_A,7,C2,1588820,1589116,296,2.8069422733458835,3.5189709355692806
4376,C2_07780W_A,4,C2,1589082,1589399,317,1.4977105234977584,1.877630278374956
4378,C2_07790C_A,94,C2,1589416,1590141,725,15.389233854891796,19.292974839661017
4380,C2_07800W_A,114,C2,1590890,1591228,338,40.03273883000148,50.18772411236255
4382,C2_07810W_A,817,C2,1591735,1593045,1310,74.02491426911469,92.80259316146022
4384,C2_07820C_A,185,C2,1593194,1594201,1007,21.805668731510934,27.337047585724754
4386,C2_07830W_A,307,C2,1595572,1597728,2156,16.901170041312426,21.18843936238084
4388,C2_07840W_A,14,C2,1598697,1600199,1502,1.106331441957898,1.3869712342589973
4390,C2_07850C_A,1,C2,1600287,1600358,71,1.6717402674253148,2.0958056276227506
4392,C2_07860W_A,183,C2,1600857,1602221,1364,15.924429101654777,19.963931466057474
4394,C2_07870C_A,1,C2,1601234,1601776,542,0.21899180624944162,0.2745428036184784
4396,C2_07880W_A,486,C2,1602503,1603915,1412,40.85344877321383,51.21662109543246
4398,C2_07890W_A,1117,C2,1604218,1605558,1340,98.94082491693989,124.03884844020708
4400,C2_07900W_A,5205,C2,1608279,1611449,3170,194.8895818701458,244.32663997354118
4402,C2_07910C_A,86,C2,1611757,1611933,176,57.997989050562346,72.71016569468475
4404,C2_07920W_A,269,C2,1612098,1613135,1037,30.789361010179448,38.59960625069134
4406,C2_07930C_A,2071,C2,1613187,1615181,1994,123.27701136533888,154.54832261347886
4408,C2_07940C_A,476,C2,1615386,1616870,1484,38.071518920421795,47.72900740642754
4410,C2_07950W_A,544,C2,1617396,1618439,1043,61.90728292333208,77.61111846721104
4412,C2_07960C_A,647,C2,1618432,1619652,1220,62.94650218419401,78.91395337385761
4414,C2_07970W_A,1,C2,1620166,1620252,86,1.3801576626418297,1.730258134432736
4416,C2_07980W_A,439,C2,1620414,1621292,878,59.34677949359868,74.40109978060764
4418,C2_07990W_A,1,C2,1621504,1621576,72,1.648521652599963,2.06669721612799
4420,C2_08000C_A,4306,C2,1621750,1623579,1829,279.4392919622044,350.3238224770875
4422,C2_08010W_A,3730,C2,1624653,1631255,6602,67.05952363257289,84.07031268756938
4424,C2_08020C_A,354,C2,1631507,1632622,1115,37.68387433315503,47.243030174592114
4426,C2_08030W_A,8,C2,1632157,1632687,530,1.7916008903727902,2.246070936773061
4428,C2_08040C_A,6771,C2,1633293,1633968,675,1190.6282783737975,1492.6513973762794
4430,C2_08050C_A,580,C2,1634398,1636212,1814,37.950531539456705,47.57732951791889
4432,C2_08055W_A,158,C2,1637752,1638088,336,55.81423309517019,69.9724628889048
4434,C2_08060W_A,72,C2,1638309,1638518,209,40.88964711520674,51.262001762715315
4436,C2_08070C_A,937,C2,1638718,1639695,977,113.83404787206133,142.70999077672334
4438,C2_08080C_A,294,C2,1640824,1641633,809,43.13461847000745,54.07644829542311
4440,C2_08090W_A,59,C2,1641292,1641828,536,13.065149216874335,16.37934659349198
4442,C2_08100W_A,1783,C2,1642751,1643854,1103,191.86819190768168,240.53882304410413
4444,C2_08110W_A,627,C2,1644085,1645620,1535,48.48264591854902,60.78109389243126
4446,C2_08120W_A,614,C2,1646053,1647380,1327,54.91925035278009,68.85045254754046
4448,C2_08130W_A,524,C2,1647947,1648927,980,63.46471929519532,79.56362507150695
4450,C2_08140C_A,3432,C2,1649319,1652102,2783,146.37308460081255,183.50310775928526
4452,C2_08150W_A,17,C2,1654158,1654853,695,2.9032956874566263,3.639766032432604
4454,C2_08160C_A,576,C2,1654999,1655677,678,100.8370058652296,126.41602794581122
4456,C2_08170W_A,90,C2,1656941,1658284,1343,7.9541476610928985,9.971852539470868
4458,C2_08180C_A,1150,C2,1658532,1659985,1453,93.94190835187676,117.77187164170515
4460,C2_08190W_A,228,C2,1660612,1661778,1166,23.20937517073842,29.09682804456011
4462,C2_08200W_A,109,C2,1662501,1663337,836,15.475595609574777,19.40124372269434
4464,C2_08210C_A,19,C2,1663652,1663780,128,17.618575162162106,22.087826497367892
4466,C2_08240W_A,911,C2,1665658,1669284,3626,29.82069283986122,37.38521891899259
4468,C2_08260W_A,12,C2,1670481,1670792,311,4.57981578085649,5.741563970207664
4470,C2_08270C_A,237,C2,1671420,1672556,1136,24.762652711237475,31.044120859161996
4472,C2_08280W_A,157,C2,1673267,1674376,1109,16.803326204679877,21.065775771966457
4474,C2_08290C_A,725,C2,1675845,1676450,605,142.23608308383155,178.31668542459684
4476,C2_08300C_A,26,C2,1676486,1677021,535,5.768285109658189,7.231508763722612
4478,C2_08310W_A,466,C2,1678351,1678905,554,99.83970846215517,125.1657490893977
4480,C2_08320C_A,125,C2,1679166,1679777,611,24.282643000654126,30.442348519070226
4482,C2_08330W_A,391,C2,1681559,1682557,998,46.5021859358659,58.298256541518214
4484,C2_08340C_A,93,C2,1682884,1683324,440,25.087502240475807,31.45137399816596
4486,C2_08350C_A,7,C2,1684411,1684974,563,1.475763610853253,1.8501161579547194
4488,C2_08360C_A,20,C2,1685485,1688250,2765,0.8585429221497097,1.0763269407682843
4490,C2_08370C_A,3758,C2,1690400,1691776,1376,324.16453101299976,406.39437932488886
4492,C2_08380C_A,713,C2,1692182,1694329,2147,39.41709713920434,49.41591443276503
4494,C2_08390W_A,627,C2,1695306,1696499,1193,62.38127534364857,78.20534712898741
4496,C2_08400C_A,7,C2,1696572,1696691,119,6.981974058070432,8.753070562424428
4498,C2_08420W_A,93,C2,1699140,1700204,1064,10.374531001700522,13.006207292474645
4500,C2_08430C_A,10,C2,1700273,1701295,1022,1.1613851172915595,1.4559902109707956
4502,C2_08440W_A,1,C2,1701368,1701685,317,0.3744276308744396,0.469407569593739
4504,C2_08450W_A,1250,C2,1704611,1709302,4691,31.628000156469135,39.65098048422918
4506,C2_08460C_A,33,C2,1709508,1709996,488,8.026408702003101,10.062443822787097
4508,C2_08470C_A,153,C2,1710326,1712089,1763,10.30068889679024,12.91363388137603
4510,C2_08480W_A,746,C2,1712468,1713754,1286,68.85333981683455,86.31916086521507
4512,C2_08490W_A,209,C2,1715956,1718130,2174,11.4107423313359,14.30527125496504
4514,C2_08500W_A,1481,C2,1719320,1721818,2498,70.37036063252174,88.22099981991988
4516,C2_08510W_A,115,C2,1722519,1723238,719,18.984366180149788,23.80007364330982
4518,C2_08520C_A,2,C2,1723457,1723618,161,1.474454148909284,1.8484745287107491
4520,C2_08530C_A,53,C2,1724226,1726340,2114,2.9757609396033398,3.73061332863974
4522,C2_08540C_A,83,C2,1726552,1727601,1049,9.391387412714376,11.773672605892154
4524,C2_08550C_A,318,C2,1728216,1731656,3440,10.972253418002547,13.75555216874025
4526,C2_08560W_A,326,C2,1732007,1735522,3515,11.008278870505361,13.800716090172454
4528,C2_08570W_A,626,C2,1736690,1737976,1286,57.777735556753925,72.43404115499283
4530,C2_08580W_A,52,C2,1739575,1740807,1232,5.0097930741349535,6.280612319142204
4532,C2_08590W_A,5699,C2,1746839,1748440,1601,422.5075531967755,529.6837821982298
4534,C2_08600W_A,187,C2,1749986,1751044,1058,20.978918270894052,26.300577805243154
4536,C2_08610W_A,443,C2,1751816,1753162,1346,39.064819191180106,48.97427518990964
4538,C2_08620W_A,1746,C2,1753778,1755259,1481,139.93177177018677,175.4278463429317
4540,C2_08630C_A,535,C2,1755545,1756948,1403,45.260908095616955,56.74210745919471
4542,C2_08640C_A,169,C2,1757291,1757896,605,33.155721436093145,41.566234257595674
4544,C2_08650W_A,472,C2,1758955,1759428,473,118.44262123035338,148.4876071731366
4546,C2_08660C_A,371,C2,1759736,1761676,1940,22.69861360012898,28.456503111964366
4548,C2_08670C_A,241,C2,1762253,1763524,1271,22.506017085692022,28.21505121499047
4550,C2_08680W_A,292,C2,1764313,1767426,3113,11.133478710010161,13.9576749989961
4552,C2_08690C_A,75,C2,1767421,1768830,1409,6.317968008544927,7.920628081682857
4554,C2_08700C_A,402,C2,1769650,1770171,521,91.58312996708894,114.81474898965172
4556,C2_08710W_A,118,C2,1770912,1771637,725,19.318399945502467,24.218840756170213
4558,C2_08720W_A,711,C2,1772078,1773226,1148,73.51142895461439,92.15885356099658
4560,C2_08730W_A,749,C2,1774396,1776672,2276,39.06040232047927,48.96873790481118
4562,C2_08740W_A,173,C2,1776991,1778634,1643,12.497861049777931,15.668156131521755
4564,C2_08750W_A,46,C2,1778791,1779492,701,7.788735682469442,9.764480998310848
4566,C2_08760C_A,8373,C2,1779860,1783114,3254,305.41523337424815,382.8890033577307
4568,C2_08770C_A,58,C2,1783693,1784028,335,20.54992961569387,25.762768879255184
4570,C2_08780W_A,2680,C2,1784325,1785530,1205,263.9823552578331,330.94597080834603
4572,C2_08790W_A,973,C2,1785847,1787757,1910,60.46535753640996,75.80342417437826
4574,C2_08800C_A,884,C2,1787951,1789603,1652,63.5139867703889,79.62539007997235
4576,C2_08810C_A,7667,C2,1790255,1791121,866,1050.8354696938131,1317.3977644755628
4578,C2_08820C_A,21,C2,1791402,1792331,929,2.6830621514867006,3.3636665132244574
4580,C2_08830W_A,708,C2,1793219,1794115,896,93.78910687827647,117.5803094747103
4582,C2_08840W_A,63,C2,1794757,1795149,392,19.07575055151386,23.914639215195315
4584,C2_08850C_A,721,C2,1795173,1796258,1085,78.87378435923438,98.88146164390434
4586,C2_08860W_A,1882,C2,1797497,1799881,2384,93.70020050918852,117.46885049253656
4588,C2_08870C_A,14588,C2,1800507,1801664,1157,1496.5441992266508,1876.168096109774
4590,C2_08880W_A,12,C2,1807223,1807564,341,4.176899436499614,5.236441040277371
4592,C2_08890W_A,11,C2,1809126,1810265,1139,1.1462942483399219,1.4370712863681898
4594,C2_08900W_A,355,C2,1812528,1812710,182,231.5176562662366,290.24604859467814
4596,C2_08910C_A,766,C2,1812881,1814407,1526,59.58012200799028,74.69363359363756
4598,C2_08920W_A,2838,C2,1816047,1817795,1748,192.70727711994627,241.5907564958404
4600,C2_08930W_A,413,C2,1818186,1819019,833,58.848067060879366,73.77588045472018
4602,C2_08940C_A,333,C2,1819068,1819814,746,52.98251359616182,66.42242956284811
4604,C2_08950W_A,246,C2,1820110,1820652,542,53.87198433736264,67.53752969014567
4606,C2_08960C_A,652,C2,1820603,1821982,1379,56.119072124476205,70.35462952422942
4608,C2_08970C_A,160,C2,1822232,1823080,848,22.39501112965988,28.075886709663266
4610,C2_08980C_A,596,C2,1823866,1828080,4214,16.787223814990416,21.04558873718185
4612,C2_08990C_A,882,C2,1830609,1833755,3146,33.2764523288964,41.717590595356604
4614,C2_09000C_A,76,C2,1839535,1840146,611,14.763846944397706,18.5089478995947
4616,C2_09010W_A,667,C2,1842875,1844386,1511,52.39484040004013,65.68568306242925
4618,C2_09020W_A,1733,C2,1844929,1847274,2345,87.71681779309723,109.96768095504738
4620,C2_09030W_A,80,C2,1847640,1848216,576,16.485216525999633,20.6669721612799
4622,C2_09040W_A,632,C2,1848596,1849177,581,129.11244282256237,161.86401053818943
4624,C2_09050C_A,505,C2,1849370,1850905,1535,39.049021034876006,48.95446956248451
4626,C2_09060C_A,7369,C2,1851749,1853470,1721,508.22361195622153,637.1431775517696
4628,C2_09070C_A,203,C2,1854294,1856705,2411,9.993692440647475,12.528762551193159
4630,C2_09080C_A,3,C2,1858791,1859419,628,0.5670074473910702,0.7108385329357418
4632,C2_09100C_A,1242,C2,1860193,1862481,2288,64.43068193273562,80.77462056600933
4634,C2_09110C_A,1,C2,1862511,1862975,464,0.2558050840241322,0.3206943956060675
4636,C2_09120C_A,1,C2,1863726,1864559,833,0.1424892664912333,0.1786340931107026
4638,C2_09130C_A,528,C2,1865856,1869113,3257,19.241694548738167,24.122677730525535
4640,C2_09140C_A,3066,C2,1872612,1875896,3284,110.81438850631763,138.92434343930756
4642,C2_09150W_A,3067,C2,1880424,1882058,1634,222.7865027011838,279.3000893844843
4644,C2_09160W_A,105,C2,1882409,1883422,1013,12.302886173401504,15.423722560639295
4646,C2_09170W_A,573,C2,1883670,1884461,791,85.98155410829847,107.79223811450868
4648,C2_09180W_A,143,C2,1884891,1885955,1064,15.952235841324459,19.99879185832123
4650,C2_09200W_A,7,C2,1888032,1888123,91,9.13027376824595,11.446323043170405
4652,C2_09210W_A,4,C2,1889155,1889655,500,0.9495484718975787,1.1904175964897223
4654,C2_09220W_A,53509,C2,1889869,1890507,638,9954.817629852576,12480.026483261863
4656,C2_09230C_A,1380,C2,1891008,1892246,1238,132.3078444283783,165.86998012477954
4658,C2_09240C_A,34,C2,1892523,1893164,641,6.295758199008908,7.892784376101903
4660,C2_09250W_A,310,C2,1893408,1894058,650,56.6076973631249,70.96720286765652
4662,C2_09260C_A,1287,C2,1894128,1894934,806,189.52681193117,237.6035122025857
4664,C2_09270C_A,2879,C2,1895205,1896446,1241,275.35757963266815,345.20671437287575
4666,C2_09280C_A,536,C2,1896700,1898205,1505,42.27225755291547,52.9953348603398
4668,C2_09290W_A,104,C2,1898815,1899127,312,39.56451966239912,49.60073318707176
4670,C2_09300W_A,705,C2,1899244,1900299,1055,79.31654889665796,99.43654093901117
4672,C2_09310C_A,213,C2,1900351,1900848,497,50.86866813737029,63.77237124052083
4674,C2_09320C_A,4139,C2,1901073,1902836,1763,278.657198325587,349.3433374837607
4676,C2_09330C_A,1,C2,1903115,1903606,491,0.2417384093425608,0.30305946957477653
4678,C2_09340W_A,2,C2,1903774,1904226,452,0.5251927388814042,0.6584168122177667
4680,C2_09350W_A,607,C2,1904445,1905677,1232,58.47969992307531,73.3140707253715
4682,C2_09360W_A,546,C2,1906142,1908715,2573,25.187206842988633,31.576370369383422
4684,C2_09370C_A,532,C2,1908759,1910822,2063,30.608324469795928,38.37264671185969
4686,C2_09380W_A,741,C2,1911130,1911897,767,114.67004851305508,143.75805720320798
4688,C2_09390W_A,622,C2,1912239,1913105,866,85.25103197463828,106.87640661325163
4690,C2_09400C_A,3015,C2,1913246,1914592,1346,265.8700448338782,333.31250496067173
4692,C2_09410W_A,9,C2,1917972,1918328,356,3.000679862035888,3.761853359693645
4694,C2_09420W_A,728,C2,1919179,1921308,2129,40.58661857335823,50.88210487579367
4696,C2_09430W_A,19101,C2,1921832,1923001,1169,1939.4060480876449,2431.369387355666
4698,C2_09460C_A,495,C2,1930208,1933412,3204,18.337488045774872,22.989103864794497
4700,C2_09470C_A,299,C2,1936516,1939248,2732,12.990254076563692,16.28545302664838
4702,C2_09480W_A,111,C2,1939565,1940335,770,17.11037019166092,21.45070668999337
4704,C2_09490W_A,176,C2,1940851,1941816,965,21.64773718315724,27.13905401323719
4706,C2_09500W_A,419,C2,1942008,1943411,1403,35.447328022548604,44.43914584187399
4708,C2_09510C_A,729,C2,1943575,1945293,1718,50.36531111854882,63.141329150247934
4710,C2_09520C_A,1905,C2,1946179,1947759,1580,143.10837333582973,179.4102469393134
4712,C2_09530W_A,672,C2,1951210,1953171,1961,40.67418237603092,50.991880726739765
4714,C2_09540W_A,9,C2,1953454,1953601,147,7.266952591052899,9.110338748645834
4716,C2_09550C_A,2,C2,1953891,1954005,114,2.082343140126269,2.6105649045827244
4718,C2_09560C_A,364,C2,1954790,1957033,2243,19.261906139696762,24.148016335391155
4720,C2_09570C_A,320,C2,1957829,1958539,710,53.49568855761008,67.06578008392802
4722,C2_09580W_A,862,C2,1960675,1961838,1163,87.97407381510243,110.29019434373825
4724,C2_09590C_A,767,C2,1962052,1963068,1016,89.60429108580745,112.33394396009068
4726,C2_09600C_A,248,C2,1965926,1966426,500,58.87200525764989,73.80589098236278
4728,C2_09610W_A,284,C2,1967507,1968607,1100,30.644518865785503,38.418022432168314
4730,C2_09620W_A,552,C2,1968951,1971164,2213,29.60634638993807,37.11649984536414
4732,C2_09630C_A,82,C2,1971151,1971660,509,19.121555671807826,23.972063583535665
4734,C2_09640W_A,994,C2,1972394,1973719,1325,89.04256425152768,111.62972555762113
4736,C2_09650W_A,4879,C2,1974605,1975096,491,1179.4416991823541,1478.6271520553348
4738,C2_09660W_A,672,C2,1977647,1978303,656,121.58852384054364,152.43152150173276
4740,C2_09670C_A,346,C2,1978366,1979250,884,46.456981232545566,58.241584896131776
4742,C2_09680W_A,263,C2,1979666,1980118,452,69.06284516290467,86.58181080663633
4744,C2_09690C_A,575,C2,1980286,1982229,1943,35.1254742242092,44.03564835187792
4746,C2_09700W_A,171,C2,1982608,1983588,980,20.710814884500763,25.964465433640626
4748,C2_09710C_A,737,C2,1983621,1985015,1394,62.75262049753548,78.67089029886347
4750,C2_09720W_A,4913,C2,1985611,1987776,2165,269.34940198803724,337.67446025138605
4752,C2_09730C_A,1070,C2,1987847,1988899,1052,120.72443737290986,151.34824480085587
4754,C2_09740W_A,1761,C2,1989824,1990711,887,235.64752804560828,295.42353261251424
4756,C2_09750W_A,3431,C2,1992136,1993851,1715,237.45632704669046,297.69116425337006
4758,C2_09760W_A,329,C2,1994315,1994887,572,68.26954703983904,85.58727911825146
4760,C2_09770C_A,879,C2,1994898,1997858,2960,35.24717511815759,44.18822074807711
4762,C2_09780C_A,358,C2,1998133,1998852,719,59.09915732603151,74.09066403743404
4764,C2_09790W_A,440,C2,1999375,2000892,1517,34.42660906682059,43.15950415750476
4766,C2_09800C_A,4,C2,2001195,2002058,863,0.5501439582257119,0.6896973328445667
4768,C2_09810C_A,244,C2,2003065,2004369,1304,22.20953097613202,27.843356359613903
4770,C2_09820W_A,28,C2,2009284,2011107,1823,1.823049726627277,2.285497305383449
4772,C2_09830C_A,54,C2,2012619,2012861,242,26.48533960871346,33.203796596304244
4774,C2_09840W_A,40,C2,2013163,2014107,944,5.029388092677855,6.305177947509121
4776,C2_09850C_A,43,C2,2014219,2015478,1259,4.0538705611195285,5.082203797563349
4778,C2_09860C_A,130,C2,2015889,2017409,1520,10.151422808115564,12.726503909840782
4780,C2_09870W_A,444,C2,2018704,2019741,1037,50.81961445546348,63.71087425764666
4782,C2_09880C_A,1004,C2,2020316,2021494,1178,101.16157319452135,126.82292730005106
4784,C2_09890W_A,370,C2,2024080,2025381,1301,33.75604675270025,42.31884230411195
4786,C2_09900C_A,880,C2,2025549,2026205,656,159.22306693404522,199.61270672845956
4788,C2_09910C_A,41,C2,2026825,2027007,182,26.738658892720284,33.52137462642762
4790,C2_09920W_A,74,C2,2027268,2027756,488,17.998613452976645,22.56426796624986
4792,C2_09930W_A,671,C2,2028006,2029757,1751,45.4845106113132,57.02243055715332
4794,C2_09940W_A,3169,C2,2031192,2032163,971,387.3737264988964,485.6376626256346
4796,C2_09950W_A,1278,C2,2034730,2036274,1544,98.24505724458433,123.16658746064321
4798,C2_09960W_A,278,C2,2036718,2037725,1007,32.7674373370813,41.07945529098098
4800,C2_09970C_A,781,C2,2038151,2039194,1043,88.87791904985727,111.4233152994335
4802,C2_09980W_A,1184,C2,2041560,2042537,977,143.84152900802627,180.329380020961
4804,C2_09990C_A,5394,C2,2042831,2047297,4466,143.35715565986175,179.7221371323769
4806,C2_10000C_A,101,C2,2048493,2049189,696,17.224208990958235,21.593422637475207
4808,C2_10010C_A,434,C2,2049481,2050200,719,71.64534714943484,89.81940835823009
4810,C2_10020C_A,22,C2,2050568,2051806,1238,2.1092554908871906,2.6443040309747468
4812,C2_10030C_A,8520,C2,2053448,2054584,1136,890.2016924039801,1116.0164967091146
4814,C2_10040W_A,3,C2,2056151,2056465,314,1.1340148947821405,1.4216770658714837
4816,C2_10050W_A,2261,C2,2057988,2062139,4151,64.6509604601429,81.05077648949838
4818,C2_10060C_A,42,C2,2062293,2063261,968,5.149927146138729,6.456293782614712
4820,C2_10070W_A,10,C2,2064740,2065882,1142,1.0393481522521661,1.3029964935307818
4822,C2_10080W_A,287,C2,2066873,2068165,1292,26.36613887718703,33.05435857126067
4824,C2_10090C_A,454,C2,2068477,2071431,2954,18.2420026337805,22.869396953551707
4826,C2_10100W_A,142,C2,2071601,2073547,1946,8.661092176866406,10.8581255589376
4828,C2_10110W_A,2072,C2,2074655,2074987,332,740.7622115104607,928.6691490687895
4830,C2_10120W_A,181,C2,2075721,2076518,797,26.955500849037293,33.79322223410284
4832,C2_10130W_A,172,C2,2076975,2080109,3134,6.514132784236741,8.166553390085843
4834,C2_10140W_A,109,C2,2081130,2082971,1841,7.027483937862311,8.810124797486402
4836,C2_10150W_A,242,C2,2084376,2085581,1205,23.837212676267022,29.883927214783483
4838,C2_10160W_A,657,C2,2088696,2089952,1256,62.087315489322194,77.83681935646374
4840,C2_10170C_A,573,C2,2090445,2091293,848,80.20213360809444,100.54676927898154
4842,C2_10180W_A,164,C2,2093231,2094343,1112,17.505165174370834,21.945648136725996
4844,C2_10190C_A,343,C2,2094546,2095355,809,50.323721548342014,63.08918967799363
4846,C2_10200W_A,185,C2,2095699,2096214,515,42.63749206336216,53.45321731810646
4848,C2_10210C_A,968,C2,2096599,2097471,872,131.76073979312736,165.18409309089037
4850,C2_10220C_A,910,C2,2099020,2100465,1445,74.74819285698935,93.70934366830858
4852,C2_10230W_A,629,C2,2102788,2104539,1751,42.63749206336215,53.45321731810646
4854,C2_10240W_A,362,C2,2107703,2108914,1211,35.48065099369566,44.480921751577156
4856,C2_10250C_A,907,C2,2109181,2111715,2534,42.484237569608524,53.26108721468914
4858,C2_10260C_A,677,C2,2112284,2113717,1433,56.075044964642444,70.2994341262685
4860,C2_10270W_A,833,C2,2114376,2116652,2276,43.44100818819658,54.46055897824795
4862,C2_10280C_A,1449,C2,2116936,2119164,2228,77.19343221384604,96.77485958895913
4864,C2_10290W_A,2399,C2,2120835,2122465,1630,174.69070430078924,219.00397346463527
4866,C2_10300C_A,265,C2,2122695,2124740,2045,15.380827937216281,19.282436617956996
4868,C2_10310C_A,138,C2,2125311,2127308,1997,8.202158808329113,10.282775933624292
4870,C2_10320C_A,34,C2,2127689,2129014,1325,3.0457215136337434,3.818320592514204
4872,C2_10330C_A,42,C2,2129274,2129768,494,10.091355217534998,12.651199152977817
4874,C2_10340W_A,91,C2,2131033,2131848,815,13.25290045133124,16.614724122786
4876,C2_10350C_A,2214,C2,2132111,2134138,2027,129.64358144926243,162.52988151382866
4878,C2_10360C_A,588,C2,2137302,2138324,1022,68.28944489674369,85.61222440508277
4880,C2_10420W_A,128,C2,2151459,2152997,1538,9.878267588011223,12.3840582209594
4882,C2_10430C_A,282,C2,2156597,2158927,2330,14.365486538364657,18.009536599254385
4884,C2_10440C_A,624,C2,2159273,2162185,2912,25.43433406868515,31.886185620260417
4886,C2_10450W_A,110,C2,2162387,2162893,506,25.80294760591247,32.348304252438105
4888,C2_10460C_A,1180,C2,2162911,2164833,1922,72.87117565290993,91.35618911666704
4890,C2_10470C_A,559,C2,2165301,2166059,758,87.53258505784078,109.73671445213633
4892,C2_10480W_A,1213,C2,2166474,2167502,1028,140.05378117847314,175.5808055133795
4894,C2_10490C_A,2,C2,2167627,2167722,95,2.498811768151523,3.132677885499269
4896,C2_10500W_A,1,C2,2168360,2168447,87,1.3642937814620384,1.710370109899026
4898,C2_10530C_A,821,C2,2169608,2170894,1286,75.77559247938494,94.99736068410401
4900,C2_10540W_A,437,C2,2171151,2171960,809,64.1150621475961,80.37893845272073
4902,C2_10550C_A,4950,C2,2171966,2179213,7247,81.07259790073506,101.63804164868438
4904,C2_10560C_A,345,C2,2179659,2180270,611,67.02009468180538,84.02088191263383
4906,C2_10570W_A,1583,C2,2181205,2184774,3569,52.645532047277506,65.99996691101255
4908,C2_10580W_A,202,C2,2184896,2185423,527,45.495443862265404,57.03613721321725
4910,C2_10590W_A,1242,C2,2186547,2187332,785,187.79286657592243,235.4297221083177
4912,C2_10600W_A,360,C2,2187377,2187721,344,124.21418963776468,155.72323209894626
4914,C2_10610W_A,1218,C2,2187993,2189639,1646,87.8303492384,110.11001158296489
4916,C2_10620W_A,5840,C2,2189809,2190597,788,879.6578483315135,1102.7980272049458
4918,C2_10630W_A,1195,C2,2190690,2192378,1688,84.0277268896332,105.3427893813106
4920,C2_10640C_A,232,C2,2192388,2192990,602,45.742368247557785,57.34569816977068
4922,C2_10650W_A,24,C2,2193331,2193519,188,15.152369232408173,18.996025475899824
4924,C2_10660W_A,837,C2,2194521,2195870,1349,73.64455809657835,92.3257531747496
4926,C2_10670W_A,2690,C2,2196056,2197075,1019,313.33235885727265,392.81444241380683
4928,C2_10680W_A,883,C2,2197235,2198446,1211,86.54534482716373,108.49904394100172
4930,C2_10690W_A,1968,C2,2198731,2201816,3085,75.71764151922348,94.92470947697625
4932,C2_10700C_A,386,C2,2201813,2202685,872,52.540956157176815,65.86886356723521
4934,C2_10710W_A,3156,C2,2202878,2203342,464,807.3208451801613,1012.1115125327487
4936,C2_10720C_A,932,C2,2203464,2204570,1106,100.02025043044117,125.39208859950512
4938,C2_10730W_A,126,C2,2204861,2205835,974,15.354608246803764,19.249565856994995
4940,C2_10740C_A,999,C2,2205832,2208582,2750,43.11813288298551,54.055780858783294
4942,C2_10750C_A,1828,C2,2208732,2210936,2204,98.44456707286605,123.416706351135
4944,C2_10760C_A,919,C2,2211080,2213146,2066,52.797376916376756,66.19032981449993
4946,C2_10770W_A,92,C2,2213264,2213599,335,32.59644008006614,40.8650816705427
4948,C2_10780C_A,139,C2,2213596,2215209,1613,10.228397209684088,12.823004177934859
4950,C2_10790C_A,212,C2,2215273,2215932,659,38.183663892694746,47.86959985884315
4952,C2_10800W_A,4,C2,2216095,2216185,90,5.275269288319882,6.613431091609567
4954,C2_10810W_A,282,C2,2216351,2217262,911,36.741584670021574,46.06171270720386
4956,C2_10820C_A,1928,C2,2217265,2220897,3632,63.006933294966,78.98971386399315
4958,C2_10830W_A,189,C2,2221164,2221412,248,90.45597842169477,113.40167627850681
4960,C2_10840W_A,570,C2,2221521,2223911,2390,28.307668879791837,35.48839069033168
4962,C2_10850C_A,1072,C2,2223908,2225521,1613,78.88375402000965,98.89396027874942
4964,C2_10860C_A,2040,C2,2225780,2226865,1085,223.16576989297937,279.7755641519624
4966,C2_10870W_A,1,C2,2227315,2228484,1169,0.10153426773926207,0.12729016215672823
4968,C3_00010C_A,418,C3,3828,4880,1052,47.161509179323666,59.124828342764246
4970,C3_00020W_A,1,C3,3999,4823,824,0.14404558129514242,0.18058519364225153
4972,C3_00030C_A,4765,C3,4903,8097,3194,177.07414169505176,221.99201030344108
4974,C3_00040W_A,1,C3,5971,7002,1031,0.1151246934890372,0.14432803061223598
4976,C3_00050C_A,10,C3,12190,12501,311,3.8165131507137415,4.78463664183972
4978,C3_00060W_A,15,C3,13756,14265,509,3.4978455497209437,4.385133582354085
4980,C3_00090W_A,9936,C3,15901,16308,407,2897.6393171911373,3632.6748276172852
4982,C3_00100W_A,419,C3,16407,17105,698,71.25014500807406,89.3239564701278
4984,C3_00110C_A,2304,C3,17074,19533,2459,111.21185844103404,139.4226383851322
4986,C3_00120W_A,1,C3,17482,18108,626,0.18960632426069865,0.23770319418724487
4988,C3_00130C_A,975,C3,19602,21179,1577,73.38377933577515,91.99882344463214
4990,C3_00140W_A,1,C3,19605,20204,599,0.19815285306710742,0.24841769542773837
4992,C3_00150W_A,1,C3,20107,20643,536,0.2214432070656667,0.2776160439574912
4994,C3_00160C_A,925,C3,21254,22687,1433,76.61656808315252,96.05166405730925
4996,C3_00170C_A,309,C3,22745,23092,347,105.6954170808184,132.50685782252313
4998,C3_00180C_A,384,C3,23211,24971,1760,25.896776506297606,32.4659344497197
5000,C3_00190W_A,1,C3,24430,24810,380,0.3123514710189404,0.39158473568740865
5002,C3_00200C_A,3299,C3,25109,26203,1094,357.92509241203294,448.718881492184
5004,C3_00210C_A,389,C3,26343,26975,632,73.05663678167686,91.58869561600117
5006,C3_00220W_A,6691,C3,28278,30170,1892,419.7561327607492,526.2344171586108
5008,C3_00230C_A,1,C3,29708,30205,497,0.23882003820361639,0.2994008039461072
5010,C3_00240C_A,2975,C3,30220,31575,1355,260.60024943683555,326.70593630598927
5012,C3_00250C_A,3746,C3,31718,32992,1274,349.00005648825845,437.5298583644524
5014,C3_00260C_A,2914,C3,33094,34464,1370,252.46206634211177,316.50336461414696
5016,C3_00270C_A,1223,C3,34558,36054,1496,97.03357128431978,121.64778747551222
5018,C3_00280C_A,1037,C3,36189,38813,2624,46.907477389376396,58.80635706744675
5020,C3_00290W_A,4891,C3,39195,40520,1325,438.13599774066586,549.276647587852
5022,C3_00300W_A,1308,C3,40606,42942,2336,66.46026333700948,83.31903982280376
5024,C3_00310C_A,464,C3,42951,43340,389,141.57792125979324,177.49156965656528
5026,C3_00320W_A,8298,C3,45115,45879,764,1289.1611943400048,1616.178863820634
5028,C3_00330W_A,2083,C3,46161,48251,2090,118.29602075135507,148.30381898852224
5030,C3_00340W_A,388,C3,48422,48775,353,130.46204217289682,163.5559587245086
5032,C3_00350W_A,341,C3,48915,49538,623,64.96710050503098,81.44711083527194
5034,C3_00360W_A,433,C3,51706,52413,707,72.69350925241365,91.13345461104133
5036,C3_00370C_A,621,C3,52683,53342,659,111.84931734605395,140.221799586517
5038,C3_00380C_A,265,C3,53465,55492,2027,15.517411510413073,19.453666938195386
5040,C3_00390W_A,88,C3,55651,56463,812,12.86334136807065,16.126346750476532
5042,C3_00400C_A,801,C3,56493,59342,2849,33.3708461736557,41.83592904476428
5044,C3_00410C_A,25,C3,59698,60243,545,5.444658669137493,6.825788970697949
5046,C3_00420W_A,1099,C3,59837,62410,2573,50.69732659422071,63.55756599991279
5048,C3_00430W_A,64,C3,62513,63145,632,12.019600910095933,15.068577170755978
5050,C3_00440W_A,119,C3,63282,63911,629,22.45553818676707,28.151767484554245
5052,C3_00450C_A,3601,C3,63988,65094,1106,386.45163283263804,484.48166421332394
5054,C3_00460W_A,5841,C3,65437,66054,617,1123.6451832159153,1408.676900546286
5056,C3_00470W_A,1033,C3,66463,67896,1433,85.56207008637465,107.2663448337302
5058,C3_00480C_A,1739,C3,68046,68837,791,260.945763689932,327.1390961276275
5060,C3_00490W_A,845,C3,70068,71693,1625,61.720650673342625,77.37714377183195
5062,C3_00500C_A,246,C3,71714,72883,1169,24.97742986385847,31.313379890555144
5064,C3_00510W_A,222,C3,73019,74104,1085,24.285686723647757,30.446164334184147
5066,C3_00520W_A,284,C3,74279,74863,584,57.720840329390505,72.36271348524853
5068,C3_00530C_A,315,C3,74962,76422,1460,25.60854183627888,32.10458415190604
5070,C3_00540C_A,302,C3,77128,77889,761,47.103094368112494,59.05159562087649
5072,C3_00550C_A,2020,C3,78180,80270,2090,114.71817662877447,143.81839383428462
5074,C3_00560C_A,965,C3,81718,83028,1310,87.43456826156141,109.61383402791814
5076,C3_00570C_A,576,C3,83705,85030,1325,51.59810564273636,64.68684297906415
5078,C3_00580W_A,631,C3,88912,92647,3735,20.05237904174606,25.139006137383358
5080,C3_00590W_A,1,C3,90951,91517,566,0.20970593460635575,0.2629014126523238
5082,C3_00600W_A,16,C3,95652,97187,1535,1.2371967060554772,1.5510326990094099
5084,C3_00610W_A,145,C3,97647,98375,728,23.640887435636834,29.637800736780516
5086,C3_00620C_A,199,C3,98473,98888,415,56.91570659868018,71.35334388598034
5088,C3_00630W_A,812,C3,99338,103045,3707,25.999236551822026,32.594385228947075
5090,C3_00640W_A,576,C3,103831,105315,1484,46.0697371810146,57.75610980273585
5092,C3_00650W_A,79,C3,107369,108898,1529,6.132629928050092,7.688275843908442
5094,C3_00660W_A,393,C3,109086,112745,3659,12.748447303079683,15.982307851204594
5096,C3_00670C_A,649,C3,113161,115300,2139,36.01314622846708,45.148493462005014
5098,C3_00680C_A,1,C3,113161,113604,443,0.26793128439547936,0.3358966130050007
5100,C3_00690C_A,415,C3,116945,118288,1343,36.67745865948392,45.98132004311567
5102,C3_00700W_A,347,C3,118533,122573,4040,10.194719051623139,12.780782982114284
5104,C3_00710W_A,2338,C3,123503,126820,3317,83.66160413387622,104.88379335969893
5106,C3_00720W_A,7475,C3,133119,135806,2687,330.1951445587273,413.95476059549094
5108,C3_00730W_A,365,C3,137630,139981,2351,18.427541059262882,23.10200035722824
5110,C3_00740W_A,1,C3,138354,138815,461,0.2574697591913175,0.32278134395057545
5112,C3_00750W_A,420,C3,140432,143014,2582,19.307240423943803,24.204850432110927
5114,C3_00760W_A,3938,C3,143568,144977,1409,331.73544023533225,415.88577847556127
5116,C3_00770C_A,1033,C3,145178,145921,743,165.02078927829726,206.88111998214723
5118,C3_00780W_A,423,C3,146262,147626,1364,36.80892628415285,46.14613666744433
5120,C3_00790W_A,260,C3,148259,150694,2435,12.673644902123742,15.88853054863079
5122,C3_00800W_A,1079,C3,155046,157730,2684,47.71622583725259,59.82025831838722
5124,C3_00810C_A,3162,C3,157966,160686,2720,137.98126232261694,172.98255698991278
5126,C3_00820W_A,582,C3,162847,165159,2312,29.87874192497788,37.45799314213984
5128,C3_00830C_A,617,C3,165325,167637,2312,31.67557348404012,39.71062159570495
5130,C3_00840C_A,357,C3,167936,168433,497,85.25875363869108,106.88608700876027
5132,C3_00850C_A,5531,C3,168880,171330,2450,267.9567652074239,335.92855745840075
5134,C3_00860W_A,456,C3,173043,173678,635,85.23505968214486,106.8563826770302
5136,C3_00870W_A,8,C3,174371,174697,326,2.912725373918953,3.6515877192936266
5138,C3_00880W_A,15352,C3,175316,178306,2990,609.425925609182,764.0171798206612
5140,C3_00890C_A,574,C3,178624,180774,2150,31.688419934256412,39.72672676657562
5142,C3_00900C_A,428,C3,181128,182009,881,57.66270516063618,72.2898313418844
5144,C3_00910W_A,269,C3,183121,185799,2678,11.922541959505633,14.946897566081745
5146,C3_00920W_A,157,C3,187453,188250,797,23.381290791706377,29.312352987591968
5148,C3_00930W_A,1658,C3,189352,190149,797,246.9183447939438,309.55338377979297
5150,C3_00940W_A,1407,C3,191169,192854,1685,99.11088278634224,124.25204438138273
5152,C3_00950C_A,147,C3,193060,194184,1124,15.52309000989147,19.46078588567495
5154,C3_00960W_A,229,C3,194324,195466,1142,23.8010726865746,29.838619701854903
5156,C3_00970W_A,1,C3,196070,196140,70,1.6956222712456763,2.1257457080173614
5158,C3_00980W_A,1532,C3,198697,201123,2426,74.95405291359701,93.96742363057783
5160,C3_00990C_A,94,C3,201335,202591,1256,8.883116675793433,11.136470349326622
5162,C3_01000W_A,2859,C3,202840,206472,3632,93.43196176883184,117.13256843213505
5164,C3_01010W_A,6,C3,206574,206882,308,2.3122121880622863,2.898744147296402
5166,C3_01020W_A,651,C3,209718,211511,1793,43.09509587320997,54.02690011954889
5168,C3_01030W_A,220,C3,211924,213378,1454,17.95913547261583,22.514775724530512
5170,C3_01040C_A,22,C3,213598,215352,1754,1.488744753545235,1.866390188339074
5172,C3_01050C_A,1,C3,214825,215352,527,0.22522496961517524,0.28235711491691706
5174,C3_01060W_A,82,C3,216483,216692,209,46.56876477009657,58.38172422975911
5176,C3_01070C_A,57,C3,216964,219954,2990,2.2627200208261704,2.8366974498291877
5178,C3_01080W_A,241,C3,220263,220553,290,98.63844039970539,123.65975894569961
5180,C3_01090W_A,78,C3,221731,221955,224,41.33079286161337,51.81505163292318
5182,C3_01100W_A,116,C3,222887,223546,659,20.8929481677009,26.192799922763236
5184,C3_01110C_A,42,C3,223626,225776,2150,2.318664873238274,2.906833665846996
5186,C3_01120W_A,83,C3,226014,227075,1061,9.285170024446165,11.640511370010243
5188,C3_01130C_A,2757,C3,227408,230062,2654,123.29997819431165,154.57711536935588
5190,C3_01140W_A,361,C3,231342,232058,716,59.844098874829946,75.02457268379709
5192,C3_01150C_A,237,C3,232663,233589,926,30.378373088515954,38.084364250548624
5194,C3_01160W_A,2283,C3,236495,238651,2156,125.68524822252857,157.5674497208973
5196,C3_01170W_A,515,C3,239217,240671,1454,42.04070349271433,52.70504317333279
5198,C3_01180C_A,919,C3,240894,244154,3260,33.45993273289398,41.94761392538554
5200,C3_01190C_A,378,C3,248165,249589,1424,31.507138551376826,39.49946027678327
5202,C3_01200W_A,667,C3,249962,257464,7502,10.552999712671372,13.22994762827654
5204,C3_01210C_A,580,C3,257541,258550,1009,68.22821031969718,85.53545663578281
5206,C3_01220W_A,101,C3,259791,260798,1007,11.904716442608672,14.924550303557838
5208,C3_01230C_A,105,C3,260834,261466,632,19.719657743126145,24.721884420771527
5210,C3_01240C_A,7,C3,261805,261893,88,9.441533101254334,11.836538601460306
5212,C3_01250W_A,5803,C3,264875,268510,3635,189.48520572289033,237.55135187172831
5214,C3_01260C_A,605,C3,269315,271492,2177,32.98557794545448,41.352930975900435
5216,C3_01270W_A,27,C3,273811,274278,467,6.862368506754451,8.60312502816448
5218,C3_01280W_A,264,C3,274498,275166,668,46.90883169553908,58.80805491640844
5220,C3_01290W_A,5,C3,275345,275761,416,1.4266052762884298,1.7884879754953762
5222,C3_01300C_A,827,C3,275604,276449,845,116.16517548214463,145.63244856464502
5224,C3_01310W_A,584,C3,277446,280040,2594,26.72206570875993,33.500572299055406
5226,C3_01320C_A,870,C3,280383,282077,1694,60.95832132164208,76.4214366105415
5228,C3_01330W_A,472,C3,285386,288133,2747,20.394379265364815,25.567760536182607
5230,C3_01340W_A,95,C3,288691,290076,1385,8.141435453995486,10.206649067375777
5232,C3_01350C_A,915,C3,290231,291043,812,133.74951536118914,167.67735541688666
5234,C3_01360C_A,657,C3,291479,293269,1790,43.56517779585959,54.616226319395786
5236,C3_01370C_A,5,C3,294348,295271,923,0.6429770259328135,0.8060790875472118
5238,C3_01390C_A,842,C3,296783,300166,3383,29.541819883896004,37.03560509327321
5240,C3_01400W_A,230,C3,301408,302595,1187,22.99875195202645,28.832776663082996
5242,C3_01410C_A,277,C3,302676,303515,839,39.18726560125586,49.127782215085375
5244,C3_01420C_A,759,C3,304687,305070,383,235.2177839981274,294.88477667614205
5246,C3_01430W_A,71,C3,306714,307373,659,12.787925171610036,16.031799952725777
5248,C3_01440C_A,19,C3,307532,307839,307,7.345855442204396,9.209256650368372
5250,C3_01450C_A,210,C3,307886,311137,3251,7.667070866598415,9.611953832007138
5252,C3_01460C_A,1948,C3,311442,312674,1232,187.67455593105555,235.28139995555796
5254,C3_01470W_A,341,C3,315066,315707,641,63.14275134888347,79.15998447796319
5256,C3_01480C_A,238,C3,315941,316663,722,39.126131632898854,49.05114057558066
5258,C3_01490W_A,2052,C3,317330,317890,560,434.927112574516,545.2537741064532
5260,C3_01500C_A,848,C3,318169,320031,1862,54.05592804572683,67.76813384957603
5262,C3_01510W_A,1264,C3,320814,322712,1898,79.04565782919782,99.09693374361228
5264,C3_01520C_A,905,C3,322839,323900,1061,101.24191412197324,126.92364807059361
5266,C3_01530C_A,2824,C3,324169,332661,8492,39.471338975488145,49.48391563364012
5268,C3_01540W_A,2648,C3,335765,336352,587,535.4353393494014,671.2576225521262
5270,C3_01550C_A,9593,C3,336811,338214,1403,811.5661520771091,1017.4337137496352
5272,C3_01560W_A,1794,C3,342573,344876,2303,92.46037552020498,115.91452280191933
5274,C3_01570W_A,264,C3,345322,347031,1709,18.33534205536577,22.98641350740833
5276,C3_01580W_A,201,C3,347678,349027,1349,17.685252302762542,22.17141742906173
5278,C3_01590W_A,292,C3,349149,350831,1682,20.60554056139217,25.832486487440462
5280,C3_01600W_A,866,C3,351734,352816,1082,94.99872650916164,119.09676970426288
5282,C3_01610W_A,4014,C3,353503,354663,1160,410.72064290914676,514.9069215851018
5284,C3_01620W_A,148,C3,354930,355490,560,31.369012018045012,39.32629559832118
5286,C3_01630W_A,2416,C3,355874,357804,1930,148.58219612076107,186.27259799994619
5288,C3_01640C_A,59,C3,358102,359031,929,7.5381269970340625,9.450301156202046
5290,C3_01660W_A,292,C3,360108,360458,350,99.02434064074752,124.14354934821391
5292,C3_01670W_A,673,C3,360537,361334,797,100.22680702432099,125.65104178757575
5294,C3_01680C_A,356,C3,362632,363738,1106,38.20516003566208,47.896548864188645
5296,C3_01690W_A,710,C3,365248,366450,1202,70.11017211390192,87.89481005695745
5298,C3_01700W_A,610,C3,367274,369532,2258,32.06513329592134,40.19899988146206
5300,C3_01710C_A,144,C3,369832,371523,1691,10.107553219489306,12.671506053704912
5302,C3_01720C_A,2299,C3,372130,375795,3665,74.45470453248751,93.3414070371716
5304,C3_01730C_A,1896,C3,376289,377701,1412,159.37888657204402,199.80805266860068
5306,C3_01740C_A,9,C3,379671,380057,386,2.7674664012558967,3.4694813369195274
5308,C3_01750C_A,419,C3,381920,384757,2837,17.529996903643177,21.976778856591192
5310,C3_01760W_A,2815,C3,385547,387934,2387,139.97585611602872,175.48311343310476
5312,C3_01770C_A,214,C3,388103,389974,1871,13.57585335289163,17.019599522234138
5314,C3_01780C_A,212,C3,390197,390463,266,94.59787408002195,118.59423423675804
5316,C3_01790C_A,595,C3,390676,394428,3752,18.822672600581672,23.597363736386754
5318,C3_01800C_A,492,C3,395037,396632,1595,36.61268402614489,45.9001142220175
5320,C3_01810C_A,2703,C3,399010,400305,1295,247.74416211767914,310.5886837173474
5322,C3_01820W_A,172,C3,402434,405034,2600,7.852035440691518,9.84383781712655
5324,C3_01830C_A,730,C3,405200,406585,1385,62.560504014912695,78.43004020194019
5326,C3_01840C_A,1,C3,407931,408004,73,1.6259391642081829,2.038386295359113
5328,C3_01850W_A,774,C3,408919,409974,1055,87.07944517165,109.1686279245314
5330,C3_01860C_A,2048,C3,410208,411830,1622,149.86708311083856,187.883418434876
5332,C3_01870C_A,1,C3,412026,412100,74,1.6039670133405046,2.0108405346110176
5334,C3_01880W_A,197,C3,412494,414257,1763,13.262978514167827,16.627358657719462
5336,C3_01890C_A,3256,C3,414635,416522,1887,204.80457237006604,256.75673649778327
5338,C3_01900C_A,386,C3,418351,420147,1796,25.50986290036647,31.980873625071883
5340,C3_01910C_A,178,C3,422590,422757,167,126.51169760312054,158.60354204728336
5342,C3_01920C_A,1,C3,423654,423768,114,1.0411715700631345,1.3052824522913622
5344,C3_01930W_A,241,C3,425210,427384,2174,13.157841635655272,16.495552021275476
5346,C3_01940C_A,354,C3,427510,428097,587,71.58010201272208,89.73761268257277
5348,C3_01950C_A,135,C3,428436,429026,590,27.158695700460413,34.047960916549265
5350,C3_01960C_A,3773,C3,429483,431612,2129,210.34795587538545,263.70629353896913
5352,C3_01970C_A,28,C3,433673,434200,527,6.306299149224907,7.905999217673678
5354,C3_01980C_A,711,C3,435718,435888,170,496.41835552880775,622.3433169883768
5356,C3_01990W_A,1565,C3,436119,437363,1244,149.32107702167514,187.19890861197905
5358,C3_02000W_A,1270,C3,437485,441483,3998,37.70405700693863,47.26833252694932
5360,C3_02010C_A,65,C3,441503,442610,1107,6.969359832129927,8.737256523467925
5362,C3_02020W_A,1276,C3,442844,445369,2525,59.98137871986686,75.19667589707355
5364,C3_02030W_A,1309,C3,445556,446539,983,158.05683490767177,198.15064010745758
5366,C3_02040C_A,749,C3,446602,447222,620,143.3894769055013,179.7626572118552
5368,C3_02050C_A,1,C3,447502,447595,93,1.2762748278193263,1.6000236511958632
5370,C3_02060W_A,143,C3,448127,449398,1271,13.354192710597344,16.741710886903057
5372,C3_02070C_A,46,C3,449448,450614,1166,4.682593236201611,5.870412675656864
5374,C3_02080W_A,483,C3,451391,453976,2585,22.177558603797415,27.803273651089746
5376,C3_02090C_A,302,C3,453985,454926,941,38.092938165923066,47.75586000795645
5378,C3_02100W_A,515,C3,456047,457429,1382,44.230957220265296,55.45089202172639
5380,C3_02110W_A,10746,C3,457757,458254,497,2566.3601305360617,3217.361039204868
5382,C3_02120W_A,718,C3,459265,460465,1200,71.01831279400642,89.03331607079382
5384,C3_02130W_A,953,C3,460854,463085,2231,50.70146199677234,63.56275041767736
5386,C3_02140C_A,1646,C3,463157,464374,1217,160.53377000240496,201.25589192913753
5388,C3_02150C_A,16569,C3,464995,466125,1130,1740.3836981051975,2181.8616323272354
5390,C3_02160C_A,1612,C3,467068,469592,2524,75.80587047835266,95.03531921263038
5392,C3_02170C_A,2783,C3,470417,471970,1553,212.70069199057966,266.6558411969492
5394,C3_02180C_A,597,C3,472269,473408,1139,62.21251511444848,77.99377799652812
5396,C3_02190C_A,1089,C3,473862,474284,422,306.29688563283867,383.99430171128773
5398,C3_02200W_A,20,C3,474569,474745,176,13.487904430363336,16.90934085922901
5400,C3_02210C_A,384,C3,474790,477275,2485,18.341378934037742,22.99398174306103
5402,C3_02220W_A,1423,C3,478901,480400,1499,112.6757401192674,141.2578585561103
5404,C3_02230C_A,945,C3,480639,484418,3779,29.68124192720336,37.2103939098567
5406,C3_02240C_A,539,C3,484858,486369,1511,42.34005843421534,53.08033458867972
5408,C3_02250C_A,3,C3,488396,488884,488,0.7296735183639181,0.9147676202533727
5410,C3_02260C_A,1261,C3,489073,490833,1760,85.04123743344084,106.61339411743892
5412,C3_02270W_A,118,C3,492474,492698,224,62.526071252184316,78.38687298314021
5414,C3_02280C_A,3655,C3,493362,495503,2141,202.62725740224494,254.02710854565242
5416,C3_02290W_A,669,C3,497382,498554,1172,67.75255201572955,84.93913951062544
5418,C3_02300W_A,632,C3,499465,502809,3344,22.432514736814813,28.122903744822985
5420,C3_02310W_A,738,C3,504690,506297,1607,54.50892752492324,68.33604435356371
5422,C3_02320W_A,2480,C3,507101,509152,2051,143.5202468494634,179.92659917689613
5424,C3_02330C_A,5,C3,509669,510601,932,0.6367680203175824,0.798295062023687
5426,C3_02340W_A,89,C3,511298,512449,1151,9.177868592407094,11.50599110421213
5428,C3_02350W_A,1581,C3,512751,514754,2003,93.68672828694909,117.45196081192279
5430,C3_02360C_A,52,C3,514904,516670,1766,3.4949405817294803,4.381491719809284
5432,C3_02370C_A,1144,C3,517634,520423,2789,48.686063636197126,61.03611197491226
5434,C3_02390W_A,164,C3,524126,525751,1625,11.978919183938688,15.017575832639572
5436,C3_02400C_A,121,C3,526430,526759,329,43.65325421717593,54.72664482342569
5438,C3_02410C_A,386,C3,527091,528625,1534,29.86682775036387,37.44305673443879
5440,C3_02420C_A,65,C3,529159,531802,2643,2.9190621771350087,3.659531960453649
5442,C3_02430W_A,652,C3,532621,534945,2324,33.29956990518618,41.74657233817228
5444,C3_02440C_A,149,C3,535056,535970,914,19.349387624827575,24.257688987550413
5446,C3_02450W_A,360,C3,536423,536868,445,96.02175558514843,120.37930751019664
5448,C3_02460C_A,123,C3,537128,538135,1007,14.497822994464027,18.175442448887267
5450,C3_02470C_A,3465,C3,538836,539411,575,715.2577076358937,896.6949938775842
5452,C3_02480C_A,2291,C3,539890,540990,1100,247.20631239969924,309.91439926794925
5454,C3_02490C_A,1525,C3,542174,546082,3908,46.317215316140214,58.06636497718866
5456,C3_02500W_A,408,C3,547221,547778,557,86.94249922221996,108.99694330516309
5458,C3_02510C_A,87,C3,548135,549352,1217,8.485077758328817,10.637462088599612
5460,C3_02520W_A,1,C3,550994,551065,71,1.6717402674253148,2.0958056276227506
5462,C3_02530W_A,87,C3,551544,551732,188,54.92733846747963,68.86059235013687
5464,C3_02540C_A,424,C3,552298,553335,1037,48.530442633145306,60.841015056851774
5466,C3_02550C_A,95,C3,553678,554376,698,16.154567483930872,20.252448364348787
5468,C3_02560W_A,196,C3,554571,556037,1466,15.868988786828568,19.894427772167937
5470,C3_02570W_A,1180,C3,556571,558802,2231,62.7783055154159,78.7030907585092
5472,C3_02580C_A,107,C3,558799,559533,734,17.302739525381632,21.691873777997326
5474,C3_02590W_A,1076,C3,559817,563116,3299,38.71302499855239,48.53324241523723
5476,C3_02600C_A,181,C3,563328,564209,881,24.385396341297074,30.571166992712786
5478,C3_02610C_A,1659,C3,565145,565855,710,277.34171036585974,347.69415362261435
5480,C3_02620C_A,39,C3,567608,567961,353,13.113452692636537,16.43990306766968
5482,C3_02630C_A,1329,C3,568695,569963,1268,124.40358035803257,155.96066499751979
5484,C3_02640C_A,2011,C3,570176,572692,2516,94.86993128905162,118.93530338537518
5486,C3_02650W_A,10,C3,572852,573178,326,3.640906717398692,4.564484649117033
5488,C3_02660W_A,28,C3,576543,577301,758,4.3844586433265516,5.496651171126686
5490,C3_02670W_A,162,C3,577678,578433,755,25.46802192837877,31.92841897869785
5492,C3_02680C_A,3883,C3,578561,580315,1754,262.76344900073394,329.4178682418467
5494,C3_02690C_A,511,C3,580798,582558,1760,34.46159581957832,43.203365895330116
5496,C3_02700W_A,330,C3,583141,586854,3713,10.549117820031006,13.225081027525194
5498,C3_02710W_A,3202,C3,588383,589213,830,457.8997299722963,574.0537867409776
5500,C3_02720W_A,288,C3,590432,591784,1352,25.283835050527244,31.69750996570266
5502,C3_02730C_A,1,C3,591928,592015,87,1.3642937814620384,1.710370109899026
5504,C3_02740C_A,1,C3,592024,592096,72,1.648521652599963,2.06669721612799
5506,C3_02750W_A,22,C3,593790,595292,1502,1.7385208373624115,2.1795262252641385
5508,C3_02760C_A,1835,C3,595659,599300,3641,59.81946738300114,74.99369299500962
5510,C3_02770C_A,507,C3,599619,600962,1343,44.808365157489995,56.174769305685885
5512,C3_02780W_A,5096,C3,601266,602642,1376,439.5802155514227,551.0872158168264
5514,C3_02790W_A,164,C3,603064,603378,314,61.99281424809034,77.71834626764111
5516,C3_02800W_A,25,C3,604119,604895,776,3.8238904312885746,4.793885295142245
5518,C3_02810C_A,2051,C3,605101,607257,2156,112.91302851704164,141.5553391929743
5520,C3_02820C_A,513,C3,609991,610995,1004,60.64720693270144,76.03140276384805
5522,C3_02830W_A,630,C3,612045,615218,3173,23.566637933165563,29.544716584798497
5524,C3_02840W_A,114,C3,615473,616045,572,23.655709308637235,29.656382430032416
5526,C3_02850C_A,228,C3,616015,617427,1412,19.165815473853396,24.027550637363376
5528,C3_02860W_A,300,C3,618110,619654,1544,23.06222001046581,28.912344474329394
5530,C3_02870C_A,422,C3,619691,621118,1427,35.10068808170798,44.00457478264391
5532,C3_02880W_A,3,C3,621776,622186,410,0.8684894560038832,1.088796582155234
5534,C3_02890C_A,1,C3,622287,622697,410,0.2894964853346277,0.3629321940517446
5536,C3_02900W_A,1,C3,622956,624053,1097,0.10819832177502037,0.1356446668743986
5538,C3_02910W_A,7,C3,624195,624851,656,1.2665471233389962,1.5878283489763827
5540,C3_02920W_A,797,C3,625101,625490,389,243.18448975011898,304.8723728799192
5542,C3_02930W_A,66,C3,625968,626501,533,14.697513870834946,18.425788313396264
5544,C3_02940C_A,1725,C3,626532,627116,584,350.59313228238943,439.5270449368089
5546,C3_02950C_A,2262,C3,628092,629936,1844,145.59914882269004,182.5328500040504
5548,C3_02960C_A,1085,C3,630423,634766,4343,29.652892355770003,37.174852987317195
5550,C3_02970C_A,744,C3,634951,635871,920,95.98696509399439,120.33569181906975
5552,C3_02980C_A,6,C3,636147,636803,656,1.085611820004854,1.360995727694042
5554,C3_02990C_A,1,C3,636945,638042,1097,0.10819832177502037,0.1356446668743986
5556,C3_03000W_A,1,C3,638299,638709,410,0.2894964853346277,0.3629321940517446
5558,C3_03010C_A,304,C3,638810,639382,572,63.08189148969929,79.08368648008646
5560,C3_03020W_A,26,C3,639381,639884,503,6.135253546057915,7.691564987259636
5562,C3_03030C_A,512,C3,639619,641031,1412,43.03902422198657,53.956604940044066
5564,C3_03040W_A,3179,C3,641788,643371,1583,238.36185977277347,298.8264007612782
5566,C3_03050C_A,794,C3,644041,646302,2261,41.68186016622499,52.25517313206765
5568,C3_03060W_A,114,C3,651582,652064,482,28.072750465851655,35.19388122402187
5570,C3_03070W_A,447,C3,652782,654299,1517,34.97430512015637,43.84613263273779
5572,C3_03080W_A,198,C3,654514,655764,1250,18.80105974357206,23.570268410496503
5574,C3_03090W_A,264,C3,656093,657952,1859,16.855890033684833,21.131673310468447
5576,C3_03100C_A,602,C3,658005,659477,1472,48.54179518362283,60.855247374899186
5578,C3_03110W_A,590,C3,660875,662410,1535,45.62162853579573,57.194330775972
5580,C3_03120C_A,45,C3,663210,664787,1577,3.386943661651161,4.246099543598406
5582,C3_03130C_A,1,C3,665661,667181,1520,0.0780878677547351,0.09789618392185216
5584,C3_03140C_A,35,C3,667510,669222,1712,2.4265622456494786,3.042101042431387
5586,C3_03150W_A,1143,C3,670712,673711,2999,45.23732508248302,56.71254221356088
5588,C3_03160C_A,167,C3,673704,674318,614,32.283101548635116,40.47225948977679
5590,C3_03170W_A,1512,C3,674583,675479,896,200.29538079089554,251.1037117595508
5592,C3_03180C_A,553,C3,675607,676530,923,71.11325906816916,89.15234708272162
5594,C3_03190C_A,655,C3,676936,678345,1409,55.17692060795902,69.17348524669696
5596,C3_03200C_A,89,C3,678753,678989,236,44.761554024832904,56.116083732831186
5598,C3_03210W_A,529,C3,680030,681031,1001,62.726166537689714,78.63772584204085
5600,C3_03220C_A,1,C3,681177,681266,89,1.3336354942381725,1.671934826530509
5602,C3_03230C_A,278,C3,681408,683057,1649,20.010193692201863,25.08611975622671
5604,C3_03240C_A,5,C3,684502,684936,434,1.367437315520707,1.7143110548527105
5606,C3_03250W_A,929,C3,685105,689544,4439,24.840350596779984,31.141528135248706
5608,C3_03260W_A,1496,C3,689950,692745,2795,63.52971887114392,79.64511289573456
5610,C3_03270W_A,230,C3,693052,693507,455,59.99894190561625,75.21869428369125
5612,C3_03280C_A,578,C3,693795,694196,401,171.08448153266852,214.48297093860955
5614,C3_03290C_A,413,C3,694449,696431,1982,24.73281526827069,31.00671464116141
5616,C3_03300C_A,1260,C3,696906,698273,1367,109.40298780092807,137.15491693279535
5618,C3_03310C_A,166,C3,698460,699125,665,29.62876810808235,37.14460921377705
5620,C3_03320W_A,274,C3,699327,699560,233,139.57955005361404,174.98627759559224
5622,C3_03330C_A,762,C3,699627,701732,2105,42.96650448847715,53.86568934234967
5624,C3_03340C_A,494,C3,702202,702486,284,206.4599230270264,258.8319950114097
5626,C3_03350W_A,4,C3,703089,703182,93,5.105099311277305,6.400094604783453
5628,C3_03360W_A,519,C3,704145,705725,1580,38.988580452123685,48.878697197639696
5630,C3_03370C_A,1107,C3,708490,709062,572,229.7093877601879,287.9790820179463
5632,C3_03380W_A,75,C3,714210,716651,2441,3.646872971749202,4.571964345387606
5634,C3_03390C_A,389,C3,716811,717320,509,90.71079458942981,113.7211309023826
5636,C3_03400C_A,216,C3,717691,718467,776,33.038413326333284,41.419168950029004
5638,C3_03410C_A,5792,C3,718781,721924,3143,218.73149654910821,274.216461933999
5640,C3_03420C_A,2651,C3,722858,724582,1724,182.51544366302795,228.8135910886205
5642,C3_03430C_A,94,C3,725582,726181,599,18.6263681883081,23.35126337020741
5644,C3_03440C_A,710,C3,726384,728315,1931,43.64185752506997,54.7123571664748
5646,C3_03450C_A,258,C3,728899,730854,1955,15.663907017236276,19.63732352265654
5648,C3_03460C_A,1735,C3,733522,734337,815,252.67892618746922,316.7752346487221
5650,C3_03470W_A,284,C3,737492,738967,1475,22.85353949312817,28.650728593481453
5652,C3_03480C_A,2193,C3,739106,740668,1562,166.64210938471436,208.91371551712237
5654,C3_03490W_A,659,C3,743259,744101,842,92.89674034746207,116.46157899149748
5656,C3_03500W_A,2856,C3,745852,748008,2156,157.23042878823549,197.11460201615532
5658,C3_03510C_A,427,C3,748403,750508,2105,24.077030730419605,30.18457919840329
5660,C3_03520C_A,973,C3,750831,751586,755,152.9653415821762,191.76760287822842
5662,C3_03530W_A,70,C3,752036,752503,467,17.791325758252277,22.304398221167173
5664,C3_03540W_A,391,C3,752749,754380,1631,28.454433822191397,35.67238505728705
5666,C3_03550C_A,302,C3,754424,755479,1055,33.97673442097972,42.59551115401614
5668,C3_03560W_A,593,C3,755825,757297,1472,47.81608728220655,59.94545131779936
5670,C3_03570C_A,26,C3,757464,758735,1271,2.428035038290426,3.043947433982374
5672,C3_03580C_A,27,C3,759278,760178,900,3.5608067696159207,4.4640659868364585
5674,C3_03590W_A,820,C3,761498,762349,851,114.3698218208012,143.38167290269863
5676,C3_03600C_A,21,C3,762417,763243,826,3.0176328556067125,3.7831067685054736
5678,C3_03610W_A,80,C3,763787,765499,1712,5.546427990055951,6.953373811271742
5680,C3_03620C_A,1,C3,765496,765804,308,0.385368698010381,0.48312402454940023
5682,C3_03630W_A,1,C3,765830,767350,1520,0.0780878677547351,0.09789618392185216
5684,C3_03640W_A,191,C3,768366,769943,1577,14.375694208341596,18.02233361838435
5686,C3_03650W_A,1472,C3,770431,771831,1400,124.7977991636818,156.45488411007778
5688,C3_03660W_A,2320,C3,772084,774000,1916,143.72080211393416,180.1780286962523
5690,C3_03670W_A,450,C3,774527,776536,2009,26.586411918486217,33.330507616996954
5692,C3_03680W_A,1181,C3,777344,779113,1769,79.24086668393447,99.34166064544672
5694,C3_03690W_A,255,C3,779861,780721,860,35.19402039736666,44.12158242803477
5696,C3_03700C_A,3,C3,781934,782260,326,1.0922720152196075,1.36934539473511
5698,C3_03710W_A,1066,C3,782645,783583,938,134.89054784685754,169.10783020496322
5700,C3_03720W_A,866,C3,784714,785540,826,124.44143109311489,156.00811721551142
5702,C3_03730C_A,632,C3,785608,786459,851,88.14844803749558,110.50880155427505
5704,C3_03740W_A,103,C3,787084,787413,329,37.159381689000995,46.58549104804005
5706,C3_03750C_A,1377,C3,787516,789564,2048,79.80519078387243,100.04913515419602
5708,C3_03760W_A,968,C3,791640,793373,1733,66.29853727617257,83.11628919518546
5710,C3_03770C_A,376,C3,793475,794341,866,51.53438588820578,64.60695962473089
5712,C3_03780W_A,1,C3,793920,794360,440,0.2697580886072667,0.3381868171845802
5714,C3_03790W_A,1603,C3,794780,795814,1034,184.00945363295685,230.68658210505617
5716,C3_03800W_A,5466,C3,797737,799467,1730,375.0167592046363,470.1461403477473
5718,C3_03810W_A,698,C3,799968,802067,2099,39.470273546004655,49.48257993984196
5720,C3_03820C_A,612,C3,802124,803323,1199,60.58420191840265,75.95241545576627
5722,C3_03830W_A,254,C3,803446,804522,1076,28.018739760918336,35.12616978489655
5724,C3_03840C_A,637,C3,804528,805997,1469,51.46888841037761,64.52484759734114
5726,C3_03850C_A,498,C3,806218,806934,716,82.55501728439145,103.49650192944863
5728,C3_03860W_A,147,C3,807802,808329,527,33.10807053343076,41.50649589278681
5730,C3_03870C_A,11494,C3,808654,810288,1634,834.9227460213259,1046.7151051142037
5732,C3_03880C_A,689,C3,811840,812883,1043,78.40830502605847,98.29790555865515
5734,C3_03890W_A,1878,C3,813612,817613,4001,55.712697770046645,69.84517140114029
5736,C3_03900C_A,1829,C3,817866,818258,392,553.8023453764897,694.2837321363845
5738,C3_03910W_A,740,C3,818804,819202,398,220.68651670986443,276.667406219345
5740,C3_03920W_A,226,C3,819467,819682,215,124.76625270282142,156.41533535271932
5742,C3_03930W_A,478,C3,819740,820771,1031,55.029603487759786,68.9887986326488
5744,C3_03940C_A,2,C3,822151,822279,128,1.8545868591749586,2.3250343681439887
5746,C3_03970W_A,1,C3,826066,826155,89,1.3336354942381725,1.671934826530509
5748,C3_03980C_A,149,C3,826496,828007,1511,11.70439463209292,14.673413457724076
5750,C3_03990C_A,523,C3,828580,830493,1913,32.449937977158505,40.68141681678807
5752,C3_04000C_A,1825,C3,832411,835089,2678,80.88713411188766,101.4055318144951
5754,C3_04010C_A,1,C3,835704,835800,96,1.2363912394499723,1.5500229120959925
5756,C3_04020C_A,512,C3,836183,839419,3236,18.77969783728215,23.54348769324544
5758,C3_04030C_A,291,C3,841090,843573,2483,13.91052181444802,17.43916233278842
5760,C3_04040W_A,1,C3,844399,845358,959,0.12376804899603477,0.15516392029323806
5762,C3_04050W_A,1,C3,845662,845734,72,1.648521652599963,2.06669721612799
5764,C3_04060C_A,5332,C3,846209,847180,971,651.7755473941671,817.1095036667352
5766,C3_04070C_A,3106,C3,848680,853218,4538,81.23891454698877,101.84654734181021
5768,C3_04080W_A,3008,C3,854961,855487,526,678.7646871359119,850.9448978709803
5770,C3_04090W_A,4163,C3,856852,857700,848,582.690195829838,730.499477327051
5772,C3_04100W_A,34,C3,858695,859174,479,8.425012537713382,10.562160302883758
5774,C3_04110C_A,1067,C3,859230,861788,2558,49.50978398723205,62.06878300696509
5776,C3_04120C_A,164,C3,862452,863414,962,20.234660783680216,25.367526744323605
5778,C3_04130W_A,482,C3,863945,864979,1034,55.329105833490445,69.36427484381602
5780,C3_04140C_A,3665,C3,865042,865578,536,811.5893538956685,1017.4628011042053
5782,C3_04150W_A,329,C3,865874,866186,312,125.1608362397049,156.91001171679432
5784,C3_04160W_A,231,C3,867053,868633,1580,17.353298813951007,21.755258290278945
5786,C3_04170W_A,40,C3,869575,869979,404,11.751837523484888,14.73289104566488
5788,C3_04180W_A,2364,C3,870556,871371,815,344.28413919722027,431.6176684205066
5790,C3_04190W_A,243,C3,872065,872355,290,99.45701666858263,124.68598101163902
5792,C3_04200W_A,736,C3,872655,873911,1256,69.55291354663794,87.19619337345101
5794,C3_04210W_A,45,C3,874795,875313,518,10.311216514331818,12.926832008213683
5796,C3_04220C_A,438,C3,875584,877221,1637,31.757958971528677,39.81390556372162
5798,C3_04230W_A,355,C3,877509,880106,2597,16.22495704291685,20.34069343251114
5800,C3_04240C_A,6,C3,881322,881645,323,2.2048339130748738,2.7641275460287673
5802,C3_04250W_A,927,C3,883024,884100,1076,102.25736912744604,128.1966905141697
5804,C3_04260W_A,1180,C3,885203,886766,1563,89.60870096282333,112.339472477437
5806,C3_04270C_A,240,C3,886986,887941,955,29.828747808300903,37.395317167216405
5808,C3_04290C_A,1080,C3,890865,892955,2090,61.33447067281012,76.89300264407298
5810,C3_04300C_A,2029,C3,893246,897658,4412,54.585047866052456,68.4314739142579
5812,C3_04310C_A,100,C3,898103,898993,890,13.336354942381725,16.71934826530509
5814,C3_04320W_A,363,C3,899511,900371,860,50.09972315389842,62.80837027990831
5816,C3_04330C_A,1394,C3,900521,900976,455,363.64576094099584,455.89069491941564
5818,C3_04340W_A,1551,C3,901780,903258,1478,124.55596075043512,156.15169926890727
5820,C3_04350C_A,397,C3,903462,904355,893,52.76746127426355,66.15282556080903
5822,C3_04360W_A,472,C3,905118,907424,2306,24.294605308741176,30.457345270118655
5824,C3_04370C_A,690,C3,907472,910834,3362,24.360070107425987,30.539416328744363
5826,C3_04380C_A,1063,C3,911155,911535,380,332.0296136931337,416.25457403571545
5828,C3_04390W_A,1349,C3,912024,912804,780,205.27898855606313,257.35149642061464
5830,C3_04400C_A,727,C3,913107,915428,2321,37.178034202366426,46.608875088756356
5832,C3_04410C_A,1258,C3,915591,918926,3335,44.77256288032812,56.12988517181674
5834,C3_04420W_A,1690,C3,919600,922284,2684,74.73625733545586,93.69438049867878
5836,C3_04430W_A,5473,C3,922611,923421,810,801.9874670826309,1005.4252323438658
5838,C3_04440C_A,69,C3,923719,925423,1704,4.806253268847781,6.025441179415408
5840,C3_04450C_A,18,C3,925625,926464,839,2.546464912716987,3.192419060908075
5842,C3_04460W_A,879,C3,927344,930337,2993,34.85854939851202,43.70101350294295
5844,C3_04470W_A,2129,C3,931012,934305,3293,76.7381072225154,96.20403366712036
5846,C3_04480C_A,167,C3,934439,935401,962,20.604807017528024,25.831566867695376
5848,C3_04490W_A,840,C3,939148,940800,1652,60.35265711213426,75.66213537010947
5850,C3_04500C_A,13596,C3,941278,942286,1008,1600.950027767793,2007.058239319725
5852,C3_04510W_A,286,C3,942851,943153,302,112.40515851105447,140.9186393195615
5854,C3_04520C_A,2107,C3,943416,945122,1706,146.59280702580588,183.77856651552207
5856,C3_04530C_A,486,C3,949762,951993,2231,25.856149559739094,32.41500178697921
5858,C3_04540C_A,557,C3,958062,960341,2279,29.009351626094308,36.36806720298241
5860,C3_04550C_A,2855,C3,960570,961817,1247,271.74828460982235,340.6818602624456
5862,C3_04560W_A,3064,C3,962464,965664,3200,113.64908273024146,142.47810607986364
5864,C3_04570C_A,92,C3,965801,967807,2006,5.443572994427795,6.8244278961275215
5866,C3_04580C_A,402,C3,968946,970256,1310,36.42351962813232,45.662965056189734
5868,C3_04590W_A,1365,C3,973774,975360,1586,102.15429257094854,128.06746683547217
5870,C3_04600C_A,116,C3,975446,975751,305,45.142468336114405,56.59362343967532
5872,C3_04610W_A,112,C3,976463,978352,1889,7.037415884894708,8.822576151856067
5874,C3_04620C_A,241,C3,978529,978939,410,69.76865296564527,87.46665876647045
5876,C3_04630W_A,409,C3,980490,981581,1091,44.49648544982925,55.78377600415862
5878,C3_04640W_A,725,C3,985016,988408,3392,25.369348545317834,31.804715413290417
5880,C3_04650W_A,103,C3,989048,990181,1133,10.790323544290668,13.527472687383208
5882,C3_04660C_A,83,C3,990298,991251,953,10.337424339913307,12.959687894628402
5884,C3_04670C_A,5558,C3,991751,992554,803,821.5427158790072,1029.9410026914502
5886,C3_04680W_A,3143,C3,993011,993346,335,1113.5935996918247,1396.0755618534317
5888,C3_04690C_A,325,C3,993464,994486,1022,37.745016311975675,47.31968185655085
5890,C3_04700W_A,437,C3,994723,995823,1100,47.15371388855022,59.115055643864615
5892,C3_04710W_A,44,C3,995983,996873,890,5.86799617464796,7.356513236734239
5894,C3_04720C_A,397,C3,996870,999467,2597,18.144529425459126,22.747198007625133
5896,C3_04730C_A,10,C3,1000090,1001517,1427,0.8317698597561133,1.0427624356076755
5898,C3_04740C_A,343,C3,1004284,1006173,1889,21.552086147490044,27.019139465059208
5900,C3_04750W_A,234,C3,1006868,1008700,1832,15.160640176312327,19.00639448543907
5902,C3_04760C_A,2451,C3,1008831,1014887,6056,48.03796451083566,60.22361148027389
5904,C3_04770C_A,489,C3,1015233,1017383,2150,26.99588388127419,33.84384910950432
5906,C3_04780C_A,406,C3,1018054,1019091,1037,46.47018799305894,58.25814177613636
5908,C3_04790W_A,262,C3,1019402,1020850,1448,21.476320755970793,26.924154892982322
5910,C3_04800C_A,601,C3,1020896,1022662,1766,40.393447877296495,50.639933146257306
5912,C3_04810C_A,10624,C3,1023134,1024411,1277,987.4709245732066,1237.9597244622953
5914,C3_04820C_A,2489,C3,1024767,1030286,5519,53.52931116490927,67.10793163759102
5916,C3_04830C_A,20473,C3,1030626,1036280,5654,429.78656405109507,538.8092379937674
5918,C3_04840C_A,223,C3,1037259,1038575,1316,20.1129663025418,25.21496238765274
5920,C3_04850C_A,1,C3,1038960,1039044,84,1.413018559371397,1.7714547566811343
5922,C3_04860W_A,3978,C3,1041331,1042668,1337,353.15106780184817,442.73384431900854
5924,C3_04870W_A,31,C3,1043577,1045197,1620,2.271296499137727,2.847449497776342
5926,C3_04880W_A,3096,C3,1045564,1046421,857,428.7926004951727,537.5631386715548
5928,C3_04890W_A,2289,C3,1047887,1052386,4499,60.38887675521109,75.70754274185859
5930,C3_04900W_A,855,C3,1052736,1055264,2528,40.14358897707822,50.32669328514204
5932,C3_04910C_A,2634,C3,1056652,1057164,512,610.6227233833552,765.5175657114083
5934,C3_04920C_A,667,C3,1059572,1060321,749,105.69907055335199,132.5114380605215
5936,C3_04930C_A,1821,C3,1060721,1062967,2246,96.23373593752733,120.64506028538425
5938,C3_04940W_A,460,C3,1064140,1065189,1049,52.048653130706185,65.25167950253483
5940,C3_04950W_A,3221,C3,1066127,1066672,545,701.4898229316747,879.4346509847237
5942,C3_04960W_A,1140,C3,1067838,1068640,802,168.7165302311783,211.51434850347312
5944,C3_04970C_A,932,C3,1068899,1072126,3227,34.28025936661541,42.9760303659909
5946,C3_04980W_A,1,C3,1072322,1072663,341,0.34807495304163444,0.43637008668978094
5948,C3_04990W_A,1135,C3,1073082,1074314,1232,109.34836806044561,137.08644196589233
5950,C3_05000W_A,1574,C3,1075012,1075623,611,305.76704066423673,383.3300525521324
5952,C3_05010C_A,348,C3,1076055,1078643,2588,15.960339461956988,20.008951100194327
5954,C3_05020W_A,163,C3,1078882,1080726,1844,10.491892687046187,13.15333976598595
5956,C3_05030W_A,728,C3,1081001,1081912,911,94.85061574388548,118.91108812356171
5958,C3_05040C_A,388,C3,1082115,1084973,2858,16.11375118510587,20.20127831691796
5960,C3_05050W_A,371,C3,1087547,1088407,860,51.20384928401188,64.19257678745451
5962,C3_05060W_A,200,C3,1089895,1091235,1340,17.715456565253337,22.2092835165993
5964,C3_05070W_A,344,C3,1091284,1092609,1325,30.815535314411996,38.632420112496646
5966,C3_05080W_A,110,C3,1093188,1094402,1214,10.75477058368345,13.482901113454433
5968,C3_05090C_A,341,C3,1094445,1096175,1730,23.395666829268386,29.33037575166151
5970,C3_05100C_A,8124,C3,1096555,1097574,1019,946.2870198351239,1186.3288216244484
5972,C3_05110W_A,396,C3,1097924,1098925,1001,46.95569366526489,58.86680422201924
5974,C3_05120C_A,297,C3,1099004,1099615,611,57.6955597695542,72.33102008131087
5976,C3_05130C_A,108,C3,1099836,1100900,1064,12.047842453587702,15.103982662228619
5978,C3_05140C_A,598,C3,1101306,1102724,1418,50.05553474918478,62.75297273456046
5980,C3_05150W_A,2204,C3,1103435,1104862,1427,183.32207709024735,229.82484080793165
5982,C3_05160C_A,2667,C3,1104957,1107683,2726,116.12462282423161,145.58160903512882
5984,C3_05170W_A,1436,C3,1118725,1120065,1340,127.19697813851896,159.46265564918295
5986,C3_05180W_A,183,C3,1126468,1127022,554,39.207439160030894,49.153073140257035
5988,C3_05190C_A,2232,C3,1127463,1128809,1346,196.8231973695576,246.75074994103454
5990,C3_05200W_A,7058,C3,1130252,1131056,804,1041.964103646317,1306.2760255013154
5992,C3_05210C_A,1864,C3,1131286,1143771,12485,17.720848534412163,22.21604325046899
5994,C3_05220W_A,27799,C3,1146045,1150550,4505,732.422252227547,918.2136172257989
5996,C3_05230W_A,103,C3,1151651,1152847,1196,10.221936936188401,12.814905146158173
5998,C3_05240C_A,4915,C3,1153146,1153934,788,740.3284802310596,928.1253944712856
6000,C3_05250C_A,518,C3,1154421,1156208,1787,34.40585537513611,43.13348593884137
6002,C3_05270C_A,557,C3,1158476,1160710,2234,29.593693982036225,37.100637938942214
6004,C3_05280C_A,511,C3,1161511,1162572,1061,57.165323885445666,71.66628084427994
6006,C3_05290C_A,151,C3,1163817,1166642,2825,6.3443282856873635,7.953675091590623
6008,C3_05300C_A,109,C3,1168301,1170169,1868,6.925908955891067,8.682783593240078
6010,C3_05310W_A,2291,C3,1171323,1174715,3392,80.16714140320435,100.5029007059977
6012,C3_05320W_A,776,C3,1178238,1181699,3461,26.612598027756473,33.36333627838863
6014,C3_05330C_A,20,C3,1181872,1182843,971,2.4447694951019026,3.064926870467874
6016,C3_05340W_A,41,C3,1183239,1184501,1262,3.8561298878566497,4.834302838359609
6018,C3_05350C_A,215,C3,1184605,1186257,1652,15.44740628465341,19.365903695920878
6020,C3_05360C_A,1124,C3,1186862,1190638,3776,35.33145135106193,44.29387508125158
6022,C3_05370C_A,13232,C3,1193027,1194203,1176,1335.504398400166,1674.277810028912
6024,C3_05380W_A,203,C3,1195336,1197177,1841,13.087882930147238,16.40784709990587
6026,C3_05390C_A,53,C3,1197250,1199196,1946,3.2326611646050667,4.052680666364034
6028,C3_05400C_A,7,C3,1199156,1199485,329,2.525394872068029,3.166004245983304
6030,C3_05410W_A,1188,C3,1201743,1204085,2342,60.2083467450002,75.48121822319546
6032,C3_05420W_A,228,C3,1205701,1207458,1757,15.402465252749572,19.309562606691564
6034,C3_05430W_A,100,C3,1207783,1209570,1787,6.642057022227048,8.326927787421113
6036,C3_05440C_A,153,C3,1209706,1210995,1289,14.08852949964406,17.66232469578428
6038,C3_05450C_A,166,C3,1216080,1217252,1172,16.81154504426174,21.07607946003561
6040,C3_05460W_A,350,C3,1226660,1228948,2288,18.156794425489107,22.762574233577517
6042,C3_05470W_A,363,C3,1229344,1232046,2702,15.945877835807787,19.990821036536325
6044,C3_05480C_A,4,C3,1232492,1232565,73,6.503756656832731,8.153545181436453
6046,C3_05490C_A,1,C3,1232581,1232654,73,1.6259391642081829,2.038386295359113
6048,C3_05500W_A,10,C3,1233522,1233619,97,12.23644938012344,15.340432944455184
6050,C3_05510W_A,260,C3,1233917,1236124,2207,13.98292946836036,17.529937419989114
6052,C3_05520C_A,1852,C3,1236311,1238911,2600,84.54633509395751,105.99295137975797
6054,C3_05530W_A,677,C3,1240041,1241453,1412,56.90902226227523,71.34496395392547
6056,C3_05540C_A,35,C3,1241446,1241769,323,12.861531159603429,16.124077351834472
6058,C3_05550C_A,169,C3,1241895,1242686,791,25.35930653455923,31.79212607565788
6060,C3_05560W_A,865,C3,1243106,1243750,644,159.42535485081632,199.8663084168497
6062,C3_05570W_A,1235,C3,1245025,1246539,1514,96.82070366525015,121.3809223633427
6064,C3_05580C_A,1279,C3,1246780,1248546,1766,85.96209623138472,107.76784441607833
6066,C3_05590C_A,3100,C3,1250579,1251688,1109,331.78542187584475,415.9484388095288
6068,C3_05600W_A,135,C3,1252997,1253842,845,18.962876287895437,23.773132474277
6070,C3_05610W_A,475,C3,1254541,1256598,2057,27.40857584779715,34.36122741447606
6072,C3_05620W_A,72,C3,1257308,1258150,842,10.149567989404048,12.724178584807008
6074,C3_05630W_A,5,C3,1258947,1259750,803,0.7390632564582651,0.9265392251632334
6076,C3_05640W_A,8,C3,1260221,1261498,1277,0.7435775034436796,0.9321985876975116
6078,C3_05650W_A,2106,C3,1263720,1265207,1487,168.10264642033465,210.74474261998617
6080,C3_05660C_A,6,C3,1266051,1267238,1187,0.5999674422267769,0.7521593912108608
6082,C3_05670C_A,37,C3,1269469,1269789,320,13.723942757894694,17.205254324265518
6084,C3_05680W_A,792,C3,1269788,1270519,731,128.598219860274,161.2193461730267
6086,C3_05700W_A,3793,C3,1275033,1277288,2255,199.6473034316805,250.2912385524122
6088,C3_05710W_A,22907,C3,1279081,1279656,575,4728.544966469095,5928.020844084797
6090,C3_05720C_A,676,C3,1279891,1282809,2918,27.49720557756868,34.47233958306427
6092,C3_05730C_A,309,C3,1283574,1284857,1283,28.586367675014795,35.837786176473514
6094,C3_05740C_A,342,C3,1286414,1287718,1304,31.129752433758817,39.026343749950634
6096,C3_05750C_A,67,C3,1288112,1288444,332,23.953218229344046,30.02935955000429
6098,C3_05760W_A,990,C3,1289599,1290645,1046,112.33902810451758,140.83573381032804
6100,C3_05770C_A,134,C3,1290741,1292264,1523,10.443162773660175,13.092248681026165
6102,C3_05780C_A,3869,C3,1292710,1294905,2195,209.21429600066813,262.28506155004186
6104,C3_05790C_A,83,C3,1298064,1298540,476,20.696565957851643,25.946602024329557
6106,C3_05800W_A,519,C3,1298785,1300203,1418,43.44284704820552,54.46286429638275
6108,C3_05810C_A,1032,C3,1300265,1302478,2213,55.35099542466682,69.3917171022025
6110,C3_05820W_A,6,C3,1305719,1305824,105,6.782489084982706,8.502982832069446
6112,C3_05830W_A,2492,C3,1306093,1308315,2222,133.1162686751106,166.88347493544038
6114,C3_05840W_A,66,C3,1309841,1311451,1610,4.865698691400637,6.099965944745471
6116,C3_05850W_A,152,C3,1312151,1313869,1718,10.501409176981372,13.16527027549751
6118,C3_05860C_A,175,C3,1313895,1314956,1061,19.577165714193722,24.54324686447943
6120,C3_05870C_A,651,C3,1315290,1317704,2414,32.008909238055296,40.12851363477679
6122,C3_05880C_A,1590,C3,1318841,1320373,1532,123.18717936660822,154.43570319995584
6124,C3_05890W_A,142,C3,1321857,1323116,1259,13.387200457650538,16.78309161055804
6126,C3_05900W_A,289,C3,1323692,1324687,995,34.4748126103518,43.21993534994092
6128,C3_05910W_A,520,C3,1325453,1328761,3308,18.65799597138532,23.39091407854654
6130,C3_05920W_A,935,C3,1329263,1332589,3326,33.366950587200705,41.83104527652925
6132,C3_05930W_A,1666,C3,1333825,1336875,3050,64.83392435169534,81.280152284913
6134,C3_05940C_A,57,C3,1336989,1337603,614,11.018783163306594,13.81388497555256
6136,C3_05950W_A,240,C3,1337786,1340074,2288,12.450373320335386,15.60862233159601
6138,C3_05960W_A,316,C3,1340442,1343162,2720,13.789398764689105,17.287314360788244
6140,C3_05970C_A,932,C3,1343332,1344948,1616,68.45445357429946,85.81909034099792
6142,C3_05980C_A,401,C3,1345603,1347867,2264,21.023019944287164,26.355866618395464
6144,C3_05990C_A,317,C3,1349838,1352354,2516,14.95463362438059,18.74813086681449
6146,C3_06000W_A,1263,C3,1362512,1364386,1874,79.99464514451988,100.28664783661415
6148,C3_06010W_A,2507,C3,1366624,1368091,1467,202.83895867818933,254.29251145192003
6150,C3_06020W_A,692,C3,1368673,1369779,1106,74.26396276594987,93.10228037645659
6152,C3_06030W_A,1842,C3,1370186,1372108,1922,113.75314029886448,142.60855962110227
6154,C3_06040W_A,165,C3,1373713,1375218,1505,13.012915104908679,16.313862410365793
6156,C3_06050C_A,656,C3,1375404,1376279,875,88.98625679497312,111.5591347567511
6158,C3_06060W_A,794,C3,1376548,1378191,1643,57.36012528048369,71.91049692733107
6160,C3_06070C_A,1402,C3,1378314,1379951,1637,101.65447141114886,127.44085753501763
6162,C3_06080W_A,938,C3,1380538,1385430,4892,22.75849516148633,28.531574650126725
6164,C3_06090C_A,589,C3,1385507,1386664,1157,60.423946623560276,75.7515086789592
6166,C3_06100C_A,5509,C3,1387874,1389892,2018,324.0251815958723,406.2196815573514
6168,C3_06110C_A,1175,C3,1391037,1392815,1778,78.43921924069565,98.33666168977952
6170,C3_06120C_A,2378,C3,1393714,1395513,1799,156.8945432304365,196.69351337219007
6172,C3_06130W_A,4,C3,1395597,1395914,317,1.4977105234977584,1.877630278374956
6174,C3_06140W_A,116,C3,1397002,1398207,1205,11.426101943995763,14.324527094689605
6176,C3_06150W_A,714,C3,1399074,1402343,3269,25.92450324773904,32.5006945508436
6178,C3_06160C_A,1,C3,1402376,1403161,785,0.15120198597095202,0.1895569421161978
6180,C3_06170C_A,1,C3,1404228,1405019,791,0.15005506825182977,0.18811908920507622
6182,C3_06180C_A,1,C3,1405934,1406524,590,0.20117552370711414,0.2522071179003649
6184,C3_06190C_A,223,C3,1407764,1411864,4100,6.455771622962198,8.093387927353906
6186,C3_06200C_A,210,C3,1416009,1416827,818,30.471451573730377,38.20105367708461
6188,C3_06210C_A,1017,C3,1417168,1419369,2201,54.84386619263049,68.75594591265605
6190,C3_06220C_A,51,C3,1419828,1420880,1052,5.754155426185423,7.213794845648269
6192,C3_06230W_A,2156,C3,1421438,1424542,3104,82.44307769858166,103.35616696326679
6194,C3_06240C_A,207,C3,1424631,1424843,212,115.89418259598988,145.2927137225074
6196,C3_06250W_A,879,C3,1425217,1425864,647,161.25446421908265,202.15940249506684
6198,C3_06260C_A,317,C3,1425861,1427921,2060,18.264979708224057,22.898202553837496
6200,C3_06270C_A,115,C3,1428461,1429165,704,19.3888626186473,24.3071774851417
6202,C3_06280W_A,894,C3,1429597,1430595,998,106.32469111678802,133.2957579235736
6204,C3_06290W_A,921,C3,1431324,1433579,2255,48.47750236239857,60.77464558575578
6206,C3_06300W_A,1349,C3,1434184,1438215,4031,39.721560673214896,49.79761032202418
6208,C3_06310C_A,582,C3,1438401,1441571,3170,21.791688116892384,27.319520550355616
6210,C3_06320W_A,362,C3,1446503,1451209,4706,9.130273768245951,11.446323043170405
6212,C3_06330W_A,1,C3,1452363,1452953,590,0.20117552370711414,0.2522071179003649
6214,C3_06340W_A,35,C3,1453205,1453747,542,7.664713218730456,9.608998126646743
6216,C3_06350W_A,11,C3,1453866,1454657,791,1.6506057507701277,2.0693099812558384
6218,C3_06360C_A,2313,C3,1454762,1455369,607,452.2869883647241,567.017277734911
6220,C3_06370C_A,631,C3,1455629,1456801,1172,63.904126041741925,80.11449481495465
6222,C3_06380W_A,1,C3,1456914,1457699,785,0.15120198597095202,0.1895569421161978
6224,C3_06390W_A,1,C3,1457202,1457699,497,0.23882003820361639,0.2994008039461072
6226,C3_06400C_A,563,C3,1457924,1458991,1067,62.62837273644997,78.51512497934789
6228,C3_06410C_A,302,C3,1459414,1460436,1022,35.073830542205094,43.97090437131802
6230,C3_06420C_A,425,C3,1460652,1461866,1214,41.55252270968606,52.093027029255765
6232,C3_06430W_A,1365,C3,1462286,1463470,1184,136.8384358256118,171.5498331090024
6234,C3_06440W_A,4329,C3,1463534,1466824,3290,156.17763430260712,195.7947482980246
6236,C3_06450W_A,162,C3,1467909,1468994,1085,17.721987609148364,22.217471270891128
6238,C3_06460C_A,3,C3,1469508,1469605,97,3.670934814037032,4.602129883336556
6240,C3_06470W_A,2029,C3,1477198,1479036,1838,131.0278733324393,164.26532258417075
6242,C3_06480C_A,547,C3,1479207,1479679,472,137.55376433473933,172.44661686437448
6244,C3_06490W_A,949,C3,1481888,1482811,923,122.03703952204799,152.9938108164608
6246,C3_06500W_A,5795,C3,1483052,1486117,3065,224.4140862416994,281.340537180177
6248,C3_06510C_A,67,C3,1486242,1490213,3971,2.0026362256716754,2.510638975220706
6250,C3_06520C_A,192,C3,1490884,1491810,926,24.610327565380015,30.85315584854572
6252,C3_06530W_A,164,C3,1492058,1492954,896,21.725160350335234,27.23611688397244
6254,C3_06540C_A,19,C3,1492993,1493760,767,2.940257654180899,3.6861040308514865
6256,C3_06550C_A,286,C3,1493769,1494794,1025,33.11839792228141,41.51944299951958
6258,C3_06560W_A,636,C3,1496301,1497788,1487,50.76604136910392,63.64371144649154
6260,C3_06570C_A,85,C3,1498396,1499073,677,14.902440936354175,18.682698615514475
6262,C3_06580W_A,31,C3,1501918,1503543,1625,2.2643078945249955,2.838688114706261
6264,C3_06590W_A,3723,C3,1504006,1505340,1334,331.25646185107627,415.2852990752658
6266,C3_06600C_A,151,C3,1505399,1507120,1721,10.414135622932482,13.055858299676645
6268,C3_06610W_A,443,C3,1508187,1509278,1091,48.195459790401856,60.42105811697376
6270,C3_06620W_A,658,C3,1510924,1514895,3971,19.66768114167108,24.656723070077977
6272,C3_06630W_A,178,C3,1515330,1517540,2210,9.559933710281054,11.984973539319602
6274,C3_06640W_A,134,C3,1517766,1518587,821,19.3726393474841,24.286838905240984
6276,C3_06650C_A,434,C3,1518671,1520230,1559,33.04233778091318,41.424088909279945
6278,C3_06660C_A,76,C3,1520428,1521507,1079,8.360250679357737,10.480970497360854
6280,C3_06670C_A,188,C3,1523520,1524584,1064,20.972170196986,26.29211796758315
6282,C3_06680C_A,705,C3,1525242,1526126,884,94.65945597960877,118.67143743286965
6284,C3_06690C_A,372,C3,1526530,1526895,365,120.96987381708881,151.65594037471806
6286,C3_06700C_A,4975,C3,1527476,1529317,1841,320.7498402831651,402.11349419720045
6288,C3_06710W_A,1211,C3,1533041,1535032,1991,72.19382216649726,90.50701339459152
6290,C3_06720W_A,1135,C3,1535326,1537980,2654,50.760056311405044,63.6362081770834
6292,C3_06730W_A,197,C3,1538299,1539096,797,29.338307553924565,36.78046839844343
6294,C3_06740W_A,634,C3,1539368,1541332,1964,38.31553788079589,48.03492592760209
6296,C3_06750W_A,148,C3,1541633,1541839,206,85.2749841267243,106.90643463621292
6298,C3_06760W_A,286,C3,1542502,1543329,827,41.047591137047704,51.46001097280239
6300,C3_06770W_A,362,C3,1543770,1544822,1052,40.843220868218104,51.203798708326936
6302,C3_06780C_A,310,C3,1544843,1546036,1193,30.84241683657266,38.66612059008947
6304,C3_06790W_A,200,C3,1548990,1550393,1403,16.919965643221293,21.212002788484
6306,C3_06800C_A,140,C3,1550697,1551773,1076,15.443399868222704,19.360880983801245
6308,C3_06810W_A,287,C3,1552208,1554631,2423,14.059038972070013,17.625353394167885
6310,C3_06820C_A,917,C3,1554678,1556225,1547,70.3568155082482,88.20401874443078
6312,C3_06830C_A,1720,C3,1556453,1560565,4112,49.648084012154534,62.24216518611145
6314,C3_06840C_A,1,C3,1560848,1560943,95,1.2494058840757616,1.5663389427496346
6316,C3_06850W_A,2785,C3,1568451,1570004,1553,212.85354911741445,266.8474731345683
6318,C3_06860C_A,1054,C3,1572462,1573310,848,147.52713581663446,184.94990369990674
6320,C3_06870W_A,37429,C3,1574865,1575872,1007,4411.699324063366,5530.801913978876
6322,C3_06880W_A,25,C3,1576153,1576956,803,3.695316282291325,4.6326961258161665
6324,C3_06890W_A,3010,C3,1577290,1579599,2309,154.7282860768575,193.97774823701081
6326,C3_06900W_A,121,C3,1580008,1580706,698,20.575817532164585,25.795223706170557
6328,C3_06910C_A,430,C3,1580822,1582753,1931,26.430984134901536,33.135652931808686
6330,C3_06920W_A,427,C3,1584075,1585043,968,52.357592652410396,65.63898678991625
6332,C3_06940W_A,1437,C3,1585276,1587105,1829,93.25458953778163,116.91020271704011
6334,C3_06950W_A,539,C3,1591959,1594790,2831,22.598314480430723,28.330761414162854
6336,C3_06960C_A,2,C3,1595078,1595193,115,2.0642358084729975,2.5878643401950483
6338,C3_06970W_A,240,C3,1595830,1597650,1820,15.65189788842163,19.62226807400641
6340,C3_06980W_A,127,C3,1597909,1599021,1112,13.555829128933512,16.99449581319635
6342,C3_06990W_A,53,C3,1599406,1600539,1133,5.55230240628549,6.960738373119514
6344,C3_07000W_A,1067,C3,1600835,1602568,1733,73.07906949759929,91.6168187719658
6346,C3_07010W_A,720,C3,1603060,1604628,1568,54.50214443289675,68.32754061484376
6348,C3_07020W_A,5781,C3,1607932,1611174,3242,211.64943383867612,265.33791352973026
6350,C3_07030C_A,368,C3,1611520,1614048,2528,17.278176308262907,21.661079682961716
6352,C3_07040C_A,204,C3,1614394,1615095,701,34.54134954834274,43.3033505142481
6354,C3_07050W_A,81,C3,1615420,1615779,359,26.78044088569077,33.57375533275331
6356,C3_07060W_A,1083,C3,1616538,1617209,671,191.572465548636,240.16808066288547
6358,C3_07070C_A,747,C3,1617559,1618656,1097,80.82414636594022,101.32656615517575
6360,C3_07080W_A,311,C3,1620223,1621497,1274,28.974644305351944,36.32455577985711
6362,C3_07090W_A,1606,C3,1622261,1622671,410,464.93135544741216,582.8691036471018
6364,C3_07100C_A,1247,C3,1623757,1626420,2663,55.58049870711044,69.67943779678387
6366,C3_07110W_A,366,C3,1628166,1631963,3797,11.441096283727742,14.343325003793732
6368,C3_07120W_A,89,C3,1632270,1633007,737,14.333414857341337,17.969329390703066
6370,C3_07130W_A,40,C3,1633324,1633997,673,7.054594887797763,8.84411290111235
6372,C3_07140C_A,461,C3,1634324,1636125,1801,30.381860462575226,38.08873625636882
6374,C3_07150C_A,2587,C3,1636561,1636992,431,712.4367450113215,893.1584460901715
6376,C3_07160W_A,144,C3,1637897,1639189,1292,13.22900347844924,16.5847652761726
6378,C3_07170C_A,844,C3,1639579,1641591,2012,49.78994223916231,62.42000816583782
6380,C3_07180C_A,124,C3,1643662,1645716,2054,7.16553131178796,8.983190236412218
6382,C3_07200C_A,64,C3,1649675,1651255,1580,4.807840364038373,6.0274308683023925
6384,C3_07210W_A,85,C3,1652454,1653311,857,11.77240666734163,14.758677902804317
6386,C3_07220C_A,493,C3,1653321,1654661,1340,43.668600433349475,54.74588386841726
6388,C3_07230W_A,1546,C3,1655226,1659188,3962,46.31505355734657,58.06365485149895
6390,C3_07240W_A,33,C3,1660226,1660924,698,5.61158659968125,7.035061010773789
6392,C3_07250W_A,644,C3,1661263,1662765,1502,50.89124633006331,63.80067677591388
6394,C3_07260C_A,2129,C3,1662823,1668402,5579,45.29460245272328,56.78434896322412
6396,C3_07270C_A,5888,C3,1668585,1669274,689,1014.3217348572106,1271.6216995884406
6398,C3_07280C_A,715,C3,1670305,1671261,956,88.77185635548756,111.29034799818926
6400,C3_07290W_A,1207,C3,1673212,1675362,2150,66.63401195234754,83.5368627304125
6402,C3_07300W_A,808,C3,1675626,1676816,1190,80.59192912744156,101.0354430634134
6404,C3_07310C_A,11483,C3,1677116,1680709,3593,379.33708261897783,475.5623872979224
6406,C3_07320W_A,1597,C3,1682965,1687116,4151,45.664566056987276,57.248160129911064
6408,C3_07330W_A,509,C3,1687597,1688466,869,69.52246435498671,87.15802022630447
6410,C3_07340W_A,1216,C3,1688903,1689790,887,162.71856564648473,203.99489815832897
6412,C3_07350W_A,814,C3,1690050,1690943,893,108.19323294017767,135.63828717002156
6414,C3_07360W_A,935,C3,1691219,1692820,1601,69.31822464274174,86.9019716363125
6416,C3_07370W_A,920,C3,1693663,1694244,581,187.94849271638827,235.62482546698462
6418,C3_07380W_A,677,C3,1694611,1695268,657,122.30675712988221,153.33194688423552
6420,C3_07390C_A,891,C3,1695339,1696043,704,150.22153559317164,188.3277838196631
6422,C3_07400W_A,316,C3,1696236,1697117,881,42.57339913729213,53.37286613092398
6424,C3_07410C_A,7579,C3,1697167,1698951,1784,504.24802890356995,632.1591202211047
6426,C3_07420W_A,1243,C3,1699250,1700236,986,149.6309267962336,187.5873570533373
6428,C3_07430W_A,651,C3,1700498,1701494,996,77.57982620548744,97.25926899031242
6430,C3_07440W_A,5637,C3,1701963,1702709,746,896.884171596289,1124.394100437762
6432,C3_07450C_A,220,C3,1702725,1703696,971,26.892464446120925,33.71419557514662
6434,C3_07460W_A,1208,C3,1704278,1706584,2306,62.17771867152403,77.95015484386299
6436,C3_07470W_A,145,C3,1707692,1708939,1247,13.801576626418296,17.302581344327358
6438,C3_07480W_A,570,C3,1709297,1710637,1340,50.48905121097201,63.296458022308
6440,C3_07490W_A,1348,C3,1710784,1712634,1850,86.48590135932001,108.42452162622605
6442,C3_07500W_A,842,C3,1713090,1714644,1554,64.31143929679548,80.6251300067846
6444,C3_07510C_A,19,C3,1714800,1714923,123,18.33477740452642,22.98570562327716
6446,C3_07520W_A,1,C3,1715652,1715724,72,1.648521652599963,2.06669721612799
6448,C3_07530W_A,2,C3,1715733,1715820,87,2.728587562924077,3.420740219798052
6450,C3_07540C_A,400,C3,1715989,1716855,866,54.823814774687,68.73080811141584
6452,C3_07550C_A,976,C3,1719339,1721228,1889,61.32605271122531,76.88244932331716
6454,C3_07560W_A,3606,C3,1729949,1732195,2246,190.56499274614143,238.90504524387458
6456,C3_07570C_A,140,C3,1732312,1733178,866,19.188335171140448,24.055782838995544
6458,C3_07580W_A,322,C3,1733433,1733702,269,142.07927878764886,178.12010505097146
6460,C3_07590W_A,159,C3,1733947,1734279,332,56.84420445471199,71.2637040067266
6462,C3_07600W_A,345,C3,1734635,1735285,650,62.99888900089706,78.97962899787579
6464,C3_07610W_A,1423,C3,1735459,1739046,3587,47.08696248641813,59.03137161293821
6466,C3_07620C_A,447,C3,1739081,1740394,1313,40.408241330751885,50.65847921086309
6468,C3_07630C_A,1182,C3,1740463,1741461,998,140.57694060407542,176.23667322781213
6470,C3_07640C_A,5464,C3,1741637,1743169,1532,423.33003022587883,530.7148945185903
6472,C3_07650C_A,217,C3,1743425,1745305,1880,13.700267180969057,17.175573034459422
6474,C3_07660W_A,523,C3,1745619,1747748,2129,29.15769438717906,36.554039629175946
6476,C3_07670W_A,499,C3,1748233,1748973,740,80.03795396569119,100.34094267708977
6478,C3_07680W_A,981,C3,1749088,1753920,4832,24.097347137094495,30.210049207274874
6480,C3_07690C_A,320,C3,1753937,1754744,807,47.06559959839301,59.00458966491808
6482,C3_07700W_A,599,C3,1754845,1755624,779,91.26757616602211,114.41914959841843
6484,C3_07710W_A,1049,C3,1755737,1757161,1424,87.43647709099018,109.61622706440649
6486,C3_07720C_A,2,C3,1757860,1758168,308,0.770737396020762,0.9662480490988005
6488,C3_07730W_A,952,C3,1761811,1763016,1205,93.77283664382729,117.5599120184871
6490,C3_07740W_A,1627,C3,1763210,1765186,1976,97.72996987458002,122.52083941604113
6492,C3_07750W_A,1451,C3,1765306,1766643,1337,128.81402699358514,161.48989645723515
6494,C3_07760C_A,523,C3,1766636,1767562,926,67.03750685777993,84.04271098327817
6496,C3_07770C_A,366,C3,1767841,1768743,902,48.16168801476079,60.37871955588115
6498,C3_07780C_A,2830,C3,1768864,1771416,2552,131.6233432342353,165.0118435573038
6500,C3_07790W_A,558,C3,1772206,1773213,1007,65.77061163342218,82.45444623153736
6502,C3_07800C_A,569,C3,1773215,1773838,623,108.40551374593144,135.90441661369422
6504,C3_07810C_A,4539,C3,1773915,1775354,1439,374.39198349054124,469.36287964444483
6506,C3_07820W_A,241,C3,1775574,1775900,326,87.74585188930847,110.0040800437205
6508,C3_07830W_A,360,C3,1776048,1777043,995,42.9444032516493,53.837981750791464
6510,C3_07840C_A,1,C3,1776123,1776815,692,0.1715224840855453,0.21503208029077356
6512,C3_07850W_A,397,C3,1777118,1778428,1310,35.97049077703615,45.0950177296202
6514,C3_07860C_A,613,C3,1778415,1780547,2132,34.12718182887053,42.78412210648451
6516,C3_07870W_A,1,C3,1778544,1778849,305,0.3891592097940897,0.48787606413513207
6518,C3_07880C_A,116,C3,1780559,1781017,458,30.062124110294526,37.687893338648415
6520,C3_07890W_A,317,C3,1781080,1781346,266,141.450594732863,177.33194458986935
6522,C3_07900C_A,368,C3,1781343,1782407,1064,41.05190761963217,51.46542240463085
6524,C3_07910W_A,1,C3,1782289,1783212,923,0.12859540518656268,0.16121581750944236
6526,C3_07920W_A,641,C3,1782289,1784314,2025,37.57164015347828,47.10232588579703
6528,C3_07930C_A,1,C3,1783243,1783560,317,0.3744276308744396,0.469407569593739
6530,C3_07940W_A,533,C3,1784362,1785075,713,88.72884563839578,111.23642688096457
6532,C3_07950C_A,9089,C3,1785089,1786177,1088,991.5494095906589,1243.0727865918068
6534,C3_07970C_A,40,C3,1787605,1788114,509,9.327588132589185,11.693689552944226
6536,C3_07980C_A,6,C3,1795809,1796210,401,1.7759634761176661,2.2264668263523486
6538,C4_00010W_A,200,C4,983,1660,677,35.064566909068645,43.95929086003406
6540,C4_00020W_A,2847,C4,2845,3891,1046,323.05981112480964,405.0094284424282
6542,C4_00030C_A,400,C4,3894,4904,1010,47.00735009393955,58.93156418265952
6544,C4_00040W_A,2225,C4,5033,7435,2402,109.94719764634225,137.83717486415657
6546,C4_00050W_A,442,C4,7507,8355,848,61.86621824568541,77.55963703544475
6548,C4_00060W_A,250,C4,8369,8995,626,47.40158106517467,59.42579854681122
6550,C4_00070C_A,3330,C4,8937,11315,2378,166.21091313177763,208.37313899867405
6552,C4_00080C_A,589,C4,11383,12630,1247,56.062956089381906,70.28427870212975
6554,C4_00090W_A,570,C4,12793,14309,1516,44.627525476716684,55.94805656325377
6556,C4_00100C_A,517,C4,14306,15706,1400,43.83183571170074,54.95052655224879
6558,C4_00110C_A,1203,C4,15792,17456,1664,85.81030736874905,107.57755172604686
6560,C4_00120W_A,388,C4,17803,18462,659,69.8833093885168,87.61039974165634
6562,C4_00130W_A,1089,C4,19713,20438,725,178.2859113614592,223.51116596160477
6564,C4_00140C_A,5377,C4,21178,23694,2516,253.66266560976158,318.0085163118659
6566,C4_00150C_A,1787,C4,23853,25631,1778,119.29437002818992,149.55541654437104
6568,C4_00160C_A,5978,C4,25876,27186,1310,541.6412943705847,679.0378236465228
6570,C4_00170W_A,1418,C4,27530,27943,413,407.52413230955415,510.89956168959634
6572,C4_00180W_A,1131,C4,28147,29691,1544,86.94456943945609,108.99953866822183
6574,C4_00190W_A,241,C4,29746,30663,917,31.19427231833649,39.107230200930076
6576,C4_00200C_A,3995,C4,30660,31982,1322,358.68439345979834,449.6707921687254
6578,C4_00210W_A,130,C4,32585,33277,692,22.29792293112089,27.95417043780056
6580,C4_00220C_A,3679,C4,33383,34763,1380,316.4301474738399,396.6980378157326
6582,C4_00230W_A,353,C4,34782,35390,608,68.91254329355372,86.39338231103454
6584,C4_00240C_A,404,C4,35411,36235,824,58.19441484323754,72.95641823146964
6586,C4_00250W_A,1,C4,35436,35975,539,0.22021068457736057,0.27607087117108586
6588,C4_00260W_A,1072,C4,36910,39081,2171,58.60870347041712,73.47579821723757
6590,C4_00270W_A,44828,C4,39465,41389,1924,2765.485895154929,3466.998441751642
6592,C4_00280W_A,1017,C4,41651,43041,1390,86.84269747480555,108.87182514658701
6594,C4_00290C_A,85,C4,43184,44714,1530,6.594086610399853,8.26678886451196
6596,C4_00300C_A,1013,C4,45136,48099,2963,40.579336906524105,50.872976090283856
6598,C4_00310C_A,710,C4,48304,49311,1007,83.68662053715006,104.91515559926799
6600,C4_00320C_A,227,C4,49530,50508,978,27.549527494983433,34.53793384498555
6602,C4_00330C_A,1254,C4,50924,51205,281,529.6858468681335,664.0496734867045
6604,C4_00340W_A,1586,C4,51516,52568,1052,178.94295109666825,224.3348750038854
6606,C4_00350W_A,303,C4,52677,54014,1337,26.899138648557066,33.722562802579084
6608,C4_00360C_A,650,C4,54076,55311,1235,62.47029420378808,78.31694713748173
6610,C4_00370W_A,307,C4,56577,58400,1823,19.98843807409193,25.058845455454247
6612,C4_00380W_A,547,C4,58581,59564,983,66.04819609969172,82.80244472022864
6614,C4_00390W_A,1142,C4,59710,60150,440,308.06373718949857,386.2093452247906
6616,C4_00400W_A,1420,C4,60939,63332,2393,70.43245038103646,88.29883968948002
6618,C4_00410W_A,519,C4,63553,64113,560,110.00349484706327,137.90775280762634
6620,C4_00420C_A,1840,C4,64264,66699,2435,89.69041007656803,112.44190849800252
6622,C4_00430W_A,835,C4,67988,69430,1442,68.73032021796796,86.16493525216002
6624,C4_00440C_A,286,C4,69499,71742,2243,15.134354824047458,18.973441406378765
6626,C4_00450C_A,6,C4,72788,73540,752,0.9470230770255108,1.187251592243739
6628,C4_00460C_A,1115,C4,74264,77572,3308,40.00704905402813,50.15551768765267
6630,C4_00470C_A,874,C4,78356,80167,1811,57.282258727117885,71.81287819795813
6632,C4_00480W_A,219,C4,81574,83547,1973,13.174804570803964,16.516817893515533
6634,C4_00490W_A,60,C4,84041,85630,1589,4.481820981266105,5.618711122512848
6636,C4_00500W_A,536,C4,86313,89231,2918,21.802518031918364,27.333097657577586
6638,C4_00510C_A,600,C4,89384,90013,629,113.22120094168271,141.94168479607183
6640,C4_00520W_A,900,C4,90446,90919,473,225.84398115957214,283.1331492708113
6642,C4_00530C_A,5,C4,91405,92481,1076,0.5515499952936681,0.6914600351357587
6644,C4_00540C_A,1148,C4,93725,96778,3053,44.631577372192126,55.953136290951576
6646,C4_00550C_A,1,C4,97323,97393,70,1.6956222712456763,2.1257457080173614
6648,C4_00560C_A,438,C4,97569,98888,1319,39.41454043699199,49.41270917953927
6650,C4_00570C_A,1065,C4,99126,100499,1373,92.0674729216061,115.42195377472272
6652,C4_00580W_A,54,C4,100978,101433,455,14.086708099579466,17.66004126660577
6654,C4_00590C_A,1840,C4,101589,103595,2006,108.8714598885559,136.4885579225504
6656,C4_00600C_A,3842,C4,104411,107074,2663,171.24320451701547,214.68195670829482
6658,C4_00610W_A,233,C4,107335,108391,1056,26.18901443562214,32.832303501669664
6660,C4_00620C_A,97,C4,108410,108919,509,22.61940122152877,28.35719716588975
6662,C4_00630C_A,134,C4,109388,110002,614,25.903806033036556,32.474747135509524
6664,C4_00640W_A,7,C4,110378,110908,530,1.5676507790761915,1.9653120696764281
6666,C4_00650W_A,661,C4,111275,112444,1169,67.11415097565224,84.13879718559737
6668,C4_00660W_A,1397,C4,112691,113431,740,224.07419176366852,280.91442268515914
6670,C4_00670W_A,962,C4,113645,115870,2225,51.31829381828488,64.33605212489398
6672,C4_00680W_A,275,C4,116219,117580,1361,23.98290133833892,30.066572284595303
6674,C4_00690C_A,118,C4,117577,119166,1589,8.81424792982334,11.05013187427527
6676,C4_00700C_A,400,C4,119423,120388,965,49.19940268899372,61.67966821190271
6678,C4_00710W_A,668,C4,121067,123004,1937,40.933039444216746,51.316401294213634
6680,C4_00720W_A,76,C4,124043,124867,824,10.947464178430822,13.72447471681112
6682,C4_00730C_A,59,C4,125251,125643,392,17.864591786338377,22.39624942375434
6684,C4_00740W_A,189,C4,126005,126508,503,44.59857385403638,55.911760868925825
6686,C4_00750C_A,151,C4,126564,127100,536,33.43792426691568,41.92002263758118
6688,C4_00760W_A,3084,C4,131930,133819,1889,193.78027311620787,242.93593618146534
6690,C4_00770C_A,491,C4,134409,135143,734,79.39855240151758,99.5393460280064
6692,C4_00780C_A,622,C4,135543,138761,3218,22.942011712255052,28.761643296170263
6694,C4_00790C_A,156,C4,140612,142765,2153,8.600183558756521,10.78176643360408
6696,C4_00800W_A,102,C4,142969,144084,1115,10.858065485824332,13.612398524882476
6698,C4_00810C_A,439,C4,144138,145490,1352,38.54029023326897,48.31669053799816
6700,C4_00820W_A,360,C4,146312,147412,1100,38.84516475944641,48.698901674579545
6702,C4_00830W_A,384,C4,148156,149028,872,52.26872322371994,65.52757411870031
6704,C4_00840W_A,1497,C4,150338,152152,1814,97.95163054235637,122.79872808331824
6706,C4_00850C_A,255,C4,152453,154591,2138,14.156621862364512,17.74768984476609
6708,C4_00860C_A,1318,C4,155846,156343,497,314.76481035236645,394.6102596009693
6710,C4_00870W_A,1,C4,157051,157121,70,1.6956222712456763,2.1257457080173614
6712,C4_00880W_A,971,C4,157302,158897,1595,72.25795973452578,90.5874205479248
6714,C4_00890W_A,4826,C4,159230,163885,4655,123.0537305418291,154.2684028104028
6716,C4_00900C_A,1,C4,164078,164148,70,1.6956222712456763,2.1257457080173614
6718,C4_00910C_A,689,C4,165104,166809,1705,47.96472852913723,60.131797945851815
6720,C4_00920C_A,239,C4,166683,167584,901,31.484750941110068,39.471393668291284
6722,C4_00930W_A,1,C4,168204,168274,70,1.6956222712456763,2.1257457080173614
6724,C4_00940W_A,52,C4,168441,169364,923,6.686961069701259,8.383222510491002
6726,C4_00950C_A,207,C4,169418,171475,2057,11.944368843145286,14.974261210097989
6728,C4_00960W_A,197,C4,174413,175678,1265,18.484293375871843,23.17314886447384
6730,C4_00970C_A,3343,C4,176031,191138,15107,26.265477440537552,32.928162648649156
6732,C4_00980C_A,46,C4,192152,192757,605,9.024634237043106,11.313886247629593
6734,C4_00990W_A,237,C4,195174,196907,1733,16.23218319674886,20.349752623201397
6736,C4_01000C_A,45,C4,197113,197757,644,8.293804587614723,10.397669223997962
6738,C4_01010C_A,3522,C4,199443,200198,755,553.6936619243829,694.1474792776162
6740,C4_01020C_A,1674,C4,202398,206000,3602,55.161859451573676,69.15460357175857
6742,C4_01030W_A,3,C4,206759,207076,317,1.123282892623319,1.4082227087812171
6744,C4_01050C_A,2371,C4,208446,208604,158,1781.1546098648414,2232.9747794914015
6746,C4_01060W_A,2742,C4,209074,214572,5498,59.19566001143965,74.2116462707989
6748,C4_01070W_A,25,C4,217108,218946,1838,1.6144390504243384,2.023968982062232
6750,C4_01080W_A,1243,C4,219421,222327,2906,50.769474817992545,63.64801584810413
6752,C4_01090C_A,143,C4,222373,223518,1145,14.823737061283165,18.584030163540422
6754,C4_01100C_A,3108,C4,223819,225525,1706,216.2365658453748,271.08864961093616
6756,C4_01110W_A,1,C4,227751,227822,71,1.6717402674253148,2.0958056276227506
6758,C4_01120C_A,244,C4,227963,228964,1001,28.932296096779375,36.271465227708816
6760,C4_01130C_A,222,C4,229219,229929,710,37.112633936841995,46.526884933225055
6762,C4_01140C_A,259,C4,230555,231097,542,56.718877818605385,71.1065861371859
6764,C4_01150W_A,635,C4,231131,232915,1784,42.24798764398561,52.96490847610522
6766,C4_01160W_A,293,C4,233630,233860,230,151.20527297064706,189.56106291928728
6768,C4_01170C_A,94,C4,234375,236723,2348,4.751786433047935,5.957157904069096
6770,C4_01180W_A,3,C4,240271,240573,302,1.179075089276795,1.4781675453100855
6772,C4_01190W_A,2640,C4,241362,243827,2465,127.12007940210994,159.36625024000338
6774,C4_01200C_A,119,C4,244110,245339,1229,11.492704246929607,14.408024204869504
6776,C4_01210C_A,1,C4,245658,245739,81,1.4653525800888563,1.837064192113769
6778,C4_01220C_A,471,C4,246083,248236,2153,25.965938821630264,32.55264096299693
6780,C4_01230C_A,157,C4,248784,249194,410,45.45094819753654,56.9803544661239
6782,C4_01240C_A,341,C4,249999,250601,602,67.23339470869486,84.28828912022327
6784,C4_01250W_A,158,C4,250907,251518,611,30.693260752826816,38.479128528104766
6786,C4_01260W_A,1108,C4,253002,254807,1805,72.86009050294442,91.3422920298208
6788,C4_01270W_A,12898,C4,255598,256733,1135,1348.8189637153052,1690.969841357317
6790,C4_01280C_A,618,C4,256997,258274,1277,57.44136214102425,72.01234089963278
6792,C4_01290W_A,2048,C4,258895,261285,2390,101.70895765932225,127.50916514701628
6794,C4_01300W_A,2348,C4,263831,265333,1502,185.5475875512246,232.614889860009
6796,C4_01310W_A,151,C4,266046,267944,1898,9.442954376747526,11.838320407662543
6798,C4_01320C_A,295,C4,267976,270813,2837,12.342121924999372,15.472911128148928
6800,C4_01330W_A,4,C4,272019,272348,329,1.4430827840388736,1.809145283419031
6802,C4_01340W_A,10,C4,273215,273544,329,3.6077069600971843,4.522863208547577
6804,C4_01350W_A,2,C4,274641,274952,311,0.7633026301427482,0.9569273283679439
6806,C4_01360W_A,405,C4,278189,278608,419,114.72766441483277,143.83028835869257
6808,C4_01370W_A,1045,C4,280487,281395,908,136.60216865817316,171.25363275492288
6810,C4_01380W_A,642,C4,283161,286751,3590,21.225979072362314,26.610309782256326
6812,C4_01390W_A,68,C4,287625,288733,1108,7.284442248311751,9.132264955020434
6814,C4_01400W_A,51,C4,291217,291654,437,13.85210871475301,17.365931756572035
6816,C4_01410W_A,823,C4,292031,293929,1898,51.46722815935902,64.52276619540578
6818,C4_01420W_A,1360,C4,294718,301869,7151,22.57351981856921,28.29967716448788
6820,C4_01430C_A,135,C4,302002,303258,1256,12.75766756629908,15.993866991054192
6822,C4_01440W_A,662,C4,303565,304920,1355,57.98903029485214,72.69893439817308
6824,C4_01450W_A,1479,C4,305252,307093,1841,95.35457563392987,119.5428860135999
6826,C4_01460C_A,178,C4,307183,307857,674,31.34637017762779,39.29791026987584
6828,C4_01470W_A,96,C4,308173,309534,1361,8.372212830838315,10.495967052076903
6830,C4_01480C_A,8,C4,309391,309812,421,2.2554595532009,2.827595241068224
6832,C4_01490W_A,918,C4,309930,312554,2624,41.52465211518566,52.05808658429712
6834,C4_01500W_A,437,C4,312956,314143,1187,43.69762870885025,54.782275659857696
6836,C4_01510W_A,921,C4,314498,315304,806,135.62874420249227,170.0332826251604
6838,C4_01520C_A,3532,C4,315673,316191,518,809.3159273026662,1014.6126811780163
6840,C4_01530C_A,3158,C4,317140,318105,965,388.4292842296054,486.9609805329719
6842,C4_01550C_A,756,C4,320143,321435,1292,69.45226826185852,87.07001769990616
6844,C4_01560C_A,300,C4,321752,324649,2897,12.291359232364243,15.409271614899753
6846,C4_01570C_A,10,C4,325276,325380,104,11.412842210307439,14.30790380396301
6848,C4_01580C_A,4,C4,325943,326036,93,5.105099311277305,6.400094604783453
6850,C4_01590C_A,10,C4,326188,326271,83,14.300428793638236,17.92797585074883
6852,C4_01600C_A,5,C4,326439,326531,92,6.450736901478118,8.087076063109526
6854,C4_01610C_A,8,C4,326607,326699,92,10.321179042364987,12.939321700975242
6856,C4_01620C_A,3,C4,326687,326779,92,3.8704421408868703,4.852245637865716
6858,C4_01630C_A,1,C4,326950,327037,87,1.3642937814620384,1.710370109899026
6860,C4_01640C_A,2,C4,327198,327290,92,2.5802947605912467,3.2348304252438105
6862,C4_01650C_A,353,C4,327629,329125,1496,28.007236846577985,35.11174896063436
6864,C4_01660W_A,412,C4,329466,332810,3344,14.6237279613413,18.33328535263777
6866,C4_01670C_A,217,C4,332863,334044,1181,21.80906206623355,27.341301697530664
6868,C4_01680W_A,127,C4,334467,334859,392,38.454290794321594,48.20887587825087
6870,C4_01690C_A,404,C4,334947,336305,1358,35.310896782641926,44.26810649685639
6872,C4_01700C_A,1749,C4,337230,337508,278,746.7447290237704,936.1692339300919
6874,C4_01710C_A,2313,C4,340471,340899,428,641.4443970499708,804.1576812735769
6876,C4_01720C_A,4934,C4,340871,342028,1157,506.16596373624174,634.5635718539639
6878,C4_01730C_A,545,C4,342883,345000,2117,30.55644291356758,38.30760451623162
6880,C4_01740W_A,109,C4,345376,345705,329,39.32400586505931,49.29920897316859
6882,C4_01750C_A,13587,C4,345920,346999,1079,1494.6148155320207,1873.7492914163413
6884,C4_01760W_A,66,C4,348098,348634,536,14.615251666334004,18.32265890119442
6886,C4_01770W_A,686,C4,349059,349838,779,104.52346786292347,131.03762374710357
6888,C4_01780C_A,349,C4,349990,350946,956,43.33059841687435,54.32214189002525
6890,C4_01790W_A,426,C4,352073,355570,3497,14.459095261237081,18.126890767251275
6892,C4_01800W_A,32,C4,356483,357208,725,5.238888120814228,6.567821222012261
6894,C4_01820C_A,1048,C4,357858,358832,974,127.71134478293925,160.10750014389492
6896,C4_01830C_A,607,C4,359054,360847,1793,40.18237049929101,50.37531240025526
6898,C4_01840C_A,2595,C4,361141,361872,731,421.35401583006444,528.2376304532881
6900,C4_01850C_A,143,C4,362365,364284,1919,8.844804030833362,11.088439050158305
6902,C4_01860C_A,97,C4,364597,365901,1304,8.829198789691828,11.068875274108805
6904,C4_01870C_A,1032,C4,366373,367671,1298,94.36960930260992,118.30806621508027
6906,C4_01880W_A,606,C4,367892,369211,1319,54.53244635803002,68.36552913881461
6908,C4_01890C_A,449,C4,369339,369896,557,95.67936801660973,119.9500675098486
6910,C4_01900C_A,16890,C4,370410,371408,998,2008.7517147232097,2518.3057621131525
6912,C4_01910W_A,307,C4,372264,373781,1517,24.02038405344073,30.113563128077185
6914,C4_01920W_A,496,C4,374223,374501,278,211.76980308507154,265.4888164833194
6916,C4_01930C_A,618,C4,374618,375325,707,103.75193699305228,130.0703809460128
6918,C4_01940W_A,144,C4,379679,381481,1802,9.48494589020889,11.890963782916204
6920,C4_01950W_A,778,C4,382179,383054,875,105.53553016233091,132.30641286700055
6922,C4_01960C_A,719,C4,383106,384434,1328,64.26255189141182,80.56384147930254
6924,C4_01970W_A,160,C4,385301,386614,1313,14.463800028904478,18.13278897927985
6926,C4_01980C_A,1931,C4,386687,387364,677,338.54839350705777,424.4269532536288
6928,C4_01990W_A,68,C4,387813,388049,236,34.19983903020941,42.87521004306203
6930,C4_02000C_A,3273,C4,388211,391741,3530,110.05212990512662,137.96872497559704
6932,C4_02010C_A,728,C4,394832,396466,1634,52.881830442276424,66.29620641405431
6934,C4_02020W_A,4241,C4,398110,400008,1898,265.21569213103476,332.49216456223087
6936,C4_02030W_A,397,C4,405052,408387,3335,14.12933820627207,17.713485225128174
6938,C4_02040W_A,368,C4,408951,410384,1433,30.480969788756894,38.212986349286275
6940,C4_02050W_A,401,C4,410516,411604,1088,43.74643120759755,54.84345774269055
6942,C4_02060C_A,3908,C4,411719,413545,1826,254.0276169342647,318.4660437487565
6944,C4_02070W_A,232,C4,414417,415787,1370,20.09993115695605,25.198620655621855
6946,C4_02080W_A,90,C4,416114,417043,929,11.498837792085858,14.415713628104818
6948,C4_02090C_A,269,C4,417123,417845,722,44.222392475839456,55.440154684164696
6950,C4_02100C_A,42,C4,418036,419232,1196,4.16816845941663,5.225495302316925
6952,C4_02110W_A,274,C4,419443,419976,533,61.01695152437537,76.4949393616754
6954,C4_02120W_A,510,C4,421020,421946,926,65.37118259554066,81.95369522269955
6956,C4_02130W_A,497,C4,422279,423034,755,78.13337591607561,97.95323600254834
6958,C4_02140C_A,531,C4,423169,423444,275,229.1864720807338,287.3235198800194
6960,C4_02150C_A,245,C4,423674,426985,3311,8.782821489538916,11.010733582753774
6962,C4_02160C_A,297,C4,427566,429880,2314,15.234220838028357,19.098640133829274
6964,C4_02170C_A,372,C4,430108,431778,1670,26.43952331930384,33.14635822561203
6966,C4_02180C_A,417,C4,432066,434558,2492,19.861642896332782,24.899886523686508
6968,C4_02190C_A,107,C4,435121,436770,1649,7.701765198077695,9.655448970921793
6970,C4_02200C_A,128,C4,437154,437594,440,34.529035341730136,43.28791259962627
6972,C4_02210W_A,35,C4,437882,438676,794,5.232083834448246,6.559290912648029
6974,C4_02220C_A,77,C4,438733,441150,2417,3.7813008034812565,4.740492083663044
6976,C4_02230C_A,38,C4,442010,442921,911,4.950993678939077,6.2068974569991004
6978,C4_02240C_A,47,C4,443684,444265,581,9.60171647572853,12.037355214074214
6980,C4_02250C_A,6191,C4,444629,445555,926,793.5548851941024,994.8535825955549
6982,C4_02260C_A,477,C4,446282,447397,1115,50.77742388959026,63.6579813369504
6984,C4_02270C_A,6063,C4,447754,449142,1388,518.4719366998398,649.9911642216487
6986,C4_02280W_A,917,C4,450086,450940,854,127.44964120756437,159.77941100425576
6988,C4_02290W_A,1492,C4,451427,452587,1160,152.66447414560213,191.39041529770105
6990,C4_02300W_A,1347,C4,453463,455604,2141,74.67548993729791,93.61819841614059
6992,C4_02310W_A,692,C4,457216,460641,3425,23.981297173471695,30.064561196017802
6994,C4_02320C_A,408,C4,460935,461644,709,68.30320460758324,85.62947450067112
6996,C4_02330C_A,118,C4,462582,463040,458,30.580436594954776,38.33768460310787
6998,C4_02340W_A,1126,C4,463583,463966,383,348.9528653252852,437.4706963601264
7000,C4_02360W_A,4699,C4,464869,468336,3467,160.87136823791187,201.67912770064916
7002,C4_02370C_A,9852,C4,471021,471362,341,3429.2344373661826,4299.118094067721
7004,C4_02380W_A,1,C4,479420,479728,308,0.385368698010381,0.48312402454940023
7006,C4_02390W_A,28883,C4,480535,481176,641,5348.246590058067,6704.920327498567
7008,C4_02400C_A,198,C4,483122,485536,2414,9.735428616182716,12.204985713803076
7010,C4_02410C_A,1687,C4,486083,486613,530,377.80383775736215,473.6402087920193
7012,C4_02420C_A,163,C4,487547,488344,797,24.27484330603911,30.432570299219687
7014,C4_02430W_A,645,C4,488934,493196,4262,17.9627746472882,22.519338037771906
7016,C4_02440C_A,517,C4,493509,495056,1547,39.66681964859795,49.72898330520252
7018,C4_02450W_A,112,C4,496166,497164,998,13.320319245056217,16.699244840537187
7020,C4_02460W_A,48,C4,497492,498130,638,8.92992293320607,11.195149810248173
7022,C4_02470C_A,669,C4,498333,499070,737,107.74218583776802,135.07282429640844
7024,C4_02480C_A,292,C4,499700,500026,326,106.31447614804182,133.28295175421738
7026,C4_02490W_A,601,C4,501463,504297,2834,25.171075847320257,31.55614747222667
7028,C4_02500C_A,2751,C4,504516,508772,4256,76.72133006902723,96.18300070321975
7030,C4_02510W_A,132,C4,512431,513978,1547,10.127698633684584,12.696761694945325
7032,C4_02520C_A,137,C4,514049,515524,1475,11.024418699149855,13.820950060939998
7034,C4_02530W_A,215,C4,517316,520240,2924,8.72746757258804,10.941338203030536
7036,C4_02540W_A,410,C4,523880,526963,3083,15.784741869851091,19.788810191403915
7038,C4_02550C_A,922,C4,527399,529291,1892,57.84115295253486,72.51354545213557
7040,C4_02560C_A,43,C4,529895,531271,1376,3.7091737183499176,4.650068736287977
7042,C4_02570C_A,61,C4,531726,533546,1820,3.978190713307164,4.987326468809964
7044,C4_02580W_A,13,C4,533914,534252,338,4.565136884122976,5.723161521585203
7046,C4_02590C_A,719,C4,534274,536604,2330,36.62689652866734,45.917931967602485
7048,C4_02600C_A,544,C4,536885,538603,1718,37.583990738670174,47.11780940704372
7050,C4_02610C_A,89,C4,539025,541505,2480,4.259567237847002,5.340078935866194
7052,C4_02620C_A,7261,C4,543678,545906,2228,386.81953851258527,484.9428954281796
7054,C4_02630C_A,540,C4,547040,547480,440,145.66936784792404,182.6208812796733
7056,C4_02640C_A,864,C4,547908,549077,1169,87.72560732672243,109.97870010341319
7058,C4_02650C_A,1,C4,549182,549268,86,1.3801576626418297,1.730258134432736
7060,C4_02660W_A,101,C4,550263,551270,1007,11.904716442608672,14.924550303557838
7062,C4_02670W_A,246,C4,551536,553089,1553,18.801426600676464,23.57072832714679
7064,C4_02680C_A,10,C4,553127,553465,338,3.5116437570176737,4.402431939680926
7066,C4_02690W_A,166,C4,553837,555657,1820,10.825896039491628,13.572068751187768
7068,C4_02700W_A,160,C4,555825,557594,1769,10.735426477078338,13.458650045107092
7070,C4_02710C_A,645,C4,557744,558505,761,100.60097969348529,126.12012972008391
7072,C4_02720C_A,1403,C4,558858,559796,938,177.53418257893168,222.5687483842058
7074,C4_02730C_A,7,C4,566829,567131,302,2.7511752083125214,3.449057605723533
7076,C4_02740W_A,1268,C4,571822,573321,1499,100.40255690177868,125.87137361148831
7078,C4_02750W_A,169,C4,577303,577749,446,44.97581046824294,56.384689968263196
7080,C4_02760C_A,433,C4,578111,579133,1022,50.28797557872451,63.04437613503544
7082,C4_02770C_A,377,C4,579389,580426,1037,43.15088885069759,54.09684593498377
7084,C4_02780W_A,2638,C4,580679,582313,1634,191.6239954762709,240.23268203334513
7086,C4_02790C_A,1073,C4,582403,584097,1694,75.18192963002525,94.25310515300119
7088,C4_02800W_A,604,C4,584380,585738,1358,52.791538754246844,66.18301070322093
7090,C4_02820W_A,86,C4,586325,588797,2472,4.129306663794083,5.176775551077878
7092,C4_02830C_A,1863,C4,588794,591091,2297,96.2673488868736,120.68719973119028
7094,C4_02840C_A,176,C4,591385,592176,791,26.409692012322044,33.108959700093415
7096,C4_02850W_A,1207,C4,592423,594816,2393,59.86758282388098,75.05401373605802
7098,C4_02860W_A,1463,C4,595171,595815,644,269.6408024817853,338.0397794379782
7100,C4_02870C_A,3478,C4,595985,597268,1283,321.7585332482248,403.3780592937699
7102,C4_02880C_A,210,C4,597479,598246,767,32.49758459884152,40.74114981467433
7104,C4_02890C_A,1007,C4,598659,598856,197,606.7229131985164,760.628502325603
7106,C4_02900C_A,6781,C4,599268,600629,1361,591.3747417282772,741.3870060430572
7108,C4_02910W_A,12,C4,602743,603063,320,4.451008462019901,5.580082483545573
7110,C4_02920W_A,2223,C4,603218,604786,1568,168.2753709365687,210.9612816483301
7112,C4_02930W_A,351,C4,605437,605955,518,80.42748881178817,100.82928966406674
7114,C4_02940W_A,11884,C4,606493,608439,1946,724.8480241540869,908.7180573409469
7116,C4_02950C_A,50,C4,608655,608981,326,18.20453358699346,22.822423245585167
7118,C4_02960W_A,1335,C4,609369,615065,5696,27.818802887624376,34.87551552215983
7120,C4_02970C_A,1849,C4,615198,620561,5363,40.921944912796555,51.302492446147134
7122,C4_02980W_A,2109,C4,621466,622695,1229,203.68162400650874,255.348933177057
7124,C4_02990C_A,287,C4,622851,623510,659,51.69203555284619,64.80459980890559
7126,C4_03000C_A,279,C4,624273,624995,722,45.86634758646546,57.50112697725632
7128,C4_03010W_A,1,C4,627397,627468,71,1.6717402674253148,2.0958056276227506
7130,C4_03020W_A,1883,C4,627762,630455,2693,82.99293411544471,104.04550381499013
7132,C4_03030C_A,962,C4,630579,633098,2519,45.32878274937827,56.82719967363601
7134,C4_03040W_A,246,C4,633412,633630,218,133.93860326078234,167.91440867916953
7136,C4_03050C_A,1811,C4,633876,635618,1742,123.39496861412997,154.69620172523588
7138,C4_03070W_A,2466,C4,639668,640696,1028,284.7259887766816,356.951579881281
7140,C4_03080W_A,1387,C4,641743,644179,2436,67.58126696028026,84.7244050867839
7142,C4_03090W_A,484,C4,644883,645710,827,69.46515423192687,87.08617241551173
7144,C4_03100W_A,90,C4,646818,647795,977,10.933900009056051,13.707469765106833
7146,C4_03110W_A,3595,C4,649167,654407,5240,81.43193598453712,102.08853195087194
7148,C4_03120C_A,728,C4,654505,657207,2702,31.979611747845922,40.09178433773676
7150,C4_03130W_A,599,C4,657550,659415,1865,38.121952725646764,47.79223460437961
7152,C4_03140C_A,141,C4,659489,660385,896,18.678339081690655,23.416417564878742
7154,C4_03150W_A,824,C4,660576,663860,3284,29.78181869837108,37.336483690146586
7156,C4_03160C_A,196,C4,664007,665035,1028,22.630289456702997,28.37084738715778
7158,C4_03170W_A,245,C4,665604,666623,1019,28.537705546480225,35.77678007114597
7160,C4_03180W_A,7162,C4,668228,670270,2042,416.29934841640915,521.9007606549578
7162,C4_03190W_A,544,C4,671287,672630,1343,48.07840364038374,60.27430868302391
7164,C4_03200C_A,161,C4,672797,673672,875,21.83961485364431,27.379604719263614
7166,C4_03230C_A,1,C4,674267,678610,4343,0.027329854705778804,0.03426253731549972
7168,C4_03250C_A,1,C4,679262,680179,917,0.1294368145989066,0.1622706647341497
7170,C4_03270W_A,777,C4,680862,681752,890,103.623477902306,129.90933602142053
7172,C4_03280W_A,3479,C4,682502,686239,3737,110.49903444379437,138.5289944536976
7174,C4_03290W_A,1007,C4,686644,689340,2696,44.333981416953904,55.58005005865868
7176,C4_03300C_A,93,C4,690179,690361,182,60.651104317633816,76.03628878677485
7178,C4_03310C_A,40,C4,692297,692497,200,23.738711797439475,29.760439912243058
7180,C4_03320W_A,445,C4,697717,698832,1115,47.3709719724689,59.387424936987266
7182,C4_03330W_A,233,C4,699714,700799,1085,25.489031561305975,31.95475806245453
7184,C4_03340C_A,918,C4,701061,702284,1223,89.09295760445393,111.6929020418607
7186,C4_03350C_A,341,C4,702676,704019,1343,30.13738169369643,37.78224128843962
7188,C4_03360C_A,1155,C4,704421,706550,2129,64.39223139042412,80.72641638948033
7190,C4_03370C_A,200,C4,707397,707855,458,51.831248466025045,64.97912644594554
7192,C4_03380C_A,530,C4,708487,709644,1157,54.371293226633185,68.16349677393613
7194,C4_03390W_A,1234,C4,710440,711150,710,206.29274900028383,258.6224144486474
7196,C4_03400W_A,410,C4,711401,711927,526,92.51779312690289,115.98650536140356
7198,C4_03410W_A,1188,C4,712320,713195,875,161.1519406591891,202.03087208997005
7200,C4_03420C_A,31,C4,713275,713581,306,12.024510877787966,15.074732635286516
7202,C4_03430W_A,356,C4,717205,717996,791,53.419604297651404,66.97039575700713
7204,C4_03440C_A,1175,C4,718927,721134,2207,63.19208509739777,79.22183257110464
7206,C4_03450C_A,589,C4,721912,723741,1829,38.22334950435169,47.919352401069325
7208,C4_03460C_A,33,C4,723995,725866,1871,2.0934727132963724,2.6245176833351707
7210,C4_03470C_A,1,C4,726514,727329,815,0.14563626869594767,0.18257938596468135
7212,C4_03480C_A,1,C4,730527,731114,587,0.20220367800203978,0.25349608102421683
7214,C4_03490C_A,6,C4,733160,733684,524,1.3590865532885195,1.703841979708572
7216,C4_03500C_A,1,C4,734839,735390,551,0.21541480759926923,0.2700584384051094
7218,C4_03510C_A,4,C4,738442,741168,2726,0.17416516359089854,0.21834512041264167
7220,C4_03520C_A,45,C4,745166,747331,2165,2.467071664860915,3.0928863650137126
7222,C4_03530W_A,174,C4,750746,752716,1970,10.483593534909819,13.142935392716476
7224,C4_03540C_A,378,C4,752869,754629,1760,25.492139373386706,31.95865422394283
7226,C4_03550W_A,723,C4,755288,758260,2972,28.87464439695279,36.1991891933912
7228,C4_03560W_A,567,C4,758441,760756,2315,29.070949436605144,36.44529034609463
7230,C4_03570W_A,8,C4,762835,764739,1904,0.4987124327193166,0.6252193258874592
7232,C4_03580W_A,39,C4,765642,766715,1073,4.314118173812393,5.408467644815841
7234,C4_03590C_A,1199,C4,766847,769381,2534,56.16163268573386,70.40798629593415
7236,C4_03600C_A,295,C4,770572,771981,1409,24.850674166943378,31.154470454619236
7238,C4_03610C_A,1,C4,772391,772477,86,1.3801576626418297,1.730258134432736
7240,C4_03620C_A,152,C4,772928,774148,1220,14.788049972175408,18.53929043713502
7242,C4_03630C_A,2,C4,780195,780265,70,3.3912445424913527,4.251491416034723
7244,C4_03640C_A,1,C4,780937,781008,71,1.6717402674253148,2.0958056276227506
7246,C4_03650W_A,1,C4,782464,782535,71,1.6717402674253148,2.0958056276227506
7248,C4_03660W_A,11,C4,782619,782690,71,18.389142941678465,23.053861903850255
7250,C4_03670W_A,523,C4,782815,785400,2585,24.014209419846893,30.105822193623055
7252,C4_03680C_A,218,C4,785391,787022,1631,15.86462039191234,19.888951259561576
7254,C4_03690C_A,74,C4,787445,787858,413,21.267126791894924,26.66189532089572
7256,C4_03700W_A,569,C4,788604,790349,1745,38.7029427299228,48.52060260763983
7258,C4_03710C_A,138,C4,790413,791915,1502,10.905267070727854,13.671573594838687
7260,C4_03720C_A,428,C4,792424,793434,1010,50.297864600515325,63.05677367544568
7262,C4_03730C_A,181,C4,793991,795340,1349,15.925525705472737,19.96530624209041
7264,C4_03740W_A,372,C4,795553,796467,914,48.30853823111315,60.562820827978214
7266,C4_03750C_A,164,C4,796578,797762,1184,16.440661886740177,20.611115479762926
7268,C4_03760W_A,4,C4,798718,799368,650,0.730421901459676,0.9157058434536326
7270,C4_03770W_A,134,C4,800107,800601,494,32.19622855118309,40.363349678548275
7272,C4_03780C_A,1150,C4,800718,802052,1334,102.32203360965288,128.27775824242696
7274,C4_03790W_A,426,C4,802327,803634,1307,38.6866535030957,48.50018134129893
7276,C4_03800C_A,480,C4,803672,806206,2534,22.48338923198687,28.186683421224682
7278,C4_03810W_A,344,C4,807342,809537,2195,18.601632934667833,23.320253598659708
7280,C4_03820C_A,86,C4,809585,810853,1268,8.050194063800452,10.092262746265389
7282,C4_03830W_A,259,C4,811967,816289,4322,7.112825492291559,8.917114689114937
7284,C4_03840C_A,139,C4,816382,817305,923,17.874761320932215,22.408998633812487
7286,C4_03850W_A,493,C4,817941,819719,1778,32.91109368992593,41.259552521754294
7288,C4_03860C_A,167,C4,819831,820904,1073,18.47327525709409,23.159335812416547
7290,C4_03870C_A,23,C4,821114,821753,639,4.272225127864694,5.355947715035918
7292,C4_03880W_A,213,C4,822133,823599,1466,17.245380671400433,21.61996487485597
7294,C4_03890W_A,3671,C4,826096,828363,2267,192.2029356162336,240.95848018933452
7296,C4_03900C_A,195,C4,828649,830406,1757,13.173161071430554,16.51475749256516
7298,C4_03910W_A,584,C4,832645,834441,1796,38.59523298915549,48.38557045865798
7300,C4_03920W_A,344,C4,835077,836783,1706,23.933519514417288,30.004663920901557
7302,C4_03930C_A,139,C4,836883,837323,440,37.496374316410076,47.007967588656655
7304,C4_03940C_A,8368,C4,837701,841234,3533,281.1287012750828,352.4417792041465
7306,C4_03950C_A,59,C4,844510,844815,305,22.96039337785129,28.784687783972792
7308,C4_03960W_A,39,C4,845566,845781,215,21.530459537212547,26.992026897150676
7310,C4_03970W_A,11,C4,847183,847515,332,3.932617918250515,4.930193358955929
7312,C4_03990C_A,120,C4,849660,850721,1061,13.42434220401855,16.829654992785898
7314,C4_04000W_A,395,C4,854022,855179,1157,40.52200155569832,50.80109665227315
7316,C4_04010W_A,415,C4,858485,861013,2528,19.484899912850832,24.427576272905196
7318,C4_04020C_A,1,C4,861270,861698,428,0.27732139950279755,0.3476686905635871
7320,C4_04030W_A,31,C4,864733,866274,1541,2.387735450099363,2.9934251696286007
7322,C4_04040W_A,1,C4,866778,867194,416,0.2853210552576859,0.35769759509907517
7324,C4_04050C_A,47,C4,867681,868295,614,9.085663310094912,11.390396383350357
7326,C4_04060W_A,1,C4,869126,869491,365,0.32518783284163655,0.4076772590718227
7328,C4_04070C_A,3,C4,871065,871898,833,0.42746779947369995,0.5359022793321079
7330,C4_04080C_A,260,C4,874032,875090,1058,29.168549467553227,36.56764828536482
7332,C4_04090C_A,835,C4,876709,878454,1745,56.796058311925385,71.20334477571048
7334,C4_04100C_A,221,C4,878813,879406,593,44.23486768325567,55.4557944401831
7336,C4_04110W_A,38,C4,880335,880472,137,32.92230103294525,41.27360279800132
7338,C4_04120C_A,280,C4,880641,882536,1895,17.537834573306203,21.986604684506744
7340,C4_04130W_A,496,C4,882875,883537,662,88.93052153723548,111.48926130266283
7342,C4_04140W_A,386,C4,884123,885214,1091,41.99423810179485,52.64679104548955
7344,C4_04150C_A,2720,C4,885458,886597,1139,283.4473050440534,355.3485362655888
7346,C4_04160W_A,500,C4,888267,889790,1523,38.9670252748514,48.85167418293344
7348,C4_04170C_A,346,C4,890261,893062,2801,14.661896254755545,18.381135683034806
7350,C4_04180C_A,145,C4,895669,896631,962,17.89040130264409,22.42860596296904
7352,C4_04190C_A,23,C4,897092,899638,2546,1.0722513184232283,1.3442461075836418
7354,C4_04200C_A,1,C4,897092,898435,1343,0.08837941845658775,0.11079836154967632
7356,C4_04210C_A,121,C4,901264,901704,440,32.64072872147928,40.920604879334206
7358,C4_04220W_A,96,C4,902114,902629,515,22.125401286933876,27.73788574344984
7360,C4_04230W_A,149,C4,903067,904563,1496,11.82175153014198,14.820539929559542
7362,C4_04240C_A,1915,C4,904889,907018,2129,106.76287715382007,133.84509730377044
7364,C4_04250W_A,437,C4,908843,910558,1715,30.24436459323921,37.91636222055457
7366,C4_04260C_A,1874,C4,910696,913320,2624,84.76818961204567,106.27108307077647
7368,C4_04270W_A,139,C4,913732,914373,641,25.738540872418774,32.267559655240134
7370,C4_04280C_A,126,C4,914401,915228,827,18.08390378765038,22.67119364536049
7372,C4_04290W_A,725,C4,915401,918079,2678,32.13324505814716,40.284389350963814
7374,C4_04300C_A,53,C4,918145,918480,335,18.778383959168536,23.54184052759525
7376,C4_04310W_A,1342,C4,918716,919537,821,194.01553734569893,243.23087918532386
7378,C4_04320W_A,513,C4,923039,925159,2120,28.721601773788795,36.007324705143134
7380,C4_04330C_A,1982,C4,925694,926599,905,259.94545183715485,325.8850381550593
7382,C4_04340C_A,374,C4,927322,927855,533,83.28591193473136,104.41280044257883
7384,C4_04350W_A,430,C4,928087,928719,632,80.75669361470706,101.24200286601673
7386,C4_04360W_A,187,C4,929018,930820,1802,12.317256121312933,15.441737690314794
7388,C4_04370C_A,709,C4,930996,933335,2339,35.9785093295951,45.105070324455596
7390,C4_04380C_A,197,C4,935018,935302,284,82.33320817069676,103.21842716042046
7392,C4_04390W_A,2213,C4,936830,937776,946,277.6626279478518,348.0964774090586
7394,C4_04400C_A,3,C4,940284,940559,275,1.2948388253148804,1.6232967224859849
7396,C4_04410C_A,2295,C4,944103,946157,2054,132.62011581091426,166.26146445617775
7398,C4_04420W_A,610,C4,947592,949115,1523,47.539770835318706,59.59904250317881
7400,C4_04430W_A,392,C4,949398,950015,617,75.40984622849491,94.53883667422431
7402,C4_04440W_A,1365,C4,950318,951124,806,201.0132853815439,252.00372506334847
7404,C4_04450C_A,592,C4,951265,953769,2504,28.061735990583397,35.180072739712244
7406,C4_04460C_A,1959,C4,954686,958912,4226,55.021458129654434,68.97858706588282
7408,C4_04470W_A,583,C4,960912,962273,1361,50.84375083727852,63.74113324334204
7410,C4_04480C_A,7342,C4,962661,963667,1006,866.2506064453311,1085.9898103165433
7412,C4_04490C_A,1,C4,963317,963411,94,1.2626974360340144,1.583002122991652
7414,C4_04500C_A,593,C4,964068,964820,752,93.59744744602133,117.34003236675619
7416,C4_04510W_A,1688,C4,965102,969301,4199,47.71486724705623,59.818555098673826
7418,C4_04520W_A,584,C4,969500,970330,830,83.5145041548473,104.69937896837318
7420,C4_04530C_A,6030,C4,970514,972160,1646,434.8251280029162,545.1259194132007
7422,C4_04540C_A,49,C4,973176,973508,332,17.518025272206838,21.96177041716732
7424,C4_04550C_A,804,C4,974467,975477,1010,94.48477368881849,118.45244400714563
7426,C4_04560C_A,1667,C4,976498,977346,848,233.32802220714387,292.5156446563041
7428,C4_04570W_A,253,C4,979296,980141,845,35.537834821018855,44.55261122957096
7430,C4_04580W_A,5018,C4,982197,987134,4937,120.64093153691641,151.24355628887548
7432,C4_04590W_A,5022,C4,987763,988899,1136,524.7174764381207,657.8209913700908
7434,C4_04600C_A,518,C4,989215,990402,1187,51.79718917891174,64.93642744120432
7436,C4_04620C_A,1,C4,996059,997609,1550,0.07657648966915959,0.09600141907175179
7438,C4_04630C_A,48,C4,998774,999139,365,15.609015976398556,19.56850843544749
7440,C4_04640C_A,199,C4,999156,999992,836,28.25361033307688,35.420619273542876
7442,C4_04650W_A,267,C4,1000502,1001221,719,44.07674582695646,55.25756228490192
7444,C4_04660C_A,2845,C4,1001323,1004172,2849,118.52691306373342,148.59328106411286
7446,C4_04670C_A,790,C4,1005037,1006539,1502,62.42870279619567,78.2648053617577
7448,C4_04680C_A,1,C4,1006665,1006750,85,1.3963948116140865,1.750614112484886
7450,C4_04690C_A,2,C4,1006761,1006843,82,2.8949648533462766,3.629321940517446
7452,C4_04700W_A,5412,C4,1007560,1009182,1622,396.03547548625903,496.49661160622514
7454,C4_04710W_A,1222,C4,1009525,1011219,1694,85.62191799430649,107.34137418170312
7456,C4_04720W_A,739,C4,1011677,1012648,971,90.33423284401529,113.24904786378795
7458,C4_04730W_A,2269,C4,1013014,1015230,2216,121.53234898102473,152.3610969333924
7460,C4_04740W_A,1,C4,1015422,1015508,86,1.3801576626418297,1.730258134432736
7462,C4_04750W_A,1016,C4,1015865,1017364,1499,80.44873644495831,100.85592712087707
7464,C4_04760C_A,271,C4,1017566,1018333,767,41.93735917279072,52.575483808460675
7466,C4_04770C_A,1149,C4,1018785,1020554,1769,77.0937813885188,96.6499306364253
7468,C4_04780W_A,1489,C4,1022584,1025082,2498,70.75048412007081,88.69754809713754
7470,C4_04790W_A,10,C4,1027532,1030078,2546,0.46619622540140365,0.584454829384192
7472,C4_04800W_A,2245,C4,1033241,1034341,1100,242.2427635693255,303.691761831753
7474,C4_04810C_A,459,C4,1034791,1035768,977,55.76289004618586,69.90809580204484
7476,C4_04820C_A,1116,C4,1036182,1036958,776,170.698468852722,213.99903957514982
7478,C4_04830W_A,683,C4,1037422,1039257,1835,44.17858353583422,55.38523286120438
7480,C4_04840C_A,443,C4,1039532,1041073,1541,34.12150981916186,42.777011295015164
7482,C4_04850C_A,499,C4,1042165,1044021,1856,31.911684232010497,40.00662585185691
7484,C4_04860W_A,175,C4,1048293,1049468,1175,17.677764104476203,22.162029721883123
7486,C4_04870C_A,3254,C4,1049786,1052143,2357,163.86459098190082,205.4316323174351
7488,C4_04880W_A,249,C4,1052921,1053868,947,31.20876049399381,39.12539354883064
7490,C4_04890C_A,3349,C4,1054051,1054518,467,851.1878566340984,1067.106137752698
7492,C4_04900W_A,2332,C4,1055341,1055842,501,552.481795525238,692.6282023488104
7494,C4_04910C_A,166,C4,1055978,1056721,743,26.518345614905467,33.245175137498975
7496,C4_04920W_A,569,C4,1056993,1058111,1118,60.40843923409239,75.73206757632514
7498,C4_04930C_A,160,C4,1058295,1059131,836,22.716470619559306,28.478889868175177
7500,C4_04940W_A,56,C4,1059519,1060398,879,7.5618194576599,9.48000361254614
7502,C4_04950W_A,22,C4,1060449,1060895,446,5.854839232552337,7.340018812436629
7504,C4_04970C_A,500,C4,1062625,1062888,263,225.65315396805582,282.8939155156184
7506,C4_04980W_A,249,C4,1063814,1065475,1661,17.79331498363163,22.30689204740675
7508,C4_04990C_A,171,C4,1065570,1066970,1400,14.497570419150534,18.175125803548436
7510,C4_05000W_A,112,C4,1068053,1069351,1298,10.241663025089448,12.839635093109484
7512,C4_05010W_A,574,C4,1069560,1071119,1559,43.70115641991744,54.78669823485412
7514,C4_05020W_A,24,C4,1071272,1071643,371,7.678289530169101,9.626018300455975
7516,C4_05030C_A,2492,C4,1071853,1076304,4451,66.45345967110667,83.31051029129375
7518,C4_05040W_A,7,C4,1077190,1077411,221,3.759524492807156,4.713191841305462
7520,C4_05050C_A,270,C4,1077531,1078781,1250,25.63780874123463,32.141275105222505
7522,C4_05060W_A,784,C4,1080133,1082154,2021,46.0444088302636,57.72435648490489
7524,C4_05070C_A,295,C4,1082286,1083653,1367,25.614191588312526,32.11166705966241
7526,C4_05080C_A,439,C4,1083917,1085980,2063,25.25762113203085,31.66464644080151
7528,C4_05090C_A,329,C4,1086508,1091751,5243,7.44806044378942,9.337387689422053
7530,C4_05100C_A,3987,C4,1092126,1096076,3950,119.80537207138123,150.19604294951023
7532,C4_05110C_A,6108,C4,1097227,1099170,1943,373.124167932991,467.77346110133965
7534,C4_05120C_A,4,C4,1104280,1104594,314,1.5120198597095205,1.8955694211619782
7536,C4_05130C_A,622,C4,1104766,1106391,1625,45.432242270791846,56.956903462815944
7538,C4_05140C_A,3057,C4,1108501,1113084,4583,79.17220375820692,99.25558020044406
7540,C4_05150W_A,933,C4,1115386,1117143,1757,63.02850912638311,79.01676277211943
7542,C4_05160C_A,204,C4,1117383,1118930,1547,15.65189788842163,19.62226807400641
7544,C4_05170C_A,336,C4,1119301,1120516,1215,32.82389779399038,41.15023790334842
7546,C4_05180C_A,1353,C4,1120763,1125010,4247,37.813135227143405,47.40508029345992
7548,C4_05190C_A,431,C4,1125094,1126632,1538,33.261979144006546,41.69944604088673
7550,C4_05200C_A,25,C4,1127004,1127477,473,6.273443921099226,7.864809701966982
7552,C4_05210W_A,313,C4,1128701,1129393,692,53.68653751877568,67.30504113101212
7554,C4_05220C_A,160,C4,1129531,1131927,2396,7.926114122684298,9.936707817109536
7556,C4_05230C_A,202,C4,1132118,1134427,2309,10.383758733397084,13.017775795307704
7558,C4_05240C_A,1836,C4,1134817,1137282,2465,88.40623703874009,110.8319831214569
7560,C4_05250W_A,295,C4,1139061,1139768,707,49.525600991829165,62.088612263873415
7562,C4_05260W_A,588,C4,1143093,1144082,989,70.56806135942574,88.46885069969119
7564,C4_05270C_A,90,C4,1144171,1144818,647,16.510695995127918,20.69891493123551
7566,C4_05280W_A,1882,C4,1144988,1151416,6428,34.75128780552355,43.56654318204841
7568,C4_05290W_A,982,C4,1151631,1154099,2468,47.227339921162,59.20735817225017
7570,C4_05300W_A,844,C4,1154633,1156483,1850,54.14992637037544,67.88597644846794
7572,C4_05310W_A,90,C4,1156768,1158231,1463,7.301722699144062,9.153928886199164
7574,C4_05320W_A,1591,C4,1158925,1160073,1148,164.49603863121166,206.2232574058306
7576,C4_05330C_A,383,C4,1160202,1161677,1475,30.82009023192989,38.6381304623359
7578,C4_05340W_A,187,C4,1161917,1164274,2357,9.416926402463261,11.805689994886405
7580,C4_05350W_A,233,C4,1167102,1168889,1787,15.475992861789022,19.401741744691194
7582,C4_05360C_A,66,C4,1169089,1170171,1082,7.24008770162202,9.076659122957679
7584,C4_05370W_A,1027,C4,1171023,1173812,2789,43.70680712794969,54.793782341114415
7586,C4_05380C_A,37,C4,1174198,1174446,248,17.708313235993153,22.2003281603426
7588,C4_05390W_A,355,C4,1174822,1175916,1094,38.51573440626605,48.28590570770697
7590,C4_05400C_A,441,C4,1176257,1177441,1184,44.20934080519767,55.42379223521616
7592,C4_05420C_A,302,C4,1179358,1183830,4472,8.01553104072755,10.048806857667044
7594,C4_05430C_A,1569,C4,1184110,1185966,1856,100.33954420846587,125.79237667647996
7596,C4_05440C_A,1041,C4,1186514,1187842,1328,93.04216483860878,116.64389287893455
7598,C4_05450C_A,1608,C4,1188801,1189685,884,215.90412087263954,270.6718743149708
7600,C4_05460C_A,670,C4,1190491,1192344,1853,42.916721274377885,53.8032777690309
7602,C4_05530W_A,384,C4,1204629,1206167,1538,29.634802764033672,37.152174662878195
7604,C4_05540W_A,891,C4,1210137,1211771,1634,64.7221303902037,81.13999988313515
7606,C4_05550C_A,608,C4,1211998,1212963,965,74.78309208727045,93.75309568209211
7608,C4_05560C_A,697,C4,1213411,1214982,1571,52.66035048636318,66.01854429927884
7610,C4_05570C_A,226,C4,1215386,1216962,1576,17.020776859839216,21.33838648530118
7612,C4_05580C_A,3,C4,1217919,1218905,986,0.36113658921053965,0.45274502909091874
7614,C4_05590W_A,1482,C4,1221251,1229458,8207,21.43339276459443,26.8703374862582
7616,C4_05600W_A,557,C4,1230574,1233402,2828,23.377762502075292,29.307929687269066
7618,C4_05610C_A,3991,C4,1233748,1236879,3131,151.29543082654254,189.67409084918881
7620,C4_05620C_A,118,C4,1237338,1237799,461,30.38143158457546,38.088198586167906
7622,C4_05630W_A,1059,C4,1238032,1238988,956,131.48167256008577,164.83423570640898
7624,C4_05640C_A,286,C4,1239058,1239897,839,40.46049805761436,50.723991745539415
7626,C4_05650W_A,995,C4,1240101,1241087,986,119.77696875482899,150.16043464848804
7628,C4_05660C_A,719,C4,1241123,1243357,2234,38.20083657645251,47.89112868599543
7630,C4_05670W_A,6308,C4,1245541,1247604,2063,362.9272758561517,454.98995386919336
7632,C4_05680W_A,898,C4,1249405,1251384,1979,53.85892671576717,67.52115978068284
7634,C4_05690W_A,3764,C4,1251904,1254192,2288,195.26335490725998,244.79522690053074
7636,C4_05700W_A,282,C4,1256166,1259081,2915,11.482532979207427,14.395272822045527
7638,C4_05720W_A,12,C4,1262625,1262957,332,4.2901286380914705,5.37839275522465
7640,C4_05730W_A,329,C4,1263841,1264554,713,54.76883717642066,68.66188451001378
7642,C4_05740C_A,2344,C4,1264732,1269063,4331,64.23867519417931,80.53390805160208
7644,C4_05750C_A,149,C4,1269674,1270375,701,25.228730797564058,31.62842758148513
7646,C4_05760W_A,554,C4,1270621,1271970,1349,48.7444267449276,61.109279879105465
7648,C4_05770C_A,255,C4,1272201,1274483,2282,13.263303041952378,16.627765507497767
7650,C4_05780C_A,42,C4,1276925,1279141,2216,2.2496071649198055,2.8202582949327804
7652,C4_05790W_A,524,C4,1282526,1286320,3794,16.3931009249582,20.551489870868952
7654,C4_05800C_A,311,C4,1287292,1287657,365,101.13341601374898,126.78762757133687
7656,C4_05810W_A,5250,C4,1288330,1289715,1385,449.9214329839611,564.0516589865562
7658,C4_05820W_A,76,C4,1290067,1290333,266,33.91244542491353,42.514914160347224
7660,C4_05830W_A,44,C4,1290546,1290887,341,15.315297933831918,19.20028381435036
7662,C4_05840W_A,450,C4,1291227,1293410,2183,24.467293423838207,30.673838663557895
7664,C4_05850C_A,620,C4,1293694,1294932,1238,59.44265474318446,74.52129541837922
7666,C4_05860W_A,119,C4,1295759,1296151,392,36.03197326397063,45.172096295368924
7668,C4_05870C_A,14,C4,1296699,1298390,1691,0.9826787852281271,1.2319519774435328
7670,C4_05880W_A,287,C4,1301849,1303915,2066,16.4884082426552,20.67097351116592
7672,C4_05890W_A,41,C4,1304386,1304892,506,9.617462289476466,12.057095221363292
7674,C4_05900C_A,955,C4,1305122,1306300,1178,96.22440478164131,120.63336212305653
7676,C4_05910C_A,415,C4,1309161,1312463,3302,14.917573282764055,18.701669539038264
7678,C4_05920C_A,153,C4,1312804,1315008,2204,8.239616390672047,10.329735268995437
7680,C4_05940W_A,170,C4,1320918,1323974,3056,6.6027176138166075,8.277609268784882
7682,C4_05950C_A,1,C4,1324904,1324975,71,1.6717402674253148,2.0958056276227506
7684,C4_05960W_A,637,C4,1325490,1326404,914,82.72187863768568,103.70569050382291
7686,C4_05970W_A,756,C4,1326856,1328934,2078,43.182064771088164,54.13593015797823
7688,C4_05980C_A,459,C4,1329067,1331142,2075,26.255587265119797,32.91576366197485
7690,C4_05990W_A,1,C4,1331478,1331559,81,1.4653525800888563,1.837064192113769
7692,C4_06000W_A,299,C4,1331712,1333082,1370,25.90465265487008,32.47580851737472
7694,C4_06010C_A,135,C4,1333108,1334418,1310,12.231778979596674,15.334577817377149
7696,C4_06020C_A,774,C4,1334460,1337801,3341,27.49740037596251,34.4725837953848
7698,C4_06030W_A,1717,C4,1338043,1338714,671,303.72107418929636,380.76509187273723
7700,C4_06040W_A,146,C4,1339119,1340288,1169,14.824003089932264,18.58436367488232
7702,C4_06050W_A,105,C4,1340632,1341225,593,21.01656609385451,26.347775639001025
7704,C4_06060W_A,2146,C4,1341803,1351054,9251,27.533929044052055,34.518378581598526
7706,C4_06070C_A,287,C4,1351194,1352273,1079,31.570946644416722,39.57945437819165
7708,C4_06080W_A,58,C4,1352454,1352630,176,39.11492284805367,49.03708849176413
7710,C4_06090C_A,502,C4,1352664,1355066,2402,24.806064367848908,31.098544621036666
7712,C4_06100W_A,741,C4,1355313,1357805,2492,35.29371075823164,44.24656094496811
7714,C4_06110C_A,2863,C4,1357947,1360055,2108,161.20477200206167,202.09710500178338
7716,C4_06120W_A,10119,C4,1362406,1363776,1370,876.6862214536133,1099.072596613093
7718,C4_06130W_A,3100,C4,1364530,1376010,11480,32.0513965906195,40.18177862715744
7720,C4_06140C_A,99,C4,1376152,1377579,1427,8.23452161158552,10.323348112515987
7722,C4_06150C_A,12,C4,1378116,1378936,820,1.7369789120077663,2.177593164310468
7724,C4_06160W_A,185,C4,1379310,1380818,1508,14.561212475219834,18.25491174988384
7726,C4_06170C_A,381,C4,1380823,1381377,554,81.62860284137581,102.33508670184662
7728,C4_06180C_A,5,C4,1382072,1382211,139,4.269552481553862,5.352597106518535
7730,C4_06190C_A,1111,C4,1382397,1385960,3563,37.010537197523504,46.3988896190037
7732,C4_06200W_A,27,C4,1386049,1386258,209,15.333617668202528,19.223250661018245
7734,C4_06210C_A,1830,C4,1386346,1387926,1580,137.47418540922226,172.34685139052152
7736,C4_06220C_A,22,C4,1388385,1389065,680,3.8400857319387383,4.8141888093334355
7738,C4_06230C_A,624,C4,1389377,1391464,2087,35.48863479061387,44.490930774412234
7740,C4_06240W_A,140,C4,1391701,1393017,1316,12.626974360340144,15.830021229916518
7742,C4_06250C_A,1524,C4,1393150,1395522,2372,76.26011125484351,95.60478589008943
7744,C4_06260W_A,167,C4,1396271,1396981,710,27.91806246600276,34.99995398129993
7746,C4_06270C_A,1660,C4,1397074,1398126,1052,187.29211779348634,234.8019498779633
7748,C4_06280C_A,138,C4,1398542,1399618,1076,15.222779870105239,19.08429696974694
7750,C4_06290W_A,36,C4,1399953,1400249,296,14.435703120064542,18.097564811499158
7752,C4_06300C_A,58,C4,1400697,1401380,683,10.079394467434035,12.636204355125164
7754,C4_06310C_A,141,C4,1402334,1403224,890,18.80426046875823,23.574281054080174
7756,C4_06320C_A,50,C4,1403991,1404659,668,8.884248427185431,11.137889188713718
7758,C4_06340W_A,836,C4,1407066,1409819,2753,36.04352172658808,45.18657422200363
7760,C4_06350C_A,696,C4,1410147,1411982,1835,45.01946433519856,56.43941738125659
7762,C4_06360C_A,63,C4,1412344,1413132,788,9.489459665220092,11.896622553751984
7764,C4_06370C_A,293,C4,1413404,1415089,1685,20.639295420325713,25.874803840614884
7766,C4_06380W_A,45,C4,1417018,1417860,842,6.343479993377531,7.95261161550438
7768,C4_06390W_A,1913,C4,1418728,1419573,845,268.71098028699237,336.8740920243844
7770,C4_06400C_A,626,C4,1419739,1420542,803,92.53071970857478,116.00271099043682
7772,C4_06410W_A,177,C4,1420866,1423403,2537,8.280945975850978,10.381548806596415
7774,C4_06420W_A,936,C4,1426455,1429091,2636,42.14611957967251,52.83719984419481
7776,C4_06430C_A,204,C4,1429792,1431423,1631,14.845791559404207,18.61167916032368
7778,C4_06440C_A,198,C4,1431997,1433226,1229,19.12231462934506,23.973015063564382
7780,C4_06450W_A,136,C4,1433543,1433956,413,39.08553032023932,49.000240049213744
7782,C4_06460C_A,258,C4,1434027,1434701,674,45.434626437235785,56.959892413640276
7784,C4_06470W_A,2751,C4,1436216,1436827,611,534.4124071583959,669.9752062076976
7786,C4_06480C_A,723,C4,1437628,1438893,1265,67.8382949784535,85.04663263459183
7788,C4_06490C_A,102,C4,1442052,1443683,1631,7.422895779702103,9.30583958016184
7790,C4_06500W_A,2178,C4,1444145,1447327,3182,81.24279430361905,101.85141126471618
7792,C4_06510C_A,164,C4,1447546,1448538,992,19.622725477722145,24.600363637136397
7794,C4_06520W_A,1,C4,1449260,1449321,61,1.9457960489704484,2.43938032067566
7796,C4_06530C_A,313,C4,1449989,1451764,1775,20.93018814816494,26.239486457836833
7798,C4_06540W_A,2193,C4,1457328,1460318,2990,87.05517553810161,109.13820188553348
7800,C4_06550C_A,1560,C4,1461105,1465031,3926,47.1630035710718,59.12670181240343
7802,C4_06560W_A,53,C4,1466574,1467071,497,12.65746202479167,15.868242609143683
7804,C4_06570C_A,16307,C4,1468068,1469771,1703,1136.5448422808147,1424.8487775952658
7806,C4_06580W_A,801,C4,1471030,1472064,1034,91.94733147847687,115.27133641057394
7808,C4_06590W_A,265,C4,1472403,1473227,824,38.17207904321274,47.85507631519667
7810,C4_06600W_A,2541,C4,1473575,1477960,4385,68.78000761378985,86.22722670126524
7812,C4_06610C_A,10612,C4,1478187,1480112,1925,654.3252197257863,820.3059437629178
7814,C4_06620C_A,23,C4,1481276,1481707,431,6.333995027159024,7.940720626236547
7816,C4_06630C_A,1,C4,1482004,1482513,509,0.23318970331472957,0.29234223882360566
7818,C4_06640C_A,2,C4,1482851,1483333,482,0.4925043941377483,0.6174365127021382
7820,C4_06650W_A,1223,C4,1484245,1486263,2018,71.93370794912903,90.18091678065723
7822,C4_06660W_A,1,C4,1486939,1488489,1550,0.07657648966915959,0.09600141907175179
7824,C4_06670W_A,131,C4,1489544,1490743,1199,12.968187011945666,16.25778827566239
7826,C4_06680C_A,1969,C4,1490891,1493611,2720,85.92191825212926,107.71747460883562
7828,C4_06690C_A,958,C4,1494219,1494736,517,219.9389352219247,275.73018796836413
7830,C4_06700W_A,10,C4,1494984,1495313,329,3.6077069600971843,4.522863208547577
7832,C4_06710W_A,555,C4,1495684,1496802,1118,58.92211559740118,73.86871266232065
7834,C4_06720W_A,4112,C4,1497789,1498739,950,513.7556995319532,644.0785732586498
7836,C4_06730C_A,1309,C4,1498921,1500297,1376,112.9141487748847,141.5567436232782
7838,C4_06740C_A,1417,C4,1500722,1502503,1781,94.43502138397454,118.39007118374062
7840,C4_06750C_A,4,C4,1502546,1502986,440,1.0790323544290668,1.3527472687383209
7842,C4_06760W_A,4179,C4,1507097,1509049,1952,254.10880277023452,318.567823753237
7844,C4_06770W_A,426,C4,1509593,1511473,1880,26.895455387524507,33.71794521972218
7846,C4_06780C_A,887,C4,1511588,1512886,1298,81.11031342191374,101.68532435346529
7848,C4_06790W_A,621,C4,1513766,1514587,821,89.77917190140019,112.55318626981082
7850,C4_06800W_A,1505,C4,1514782,1516158,1376,129.8210801422471,162.7524057700792
7852,C4_06810C_A,1170,C4,1516294,1518216,1922,72.25362331686831,90.58198412415291
7854,C4_06820C_A,1171,C4,1518979,1520136,1157,120.12978182714616,150.60274475901736
7856,C4_06830C_A,2907,C4,1527753,1529432,1679,205.50457175448642,257.6343026351714
7858,C4_06840W_A,102,C4,1529634,1530410,776,15.601472959657384,19.559052004180362
7860,C4_06850C_A,1413,C4,1530448,1531563,1115,150.41614246539,188.57175603587189
7862,C4_06860C_A,208,C4,1531811,1532457,646,38.21712115996447,47.9115441311653
7864,C4_06870W_A,2631,C4,1532681,1533973,1292,241.704917720833,303.0174822334036
7866,C4_06880C_A,339,C4,1534066,1534347,281,143.1925853973662,179.5158208229608
7868,C4_06890W_A,66,C4,1535338,1536519,1181,6.633170951020344,8.315787613073843
7870,C4_06900W_A,1,C4,1536828,1537565,737,0.1610496051386667,0.20190257742362996
7872,C4_06910W_A,181,C4,1538056,1539795,1739,12.353958698494953,15.487750500621027
7874,C4_06920C_A,13,C4,1539950,1540393,443,3.4831066971412317,4.366655969065008
7876,C4_06930C_A,277,C4,1541258,1541980,722,45.537556564340264,57.088932518637996
7878,C4_06940C_A,221,C4,1542377,1543543,1166,22.496806634794694,28.20350437652537
7880,C4_06950W_A,159,C4,1543701,1544444,743,25.4001021251203,31.843270161821305
7882,C4_06960W_A,101,C4,1544730,1545158,428,28.009461349782555,35.114537746922295
7884,C4_06970C_A,105,C4,1545215,1546621,1406,8.86402823161858,11.11253979653457
7886,C4_06980W_A,127,C4,1547130,1548029,899,16.76761066893667,21.021000382952547
7888,C4_06990W_A,1608,C4,1548591,1550669,2078,91.84756633850498,115.146264145541
7890,C4_07000W_A,72,C4,1550811,1551437,626,13.651655346770301,17.11462998148163
7892,C4_07010C_A,144,C4,1551459,1551986,527,32.43239562458523,40.65942454803606
7894,C4_07020C_A,14,C4,1552509,1552955,446,3.7258067843514864,4.670921062459673
7896,C4_07030W_A,416,C4,1553710,1554468,758,65.14052841513734,81.66453168531078
7898,C4_07040W_A,327,C4,1554645,1556204,1559,24.895954963959934,31.21123749616254
7900,C4_07050W_A,541,C4,1556544,1557434,890,72.14968023828513,90.45167411530052
7902,C4_07060W_A,3074,C4,1557803,1562149,4346,83.95398074704202,105.25033627500595
7904,C4_07070W_A,241,C4,1562275,1562916,641,44.62581546944549,55.945912783545836
7906,C4_07080C_A,684,C4,1562962,1566078,3116,26.054683680116494,32.66389746465701
7908,C4_07090C_A,754,C4,1566664,1567773,1109,80.69877680464094,101.169394471737
7910,C4_07100C_A,1579,C4,1568024,1573987,5963,31.430006647792155,39.40276255360707
7912,C4_07110C_A,11134,C4,1574155,1575360,1205,1096.708784865938,1374.907626485121
7914,C4_07120C_A,1658,C4,1575583,1578204,2621,75.08352567751743,94.1297393637905
7916,C4_07130W_A,1830,C4,1578444,1582748,4304,50.46682456937063,63.26859321492193
7918,C4_07140W_A,939,C4,1583035,1583619,584,190.84460939893546,239.25559141777595
7920,C4_07150W_A,189,C4,1583826,1584365,539,41.619819385121154,52.17739465133523
7922,C4_07160W_A,67,C4,1584493,1584672,179,44.427198056660465,55.69691268492416
7924,C4_07170C_A,70,C4,1584704,1584946,242,34.332847640924854,43.041958550764754
7926,C4_07180W_A,10383,C4,1585323,1585904,581,2121.162173776369,2659.2310465475016
7928,C4_07190W_A,1587,C4,1586083,1588440,2357,79.91797968293686,100.1905348763889
7930,C4_07200C_A,437,C4,1588433,1589635,1202,43.15231720250021,54.098636612521695
7932,C4_07210W_A,262,C4,1589707,1590588,881,35.298198018894105,44.252186475639505
7934,C4_07220C_A,1613,C4,1590581,1593721,3140,60.97220084278642,76.43883690835676
7936,C4_07230C_A,1804,C4,1594317,1596377,2060,103.94329146257476,130.31027573224873
7938,C4_07240W_A,743,C4,1596552,1596950,398,221.58119177760713,277.78903083915316
7940,C4_07250C_A,35,C4,1597159,1597812,653,6.361829348471527,7.975615596696072
7942,C4_07260W_A,7,C4,1602903,1603258,355,2.340436374395441,2.9341278786718505
7944,C5_00010W_A,7,C5,1918,2427,509,1.632327923203107,2.04639567176524
7946,C5_00030W_A,2281,C5,3999,4808,809,334.6600841159421,419.5523080335378
7948,C5_00040C_A,1532,C5,4830,6473,1643,110.67470016335139,138.74922077162617
7950,C5_00050W_A,262,C5,6532,7230,698,44.552596639893565,55.85412075220401
7952,C5_00060C_A,596,C5,7209,8807,1598,44.26868658095721,55.49819207664851
7954,C5_00070W_A,1428,C5,8946,10154,1208,140.30993562393863,175.9019378919002
7956,C5_00080C_A,1434,C5,10151,11086,935,182.03910544132728,228.21642157302966
7958,C5_00090C_A,777,C5,11157,11819,662,139.3125307145806,174.65152425840526
7960,C5_00100C_A,781,C5,11839,12441,602,153.9861620747527,193.04737185599524
7962,C5_00110C_A,8257,C5,12554,14674,2120,462.289017244004,579.556491404224
7964,C5_00120W_A,85,C5,14763,15059,296,34.08429903348573,42.730361360484125
7966,C5_00130C_A,562,C5,15077,15475,398,167.60246269046462,210.11767877739445
7968,C5_00140C_A,278,C5,15563,15979,416,79.31925336163671,99.4399314375429
7970,C5_00150C_A,3406,C5,16398,18029,1631,247.8665002516212,310.7420550003061
7972,C5_00160W_A,412,C5,18148,18882,734,66.62363256502086,83.52385043490558
7974,C5_00170W_A,644,C5,19011,20093,1082,70.64570424006939,88.5661890179507
7976,C5_00180W_A,1977,C5,21297,23504,2207,106.32404445749395,133.294947228148
7978,C5_00190C_A,20281,C5,23548,29661,6113,393.7876770520774,493.67862085735436
7980,C5_00200C_A,3246,C5,30720,32849,2129,180.96725808945166,226.8726819049811
7982,C5_00210C_A,2132,C5,33839,35884,2045,123.74311381941553,155.13265988484642
7984,C5_00220W_A,1303,C5,36656,39271,2615,59.14252671522682,74.14503481004341
7986,C5_00230C_A,148,C5,39266,40126,860,20.42633340709908,25.60782038960449
7988,C5_00240W_A,907,C5,40891,42570,1679,64.118557475514,80.38332043003112
7990,C5_00250C_A,159,C5,42567,43190,623,30.292577654838492,37.9768053454787
7992,C5_00260W_A,2902,C5,43421,44635,1214,283.73040212590337,355.70344573858875
7994,C5_00270W_A,3396,C5,45823,46218,395,1020.4641172671448,1279.3222017971823
7996,C5_00280C_A,541,C5,46404,47366,962,66.74970417055485,83.6819022480431
7998,C5_00290W_A,395,C5,47854,48873,1019,46.00977016677424,57.680931135112885
8000,C5_00300C_A,1997,C5,48904,53010,4106,57.7279681679087,72.371649421273
8002,C5_00310C_A,725,C5,53247,53780,533,161.44996297508084,202.40449283654988
8004,C5_00320W_A,575,C5,54029,54322,293,232.93104579398795,292.01796842218016
8006,C5_00330C_A,1075,C5,54415,63318,8903,14.331750635879722,17.967243011154267
8008,C5_00340W_A,326,C5,63667,64644,977,39.60501558835859,49.65150159360919
8010,C5_00350C_A,1806,C5,64733,66052,1319,162.5174886511588,203.74281456220987
8012,C5_00360C_A,2,C5,66383,66464,81,2.9307051601777125,3.674128384227538
8014,C5_00370W_A,2399,C5,67605,68261,656,434.0637926986074,544.1714584563346
8016,C5_00380W_A,786,C5,69038,71404,2366,39.43074275736987,49.43302149413153
8018,C5_00390C_A,882,C5,71613,72101,488,214.52401439899197,268.94168035449155
8020,C5_00400C_A,1213,C5,74018,76453,2435,59.12742794721577,74.12610598265057
8022,C5_00410W_A,16,C5,77014,77355,341,5.569199248666151,6.981921387036495
8024,C5_00420C_A,554,C5,77777,78136,359,183.1649907490455,229.62790684376955
8026,C5_00430W_A,153,C5,78890,79492,602,30.166303197742845,37.81849922402979
8028,C5_00440C_A,565,C5,79518,80225,707,94.8541171538423,118.91547772572366
8030,C5_00450C_A,306,C5,80483,81598,1115,32.57419645747299,40.837195574647424
8032,C5_00460C_A,323,C5,82117,83979,1862,20.589699007983214,25.812626454496527
8034,C5_00470C_A,29,C5,84369,86237,1868,1.8426730249618433,2.3100983871923146
8036,C5_00480C_A,1079,C5,87345,88250,905,141.51419905766403,177.4116832337583
8038,C5_00490C_A,504,C5,89881,93594,3713,16.11137994332008,20.198305569311206
8040,C5_00500W_A,1244,C5,95043,98102,3059,48.2689726642934,60.51321878200452
8042,C5_00510W_A,30,C5,103156,104601,1445,2.4642261381425055,3.089319022032151
8044,C5_00520W_A,1,C5,105031,105504,473,0.250937756843969,0.3145923880786793
8046,C5_00530W_A,9,C5,105626,107950,2324,0.4596566397955147,0.5762563666312124
8048,C5_00540C_A,2,C5,109830,110891,1061,0.2237390367336425,0.28049424987976496
8050,C5_00550C_A,381,C5,121532,121855,323,140.00695348025448,175.52209917282667
8052,C5_00560W_A,537,C5,122290,122799,509,125.22287068000978,156.98778224827626
8054,C5_00570W_A,2591,C5,125110,130260,5150,59.71553618171424,74.86339787633182
8056,C5_00580W_A,611,C5,130820,132904,2084,34.79931120018119,43.62674852778433
8058,C5_00590W_A,25939,C5,134735,135640,905,3401.980360849627,4264.950557368357
8060,C5_00600C_A,102,C5,137588,138895,1307,9.263001542994743,11.612719476085664
8062,C5_00610C_A,295,C5,139506,141368,1862,18.804833459303556,23.57499939342562
8064,C5_00620W_A,14,C5,141650,142261,611,2.719656016073262,3.409543034135866
8066,C5_00630C_A,1057,C5,142316,144415,2099,59.7708870173738,74.93278939314176
8068,C5_00640C_A,267,C5,144757,146283,1526,20.767483780853013,26.035509359662175
8070,C5_00650C_A,344,C5,146706,147779,1073,38.05273466131956,47.7054582004269
8072,C5_00660C_A,8099,C5,148115,149701,1586,606.1154692542947,759.8669698904682
8074,C5_00670C_A,449,C5,151171,153228,2057,25.908316959286154,32.480402334946845
8076,C5_00680W_A,369,C5,156800,158155,1355,32.32319060241758,40.522517814087415
8078,C5_00690C_A,127,C5,158181,159323,1142,13.199721533602508,16.54805546784093
8080,C5_00700C_A,739,C5,159620,160765,1145,76.60658523278502,96.03914888710752
8082,C5_00710W_A,54,C5,164508,166652,2144,2.9894832953865005,3.7478165934261316
8084,C5_00730W_A,1496,C5,171023,174772,3749,47.36344738459516,59.37799160938332
8086,C5_00740W_A,42,C5,175545,176033,488,10.215429257094856,12.806746683547217
8088,C5_00750C_A,2225,C5,176142,178124,1982,133.24579654213628,167.04585974959838
8090,C5_00760W_A,503,C5,180036,181850,1814,32.91227131783918,41.26102887502276
8092,C5_00770C_A,618,C5,181901,184267,2366,31.00279774052746,38.867184838897316
8094,C5_00780C_A,185,C5,184660,185712,1052,20.872916742045163,26.1676871851947
8096,C5_00790C_A,2619,C5,186133,188229,2096,148.31032012760969,185.93175603569793
8098,C5_00800C_A,1443,C5,189505,190827,1322,129.55734161764434,162.42176548171986
8100,C5_00810C_A,4,C5,190881,191756,875,0.5425991267986164,0.6802386265655556
8102,C5_00820W_A,1398,C5,194339,195190,851,194.98659866521962,244.448266729235
8104,C5_00830C_A,1036,C5,195364,196608,1244,98.8476906034859,123.92208902364874
8106,C5_00840W_A,166,C5,196711,197904,1193,16.515616757648587,20.70508392888662
8108,C5_00850C_A,43,C5,197983,198300,317,16.100388127600905,20.184525492530778
8110,C5_00860W_A,306,C5,198637,199125,488,74.42669887311965,93.30629726584401
8112,C5_00870C_A,16,C5,199539,201137,1598,1.1884211162673077,1.4898843510509667
8114,C5_00880C_A,598,C5,202590,204197,1607,44.168480568975745,55.372567104920186
8116,C5_00890C_A,257,C5,206335,207939,1604,19.017608890093342,23.84174893218973
8118,C5_00900C_A,962,C5,210200,211276,1076,106.11821909450173,133.03691076012
8120,C5_00910C_A,59,C5,211600,211956,356,19.671123540013046,24.661038691325004
8122,C5_00920W_A,99,C5,212567,213013,446,26.34677654648551,33.03008465596483
8124,C5_00930C_A,3378,C5,213091,213870,779,514.6942776107223,645.2552376351543
8126,C5_00940C_A,645,C5,214536,215582,1046,73.19057891657964,91.75661445218341
8128,C5_00950C_A,821,C5,215856,217277,1421,68.57664456614287,85.97227715676125
8130,C5_00960W_A,1,C5,217451,217544,93,1.2762748278193263,1.6000236511958632
8132,C5_00970W_A,2,C5,217558,217651,93,2.5525496556386527,3.2000473023917264
8134,C5_00980W_A,358,C5,218210,219694,1484,28.633621372922274,35.897026578783745
8136,C5_00990W_A,5,C5,220201,220272,71,8.358701337126575,10.479028138113753
8138,C5_01000C_A,690,C5,220477,221181,704,116.33317571188377,145.84306491085022
8140,C5_01010W_A,253,C5,221837,222652,815,36.84597598007476,46.19258464906438
8142,C5_01020C_A,32,C5,222660,222935,275,13.811614136692056,17.315165039850505
8144,C5_01030W_A,6,C5,223245,223308,63,11.304148474971177,14.171638053449074
8146,C5_01040W_A,31,C5,223535,223858,323,11.39164188422018,14.281325654481964
8148,C5_01050C_A,1143,C5,223927,224533,606,223.87250482238707,280.66157441991595
8150,C5_01060C_A,571,C5,224788,225603,815,83.15830942538611,104.25282938583302
8152,C5_01070C_A,335,C5,225952,227454,1502,26.47293093256399,33.18824024834029
8154,C5_01080C_A,3104,C5,229537,231060,1523,241.9072929062775,303.27119332765085
8156,C5_01090C_A,1746,C5,234850,236442,1592,130.17522235656193,163.19638218208664
8158,C5_01100C_A,901,C5,244200,245597,1397,76.55182294020388,95.97049520734072
8160,C5_01110W_A,654,C5,253333,254304,971,79.9439624898322,100.22310866429949
8162,C5_01120W_A,15,C5,254730,255237,507,3.5116437570176733,4.402431939680926
8164,C5_01130W_A,1249,C5,261873,262667,794,186.71064883502453,234.07298142563965
8166,C5_01140C_A,2902,C5,262791,265052,2261,152.34352418436387,190.98805091846384
8168,C5_01150C_A,1,C5,265331,265415,84,1.413018559371397,1.7714547566811343
8170,C5_01160C_A,2,C5,265434,265534,100,2.373871179743947,2.9760439912243055
8172,C5_01170W_A,139,C5,266063,266791,728,22.662643817610487,28.411408982155116
8174,C5_01180W_A,1234,C5,266959,268119,1160,126.26538947431166,158.29475367115487
8176,C5_01190W_A,664,C5,268261,269373,1112,70.87457119379411,88.85311196820768
8178,C5_01200W_A,199,C5,269467,269937,470,50.25535795415377,63.00348449506775
8180,C5_01210W_A,7868,C5,270287,272368,2081,448.76545992852897,562.602453699011
8182,C5_01220W_A,639,C5,273044,274345,1301,58.29760506750123,73.08578441169605
8184,C5_01230C_A,757,C5,274465,275364,899,99.94552186129967,125.29840385744156
8186,C5_01240W_A,882,C5,276990,278405,1415,73.98425372912232,92.75161838373985
8188,C5_01250W_A,1134,C5,280816,283287,2471,54.47126503095176,68.28882812724328
8190,C5_01260W_A,60,C5,283848,286220,2372,3.002366584836358,3.763967948428717
8192,C5_01270W_A,655,C5,286734,288617,1883,41.28745679055457,51.76072263016252
8194,C5_01280C_A,397,C5,288699,290108,1409,33.44311065856448,41.92652464570792
8196,C5_01290C_A,1242,C5,290422,291162,740,199.2127030568907,249.74639439868835
8198,C5_01300C_A,478,C5,291456,292550,1094,51.86062266533852,65.01595191065897
8200,C5_01310W_A,268,C5,293743,294381,638,49.85873637706723,62.50625310721897
8202,C5_01320W_A,1737,C5,294646,296502,1856,111.08335773747942,139.26154129193478
8204,C5_01330W_A,5,C5,296701,297147,446,1.330645280125531,1.6681860937355975
8206,C5_01340W_A,1131,C5,297628,299091,1463,91.75831525257703,115.03437300323615
8208,C5_01350W_A,571,C5,299565,301415,1850,36.634606584697124,45.927597810515636
8210,C5_01360W_A,19,C5,303368,305500,2132,1.0577756194919088,1.326098401342913
8212,C5_01380W_A,41,C5,308742,310874,2132,2.282568442061488,2.8615807607926014
8214,C5_01390C_A,127,C5,311113,311721,608,24.792898012128397,31.08203839518806
8216,C5_01400W_A,372,C5,313333,315318,1985,22.243830701882832,27.886356794343623
8218,C5_01410C_A,498,C5,315377,317962,2585,22.866302659815968,28.666729354539733
8220,C5_01420W_A,307,C5,318343,318662,319,114.22859752059432,143.2046246560912
8222,C5_01430C_A,429,C5,319484,320866,1382,36.844816791250125,46.19113141227305
8224,C5_01440C_A,343,C5,321017,322234,1217,33.45266288628488,41.93849995850193
8226,C5_01450W_A,877,C5,322718,324214,1496,69.58171873781556,87.23230549143436
8228,C5_01460W_A,719,C5,324412,328203,3791,22.511387209653098,28.221783562256345
8230,C5_01470C_A,135,C5,328259,329767,1508,10.62574964407934,13.321151817482802
8232,C5_01480W_A,171,C5,330456,330884,428,47.42195931497839,59.45134608637339
8234,C5_01490C_A,536,C5,330986,332797,1811,35.12962320107001,44.04084978730612
8236,C5_01500C_A,526,C5,333128,336385,3257,19.16880934211416,24.031303951243245
8238,C5_01510W_A,277,C5,338274,338594,320,102.74411199829271,128.80690399517698
8240,C5_01520C_A,1521,C5,338743,340293,1550,116.47284078679174,146.01815840813447
8242,C5_01530C_A,432,C5,340759,342204,1445,35.48485638925208,44.48619391726298
8244,C5_01540W_A,239,C5,342887,343737,850,33.37383599757667,41.83967728838877
8246,C5_01550C_A,816,C5,343387,343875,488,198.47119699498575,248.81679270891738
8248,C5_01560C_A,443,C5,344089,344778,689,76.31530715722558,95.67398317216018
8250,C5_01570C_A,143,C5,345209,347536,2327,7.294017591392017,9.144269246778594
8252,C5_01580C_A,33220,C5,347886,351038,3152,1250.951786026236,1568.276989030321
8254,C5_01590W_A,80,C5,353407,355008,1601,5.930971092427101,7.435462813802139
8256,C5_01600C_A,355,C5,355185,357080,1895,22.235468834013226,27.875873796428195
8258,C5_01610W_A,201,C5,357144,358613,1469,16.240575463871117,20.360273731657095
8260,C5_01620C_A,55,C5,358644,359429,785,8.316109228402363,10.425631816390881
8262,C5_01640W_A,1478,C5,360948,362516,1568,111.88079093308527,140.26125698435982
8264,C5_01650C_A,1055,C5,362665,368511,5846,21.420065811066234,26.853629924235737
8266,C5_01670W_A,52,C5,375462,377102,1640,3.76345430935016,4.71811852267268
8268,C5_01680C_A,332,C5,377647,379728,2081,18.93621412001419,23.739706993908445
8270,C5_01690C_A,895,C5,382476,384125,1649,64.42130703064987,80.76286756051405
8272,C5_01700W_A,1100,C5,384426,385058,632,206.58689064227386,258.9911701223684
8274,C5_01710C_A,170,C5,385279,387495,2216,9.105552810389689,11.415331193775542
8276,C5_01720C_A,142,C5,387749,390304,2555,6.596667466216058,8.270024398314117
8278,C5_01730W_A,80,C5,390706,393267,2561,3.707725388120183,4.648253012454988
8280,C5_01740C_A,486,C5,393493,394455,962,59.96368988334503,75.17449998622727
8282,C5_01750C_A,58,C5,394560,395220,660,10.430646092814312,13.0765569311371
8284,C5_01760C_A,1093,C5,395335,398205,2870,45.202808352964006,56.669269728365265
8286,C5_01770C_A,3487,C5,398770,400071,1301,318.1279325045021,398.8264949038876
8288,C5_01780W_A,1931,C5,400477,402144,1667,137.49085927071272,172.3677548606519
8290,C5_01790C_A,41,C5,402452,402754,302,16.114026220116198,20.201623119237837
8291,C5_01800C_A,1206,C5,402802,404601,1799,79.56888946001112,99.75289197933608
8293,C5_01810W_A,255,C5,407947,409146,1199,25.24341746600111,31.646839773235943
8295,C5_01820W_A,1622,C5,409928,411697,1769,108.83038591138163,136.43706483227314
8297,C5_01830C_A,694,C5,411944,414976,3032,27.167984807755595,34.05960636394571
8299,C5_01840C_A,1233,C5,416400,419345,2945,49.69411145372304,62.299868271299985
8301,C5_01850C_A,1219,C5,420926,423694,2768,52.271477025069935,65.53102646861323
8303,C5_01860W_A,2,C5,424381,424716,335,0.7086182626101334,0.8883713406639719
8305,C5_01870W_A,2068,C5,424739,427087,2348,104.53930152705458,131.0574738895201
8307,C5_01880C_A,240,C5,427195,427842,647,44.02852265367444,55.197106483294704
8309,C5_01890W_A,318,C5,428107,428781,674,56.00081863194178,70.20637902146359
8311,C5_01900C_A,70,C5,428854,429018,164,50.66188493355984,63.5131339590553
8313,C5_01910W_A,2534,C5,429592,430119,527,570.720073004854,715.4929291994678
8315,C5_01920C_A,184,C5,430841,432214,1373,15.906492974249318,19.94144553478777
8317,C5_01930W_A,270,C5,432413,433954,1541,20.796405533123483,26.071767606442652
8319,C5_01940W_A,660,C5,434181,435950,1769,44.28363421794813,55.516931436066756
8321,C5_01950C_A,411,C5,435968,437557,1589,30.700473721672818,38.48817118921301
8323,C5_01960C_A,2491,C5,438134,440017,1883,157.01840437446026,196.8487940026486
8325,C5_01970C_A,1087,C5,440800,443334,2534,50.9155085316036,63.83109349764839
8327,C5_01980C_A,675,C5,444832,445512,680,117.82081222993855,147.70806574091222
8329,C5_01990W_A,126,C5,446199,446600,401,37.295232998470986,46.75580335339931
8331,C5_02000C_A,7567,C5,446964,448538,1574,570.6189077866089,715.366101702488
8333,C5_02010C_A,1009,C5,451345,453531,2186,54.78581931293785,68.68317445437613
8335,C5_02020C_A,711,C5,453808,454866,1058,79.76476412088594,99.99845358036302
8337,C5_02030W_A,1483,C5,455201,456193,992,177.4420846552557,222.45328825532488
8339,C5_02040W_A,1325,C5,456436,457821,1385,113.55159975309495,142.35589488708322
8341,C5_02050W_A,939,C5,458157,463166,5009,22.25059929905736,27.89484236134581
8343,C5_02060W_A,190,C5,463382,464368,986,22.871983983334175,28.673851842424853
8345,C5_02070C_A,516,C5,464404,465366,962,63.66515222182312,79.814901219945
8347,C5_02080C_A,22,C5,466337,466720,383,6.8179067825544175,8.547384831192522
8349,C5_02090W_A,1,C5,467461,467754,293,0.405097470946066,0.5078573363864003
8351,C5_02110W_A,6,C5,473498,473881,383,1.8594291225148412,2.331104953961597
8353,C5_02120C_A,943,C5,474334,476817,2483,45.0777390756855,56.51247450109787
8355,C5_02130W_A,1,C5,474758,475336,578,0.20535217817854212,0.25744325183601263
8357,C5_02140C_A,369,C5,477228,477779,551,79.48806400413035,99.65156377148537
8359,C5_02150C_A,637,C5,477990,479684,1694,44.632701933202306,55.95454611599418
8361,C5_02160W_A,98,C5,480236,482263,2027,5.738514445360306,7.194186263936407
8363,C5_02170C_A,5400,C5,482348,483952,1604,399.5917821264749,500.9550359292784
8365,C5_02180C_A,1517,C5,484150,487104,2954,60.95400439525336,76.41602462233026
8367,C5_02190C_A,657,C5,487795,488164,369,211.33243429427824,264.94050165777355
8369,C5_02200W_A,31,C5,488648,489742,1094,3.3633458213922465,4.216515709687088
8371,C5_02210W_A,704,C5,489943,490926,983,85.00535658899994,106.56841148636373
8373,C5_02220C_A,335,C5,491075,491653,578,68.79297968981162,86.24348936506422
8375,C5_02230W_A,1763,C5,492351,493187,836,250.30711063926907,313.8017677349552
8377,C5_02240W_A,134,C5,498691,499884,1193,13.33188340677657,16.713742448619318
8379,C5_02260C_A,527,C5,501453,502862,1409,44.39425520670902,55.65561332062488
8381,C5_02270W_A,2767,C5,503291,504823,1532,214.37668258327358,268.7569753171558
8383,C5_02280C_A,177,C5,504892,506283,1391,15.10335006522928,18.934571763001514
8385,C5_02290W_A,231,C5,508123,509403,1280,21.420478223470774,26.854146952063072
8387,C5_02300C_A,1286,C5,509606,511327,1721,88.69257225888194,111.190952141617
8389,C5_02310C_A,178,C5,511587,513602,2015,10.485088585469544,13.144809688286015
8391,C5_02320C_A,115,C5,514002,515186,1184,11.52851290838488,14.452916342516687
8393,C5_02330W_A,249,C5,515646,515960,314,94.12323626691764,117.99919646733314
8395,C5_02340C_A,1677,C5,517861,521547,3686,54.001383185439494,67.69975275750353
8397,C5_02350C_A,107,C5,523617,524495,878,14.464932587278039,18.134208830353117
8399,C5_02360C_A,40,C5,524833,525309,476,9.974248654386333,12.504386517749184
8401,C5_02370C_A,465,C5,525672,527018,1346,41.004832785324496,51.40640623771553
8403,C5_02380W_A,9540,C5,529671,531464,1793,631.5318197087913,791.7306100468453
8405,C5_02390C_A,268,C5,531715,532662,947,33.59015185698933,42.110865345729344
8407,C5_02400W_A,912,C5,533214,534119,905,119.61163071417015,149.95315580091528
8409,C5_02410C_A,139,C5,534199,534717,518,31.850202122047172,39.92954775870449
8411,C5_02430W_A,201,C5,535546,537645,2099,11.366081637173258,14.249281615914375
8413,C5_02440C_A,264,C5,537707,538597,890,35.20797704788776,44.13907942040544
8415,C5_02450W_A,485,C5,538877,541222,2345,24.54856124042248,30.775721444430452
8417,C5_02460C_A,1130,C5,541501,542742,1241,108.07713267972039,135.49273610328225
8419,C5_02470W_A,1633,C5,547644,553208,5564,34.83583426062065,43.672536283872134
8421,C5_02480W_A,1092,C5,553739,554719,980,132.25853715716275,165.80816522535414
8423,C5_02490C_A,1032,C5,555200,556462,1262,97.0616108358064,121.68293973627112
8425,C5_02500C_A,795,C5,557609,559051,1442,65.4378497883647,82.03727368319427
8427,C5_02510C_A,765,C5,559298,560461,1163,78.07443905864658,97.879348808538
8429,C5_02520W_A,210,C5,562888,563793,905,27.54215180918392,34.52868719100023
8431,C5_02530W_A,287,C5,565049,566509,1460,23.332227006387427,29.250843338403282
8433,C5_02540C_A,95,C5,566644,568018,1374,8.206614340453966,10.28836168727471
8435,C5_02550C_A,858,C5,568081,570480,2399,42.45063510254912,53.21896091018037
8437,C5_02560C_A,424,C5,570689,572443,1754,28.69217161378089,35.97042908435307
8439,C5_02570W_A,78,C5,573167,575461,2294,4.035787969050303,5.059534248376107
8441,C5_02580W_A,118,C5,575960,576265,305,45.92078675570258,57.569375567945585
8443,C5_02590C_A,366,C5,576552,579308,2756,15.762642448952915,19.761104876416834
8445,C5_02600W_A,182,C5,580917,582386,1469,14.705396688679318,18.43567074209747
8447,C5_02610C_A,312,C5,582629,586153,3524,10.508623837686033,13.174315057633134
8449,C5_02620C_A,1011,C5,586676,588685,2009,59.73080544353237,74.8825404461865
8451,C5_02630C_A,368,C5,589400,591802,2402,18.184525273642226,22.797339483150385
8453,C5_02640W_A,117,C5,594501,595151,650,21.364840617695528,26.784395921018753
8455,C5_02650C_A,1970,C5,595462,598119,2657,88.00388076958178,110.32756233932787
8457,C5_02660C_A,666,C5,600804,601811,1007,78.50040743343936,98.4133713086091
8459,C5_02670W_A,354,C5,602727,604307,1580,26.59336701358725,33.3392269902976
8461,C5_02680W_A,215,C5,604742,605716,974,26.20032359573658,32.84648142265019
8463,C5_02690W_A,670,C5,606039,607136,1097,72.49287558926365,90.88192680584707
8465,C5_02700W_A,1144,C5,607797,610301,2504,54.227408738559824,67.98311353755203
8467,C5_02710W_A,3663,C5,611323,612285,962,451.94855152817456,566.592990636935
8469,C5_02720W_A,239,C5,612652,613482,830,34.178024816795386,42.8478622832897
8471,C5_02730C_A,542,C5,613567,614718,1151,55.89218850656904,70.07019301666263
8473,C5_02740W_A,514,C5,614913,616580,1667,36.59777403684429,45.88142206026674
8475,C5_02750C_A,680,C5,616642,619695,3053,26.436822833702657,33.14297271589466
8477,C5_02760W_A,339,C5,620204,621007,803,50.108488787870364,62.81935946606723
8479,C5_02770W_A,628,C5,621344,622543,1199,62.168102622151736,77.93809951996931
8481,C5_02780W_A,701,C5,623507,625951,2444,34.04426548691708,42.68017262373646
8483,C5_02790C_A,1201,C5,626060,627808,1748,81.55089493342336,102.23766686099516
8485,C5_02800C_A,15,C5,628354,629076,722,2.465932665939003,3.091458439637437
8487,C5_02810W_A,77,C5,629164,629673,509,17.95560715523418,22.510352389417637
8489,C5_02820C_A,262,C5,629720,630532,812,38.297675436755796,48.012532370736956
8491,C5_02830W_A,445,C5,630777,631655,878,60.15789720877315,75.41797130380502
8493,C5_02840C_A,2209,C5,631817,636205,4388,59.752523200255006,74.90976728138664
8495,C5_02850W_A,325,C5,637935,638080,145,266.0372873850975,333.52217143031015
8497,C5_02860C_A,1151,C5,638962,639987,1025,133.28418184806262,167.09398214142323
8499,C5_02870C_A,3,C5,640712,641194,482,0.7387565912066225,0.9261547690532071
8501,C5_02890W_A,2121,C5,641753,642208,455,553.2945903557046,693.6471764161266
8503,C5_02900W_A,1719,C5,642638,644950,2312,88.25009857222848,110.63623747652643
8505,C5_02910C_A,353,C5,645248,647530,2282,18.360572446310545,23.01804401626161
8507,C5_02920W_A,301,C5,648510,649700,1190,30.022488449702863,37.63820341842504
8509,C5_02930C_A,1032,C5,649786,650901,1115,109.85807432716383,137.7254438988109
8511,C5_02940C_A,3253,C5,651905,653617,1712,225.5316281456501,282.74156260083726
8513,C5_02950C_A,9,C5,654469,654849,380,2.8111632391704635,3.524262621186678
8515,C5_02960C_A,21,C5,654930,655382,452,5.514523758254745,6.91337652828655
8517,C5_02970W_A,867,C5,656966,659482,2516,40.90115884018287,51.27643363258095
8519,C5_02980C_A,11,C5,659648,660151,503,2.595684192562964,3.2541236484560003
8521,C5_02990W_A,169,C5,660366,660920,554,36.20796294013782,45.39272874701333
8523,C5_03000C_A,372,C5,661022,664453,3431,12.869135512456257,16.133610678161492
8525,C5_03010W_A,348,C5,664894,666915,2021,20.438079429759863,25.622545990748602
8527,C5_03020W_A,387,C5,668022,671636,3614,12.71012931047188,15.934269847866716
8529,C5_03030W_A,566,C5,672427,674499,2072,32.42304748395449,40.64770509249414
8531,C5_03040W_A,600,C5,674318,675910,1592,44.73375338713468,56.08123099040777
8533,C5_03050C_A,82,C5,676465,677187,722,13.48043190713322,16.899972803351318
8535,C5_03060C_A,21,C5,679515,681047,1532,1.627000482200486,2.0397168347163976
8537,C5_03070W_A,14835,C5,682963,683640,677,2600.9142504801666,3260.6803995430264
8539,C5_03080C_A,299,C5,684022,686037,2015,17.612592623906703,22.08032638650291
8541,C5_03090W_A,940,C5,687505,688824,1319,84.58828312961754,106.04554024832628
8543,C5_03100C_A,326,C5,688982,689980,998,38.77164351686006,48.60673051799217
8545,C5_03110C_A,54,C5,690600,691057,457,14.025059486452204,17.58275443392916
8547,C5_03120W_A,141,C5,691292,692740,1448,11.55786727706825,14.489716946223313
8549,C5_03130W_A,74,C5,697356,698426,1070,8.208713425282808,10.290993240682178
8551,C5_03140C_A,5297,C5,699595,705870,6275,100.1943875625792,125.61039857780995
8553,C5_03150W_A,1639,C5,709951,711870,1919,101.375061584167,127.0905706518144
8555,C5_03160W_A,296,C5,712905,716690,3785,9.282243978919528,11.636843083254881
8557,C5_03170C_A,494,C5,716852,719299,2447,23.961838226267062,30.04016615579908
8559,C5_03210C_A,56,C5,726044,728167,2123,3.130871080208691,3.9250697953029
8561,C5_03240W_A,249,C5,731795,732916,1121,26.364581791090224,33.05240650378466
8563,C5_03250W_A,158,C5,734682,736340,1658,11.310966417356564,14.180185482914363
8565,C5_03260C_A,462,C5,736879,740160,3281,16.71332650170228,20.95294611316107
8567,C5_03270W_A,67,C5,741739,742398,659,12.067478683068623,15.128599955389111
8569,C5_03280W_A,1859,C5,742816,744072,1256,175.6778074499999,220.24147212125735
8571,C5_03290C_A,340,C5,744290,744577,287,140.6125785911049,176.28135139656166
8573,C5_03300C_A,306,C5,745130,747427,2297,15.812028319583103,19.823018313335606
8575,C5_03310C_A,196,C5,748851,749972,1121,20.752843498207568,26.017155320248165
8577,C5_03320C_A,53,C5,754145,755731,1586,3.9664304075166834,4.972582961377308
8579,C5_03330C_A,720,C5,756011,759739,3728,22.923648731432966,28.738622232852737
8581,C5_03340W_A,1,C5,760485,760805,320,0.37091737183499174,0.4650068736287978
8583,C5_03350W_A,3264,C5,761964,763088,1124,344.6759577706514,432.10887844110914
8585,C5_03360W_A,608,C5,763489,763962,473,152.57015616113316,191.27217195183698
8587,C5_03370C_A,50,C5,764152,764667,515,11.523646503611394,14.446815491380127
8589,C5_03380W_A,138,C5,764896,766140,1244,13.16697036996241,16.506996414347032
8591,C5_03390C_A,400,C5,766244,766900,656,72.37412133365693,90.73304851293614
8593,C5_03400C_A,443,C5,767218,767744,526,99.96434720784872,125.32200457341895
8595,C5_03410C_A,511,C5,768110,768631,521,116.4153716745832,145.94611127789062
8597,C5_03420W_A,1,C5,769601,769694,93,1.2762748278193263,1.6000236511958632
8599,C5_03430W_A,20,C5,772001,772828,827,2.8704609186746644,3.5986021659302367
8601,C5_03440W_A,62,C5,775455,775670,215,34.227910033517375,42.91040173393184
8603,C5_03450W_A,8,C5,776792,776872,80,11.869355898719736,14.880219956121529
8605,C5_03460C_A,125,C5,777303,778316,1013,14.64629306357322,18.361574476951542
8607,C5_03470C_A,752,C5,778703,780199,1496,59.6641419507837,74.79896662435421
8609,C5_03480C_A,447,C5,780649,782214,1565,33.90161077781292,42.50133112067938
8611,C5_03490C_A,2598,C5,782698,784329,1631,189.06552191829473,237.02520813000447
8613,C5_03500W_A,4556,C5,785559,787265,1706,316.9799851967592,397.3873512314753
8615,C5_03510C_A,2285,C5,787678,789219,1541,175.99920978958207,220.6444036323017
8617,C5_03520W_A,106,C5,791003,792178,1175,10.707674257568442,13.423858002969208
8619,C5_03530C_A,86,C5,792460,793005,545,18.72962582183298,23.480714059200945
8621,C5_03540C_A,6491,C5,793426,793743,317,2430.4097520059872,3046.9245342329605
8623,C5_03550W_A,4608,C5,794502,796880,2378,229.99996627964902,288.3433707224895
8625,C5_03560W_A,221,C5,797418,797924,506,51.84046746278778,64.9906839980802
8627,C5_03570W_A,625,C5,798357,798866,509,145.743564571706,182.71389926475354
8629,C5_03580C_A,349,C5,798967,800349,1382,29.973988485189494,37.577400612781574
8631,C5_03590W_A,621,C5,801071,802807,1736,42.45892864691795,53.22935825317666
8633,C5_03600W_A,2765,C5,803133,804599,1466,223.86609181418874,280.65353464308345
8635,C5_03610W_A,635,C5,805339,807027,1688,44.65071679909379,55.977130759106466
8637,C5_03620W_A,960,C5,807684,808682,998,114.17416495762471,143.13638434746161
8639,C5_03630C_A,186,C5,808679,809257,578,38.19550514120884,47.88444484149835
8641,C5_03640W_A,41,C5,809368,810267,899,5.413165649026799,6.786307210244523
8643,C5_03650C_A,48,C5,810545,811666,1121,5.0823290199692,6.371548241693429
8645,C5_03670C_A,142,C5,813516,814376,860,19.598238809513983,24.56966550894485
8647,C5_03680W_A,564,C5,816570,818933,2363,28.32973646583974,35.516056095017106
8649,C5_03690W_A,242,C5,819887,821131,1244,23.089904561818138,28.947051683130304
8651,C5_03700C_A,60,C5,821296,822195,899,7.921705827844095,9.931181283284669
8653,C5_03710C_A,148,C5,822508,823392,884,19.871772319123536,24.912585446900298
8655,C5_03720C_A,6,C5,823474,823827,353,2.017454260405621,2.5292158565645657
8657,C5_03730W_A,9,C5,824224,825066,842,1.268695998675506,1.590522323100876
8659,C5_03740W_A,88,C5,825581,826402,821,12.722330317750753,15.94956584821796
8661,C5_03750W_A,941,C5,829497,829922,425,262.8015035457711,329.4655759696555
8663,C5_03760C_A,634,C5,830628,833507,2879,26.13814393813238,32.76852883703039
8665,C5_03770C_A,25,C5,833913,835052,1139,2.6052142007725494,3.2660711053822498
8667,C5_03780C_A,115,C5,836229,836855,626,21.80472728998035,27.335867331533162
8669,C5_03790W_A,279,C5,837646,838218,572,57.89423593955955,72.58009384192144
8671,C5_03800W_A,900,C5,838556,839140,584,182.91815597342057,229.31845822790024
8673,C5_03810C_A,210,C5,839331,840098,767,32.49758459884152,40.74114981467433
8675,C5_03820C_A,633,C5,840571,842865,2294,32.75197159498514,41.060066400283034
8677,C5_03830C_A,302,C5,843215,843910,695,51.576193977170654,64.65937304674391
8679,C5_03840W_A,91,C5,844113,845093,980,11.021544763096898,13.81734710211285
8681,C5_03850W_A,171,C5,845502,845894,392,51.77703721125191,64.91116358410156
8683,C5_03860W_A,196,C5,846256,846864,608,38.2630551998202,47.96913012170756
8685,C5_03870C_A,637,C5,847034,847642,608,124.35492939941564,155.89967289554957
8687,C5_03880C_A,129,C5,848550,850904,2354,6.504447370156525,8.154411105945952
8689,C5_03890C_A,5,C5,855432,855689,257,2.309213209867653,2.8949844272609977
8691,C5_03900W_A,3637,C5,856564,856818,254,1699.5609214032943,2130.683463795827
8693,C5_03910C_A,7,C5,857664,858137,473,1.7565642979077833,2.202146716550755
8695,C5_03920C_A,282,C5,858499,859104,605,55.324931627090336,69.35904177894663
8697,C5_03930C_A,281,C5,859535,861340,1805,18.478055443436265,23.165328574349857
8699,C5_03940C_A,187,C5,863687,865150,1463,15.171357163777106,19.019830019102706
8701,C5_03950W_A,612,C5,868673,871177,2504,29.00976761188689,36.36858871064846
8703,C5_03960W_A,972,C5,872141,872530,389,296.58133505284275,371.8142364357359
8705,C5_03970W_A,64,C5,873670,875154,1484,5.1188596867794,6.417345533637317
8707,C5_03980W_A,790,C5,876481,878958,2477,37.85543463862975,47.45810967031089
8709,C5_03990W_A,311,C5,879343,881022,1679,21.985525220380215,27.56252773289932
8711,C5_04000W_A,205,C5,881262,882376,1114,21.842171985974378,27.382810511713764
8713,C5_04010C_A,41,C5,882395,883033,638,7.627642505446852,9.562523796253647
8715,C5_04020C_A,5,C5,889328,889642,314,1.8900248246369007,2.369461776452473
8717,C5_04030W_A,689,C5,891519,892661,1142,71.61108769017424,89.77645840427087
8719,C5_04040C_A,18,C5,896436,896792,356,6.001359724071776,7.52370671938729
8721,C5_04050W_A,1653,C5,899279,902074,2795,70.19694204144444,88.00359065284039
8723,C5_04060C_A,829,C5,902120,909097,6977,14.103047212324293,17.68052507327612
8725,C5_04070C_A,251,C5,909565,909873,308,96.72754320060564,121.26413016189947
8727,C5_04080C_A,599,C5,910835,911500,665,106.91344636591161,134.0338609581473
8729,C5_04090C_A,727,C5,912034,912363,329,262.2802959990653,328.8121552614088
8731,C5_04100W_A,1238,C5,913806,915161,1355,108.4447424547235,135.95359635187052
8733,C5_04110W_A,835,C5,916837,918357,1520,65.20336957520382,81.74331357474657
8735,C5_04120C_A,204,C5,918450,919472,1022,23.692256392747808,29.702200303804226
8737,C5_04130C_A,4287,C5,919760,921511,1751,290.5992503587179,364.31469418556816
8739,C5_04140W_A,5,C5,924645,925907,1262,0.47025974242154267,0.5895491266292207
8741,C5_04150C_A,138,C5,926574,927257,683,23.982007525963745,30.0654517415047
8743,C5_04160W_A,151,C5,927500,927886,386,46.431936287737834,58.21018687498318
8745,C5_04170W_A,817,C5,928229,929836,1607,60.34389402149362,75.65114937244113
8747,C5_04180W_A,191,C5,930400,931917,1517,14.944278026733484,18.735148395644114
8749,C5_04190W_A,85,C5,933743,934489,746,13.524065032053318,16.954674212739008
8751,C5_04200W_A,3,C5,936262,936849,587,0.6066110340061194,0.7604882430726506
8753,C5_04210C_A,2,C5,937203,937973,770,0.3082949584083048,0.3864992196395202
8755,C5_04220W_A,3,C5,939282,939923,641,0.5555080763831389,0.6964221508325208
8757,C5_04230W_A,4,C5,940661,941251,590,0.8047020948284566,1.0088284716014595
8759,C5_04240C_A,1,C5,942315,942626,311,0.3816513150713741,0.47846366418397196
8761,C5_04250W_A,214,C5,943001,943615,614,41.36876485873003,51.86265587312716
8763,C5_04260W_A,475,C5,944238,945479,1241,45.43065311758158,56.95491119385759
8765,C5_04270C_A,14556,C5,945967,947319,1352,1277.8871631787313,1602.044982849889
8767,C5_04280C_A,1960,C5,947806,949854,2048,113.59344512446621,142.40835504881932
8769,C5_04290C_A,883,C5,952051,953346,1295,80.93159273026662,101.46126811780162
8771,C5_04300C_A,1749,C5,954129,955433,1304,159.1986462182578,199.58209128264227
8773,C5_04310W_A,148,C5,956328,957911,1583,11.097060473850416,13.912018657649947
8775,C5_04320C_A,792,C5,958126,960237,2111,44.531169454220894,55.82725819634416
8777,C5_04330W_A,384,C5,960735,961004,269,169.4361585542148,212.4165227937051
8779,C5_04340W_A,373,C5,961458,962357,899,49.24660456309746,61.73884364441969
8781,C5_04350C_A,833,C5,962394,963245,851,116.18300192283832,145.6547969853024
8783,C5_04360C_A,898,C5,963406,964269,863,123.50731862167234,154.83705122360524
8785,C5_04370C_A,336,C5,965156,965782,626,63.70772495159475,79.86827324691427
8787,C5_04380C_A,6,C5,966890,968029,1139,0.6252514081854119,0.7838570652917398
8789,C5_04390C_A,31,C5,970181,970636,455,8.086813909017842,10.138171838236644
8791,C5_04400W_A,120,C5,971596,972795,1199,11.879255278118167,14.892630481522797
8793,C5_04410C_A,590,C5,973063,974205,1142,61.32154098287779,76.87679311831613
8795,C5_04420W_A,677,C5,974657,975694,1037,77.48846618547022,97.14473394690718
8797,C5_04430C_A,718,C5,975716,976726,1010,84.37819341862148,105.78215770787384
8799,C5_04440C_A,875,C5,977029,977940,911,114.00314392293927,142.92198091774245
8801,C5_04460C_A,4,C5,979414,979596,182,2.6086496480702714,3.270378012334402
8803,C5_04470C_A,3821,C5,979898,980725,827,548.4015585127945,687.5129438009718
8805,C5_04480C_A,43,C5,981163,981432,269,18.97331983810218,23.7862252086701
8807,C5_04490C_A,2274,C5,981844,982797,953,283.22051745738383,355.0642201492168
8809,C5_04500W_A,4,C5,983105,983407,302,1.5721001190357264,1.9708900604134476
8811,C5_04510W_A,954,C5,984134,987622,3488,32.463777314732305,40.69876673778652
8813,C5_04520W_A,297,C5,987850,989031,1181,29.849269279591546,37.421044258832296
8815,C5_04530W_A,679,C5,989261,990049,788,102.27528750292767,128.21915419043805
8817,C5_04540C_A,112,C5,990125,991027,902,14.738002889762864,18.47654806081609
8819,C5_04550W_A,455,C5,991257,992165,908,59.47749927221894,74.56497885501426
8821,C5_04560C_A,447,C5,992382,992483,101,525.3071372997745,658.5602297412202
8823,C5_04570C_A,3116,C5,993708,995429,1721,214.90361987455373,269.41757921716845
8825,C5_04580C_A,186,C5,996127,996717,590,37.41864740952324,46.91052392946787
8827,C5_04590C_A,4580,C5,997099,997750,651,835.048387344645,1046.8726174967221
8829,C5_04600C_A,2428,C5,998235,1000577,2342,123.05207567075796,154.2663281531301
8831,C5_04610W_A,218,C5,1002086,1003516,1430,18.094542558887433,22.684531121919534
8833,C5_04620C_A,360,C5,1003656,1004540,884,48.33674347894915,60.598180816784506
8835,C5_04630W_A,100,C5,1004884,1005222,338,35.116437570176736,44.024319396809254
8837,C5_04640C_A,2356,C5,1005350,1009294,3944,70.90315034833594,88.88894071151704
8839,C5_04650C_A,620,C5,1010220,1011953,1733,42.46393916449069,53.23563977377581
8841,C5_04660C_A,472,C5,1012145,1012900,755,74.2031256184863,93.02601085151473
8843,C5_04670W_A,1348,C5,1013409,1015016,1607,99.56373211869447,124.81976665122477
8845,C5_04680W_A,1582,C5,1015777,1018989,3212,58.45990358584876,73.28925271041176
8847,C5_04690C_A,23,C5,1019083,1019319,236,11.567592613159064,14.501909279270983
8849,C5_04700C_A,3372,C5,1020159,1022405,2246,178.19887840820547,223.40205561906407
8851,C5_04710W_A,352,C5,1022682,1024034,1352,30.902465061755525,38.74140106919215
8853,C5_04720C_A,628,C5,1024374,1025190,816,91.34749392642148,114.51933985838629
8855,C5_04730C_A,4487,C5,1025651,1029475,3824,139.27248932415128,174.60132568806824
8857,C5_04740C_A,556,C5,1031038,1032462,1424,46.343833424776506,58.09973522193518
8859,C5_04750C_A,2286,C5,1032682,1034379,1697,159.89008594268304,200.44892645665183
8861,C5_04760W_A,2,C5,1035099,1035171,72,3.297043305199926,4.13339443225598
8863,C5_04770W_A,398,C5,1035440,1036315,875,53.98861311646234,67.68374334327278
8865,C5_04780W_A,591,C5,1036647,1038047,1400,50.10563811530973,62.815785671913034
8867,C5_04790C_A,158,C5,1038042,1038692,650,28.851665107657205,36.170380816418486
8869,C5_04800W_A,293,C5,1039131,1040645,1514,22.970417954589713,28.797255265149325
8871,C5_04810W_A,6624,C5,1041193,1044156,2963,265.34800362173314,332.65803911356403
8873,C5_04820W_A,2,C5,1051679,1051990,311,0.7633026301427482,0.9569273283679439
8875,C5_04830W_A,516,C5,1053827,1055971,2144,28.566173711471006,35.812469670516364
8877,C5_04840C_A,195,C5,1058090,1058830,740,31.277356760139845,39.21139042491483
8879,C5_04850W_A,41,C5,1059037,1059795,758,6.420100156299593,8.048667786292649
8881,C5_04860C_A,29,C5,1059960,1060479,519,6.632202717974418,8.314573771243243
8883,C5_04870W_A,341,C5,1061084,1061869,785,51.559877216094655,64.63891726162346
8885,C5_04880C_A,1759,C5,1062043,1063830,1787,116.8337830209738,146.47065978073738
8887,C5_04890C_A,244,C5,1064216,1065337,1121,25.835172518176766,32.3887035619416
8889,C5_04900C_A,573,C5,1065586,1066695,1109,61.326789269309366,76.88337272189032
8891,C5_04910W_A,163,C5,1066921,1067634,713,27.134712643636984,34.01789414933813
8893,C5_04920C_A,1685,C5,1067875,1073664,5789,34.548047485477205,43.31174749708892
8895,C5_04930C_A,67,C5,1074184,1075950,1766,4.503096518766831,5.64538356206196
8897,C5_04940W_A,257,C5,1078889,1080637,1748,17.4509408808408,21.877668928622615
8899,C5_04950C_A,386,C5,1080794,1083001,2207,20.75927221071961,26.025214785060765
8901,C5_04960W_A,3190,C5,1088502,1091030,2528,149.77549571564856,187.76859833871708
8903,C5_04970C_A,131,C5,1091679,1094261,2582,6.022020227468185,7.549608110967933
8905,C5_04980W_A,116,C5,1095645,1097372,1727,7.972468351195653,9.994820584308613
8907,C5_04990W_A,49,C5,1097648,1098139,491,11.845182057785479,14.849914009164053
8909,C5_05000C_A,1064,C5,1098208,1100409,2201,57.378440146468876,71.93345767066472
8911,C5_05010W_A,39,C5,1100839,1101153,314,14.742193632167826,18.481801856329287
8913,C5_05020C_A,607,C5,1101230,1102420,1190,60.54368933212503,75.90162616273754
8915,C5_05030C_A,399,C5,1102463,1104616,2153,21.99662333297341,27.57644107056428
8917,C5_05040W_A,186,C5,1104724,1106172,1448,15.246548322941097,19.114094695017982
8919,C5_05050W_A,24234,C5,1107880,1108932,1052,2734.2392666309324,3427.8255743027485
8921,C5_05060C_A,41,C5,1109074,1109559,485,10.033888491701221,12.579155014453251
8923,C5_05070W_A,389,C5,1109829,1112132,2303,20.04854296396864,25.134196973214394
8925,C5_05080W_A,803,C5,1119031,1121088,2057,46.33491874901288,58.088559186998474
8927,C5_05090W_A,92,C5,1121545,1122810,1265,8.632258835432536,10.821978149906567
8929,C5_05100C_A,377,C5,1122899,1124587,1688,26.509165721666708,33.23366660816242
8931,C5_05110C_A,551,C5,1125159,1127513,2354,27.78256202291663,34.83008154555209
8933,C5_05120W_A,2920,C5,1127776,1129365,1589,218.1152877549505,273.44394129562534
8935,C5_05130C_A,214,C5,1129420,1130145,725,35.035064307945156,43.922304422207
8937,C5_05140W_A,321,C5,1130266,1131324,1058,36.0119399195561,45.14698115231579
8939,C5_05150C_A,249,C5,1131319,1132620,1301,22.716907138979355,28.479437118172644
8941,C5_05160C_A,553,C5,1132798,1133319,521,125.98375838756264,157.94168206785423
8943,C5_05170W_A,719,C5,1133822,1135915,2093,40.77432819483751,51.11743023627032
8945,C5_05180W_A,12,C5,1137147,1138370,1223,1.1646138248948228,1.4600379351877217
8947,C5_05190W_A,611,C5,1139258,1140172,914,79.34547542798423,99.47280517713625
8949,C5_05200C_A,1259,C5,1140239,1141543,1304,114.59753893012382,143.66715433095862
8951,C5_05210W_A,734,C5,1141882,1143330,1448,60.16648639268153,75.42873928033978
8953,C5_05220W_A,534,C5,1143525,1144814,1289,49.171730410522414,61.64497638920788
8955,C5_05230C_A,8560,C5,1144905,1146224,1319,770.2933016909851,965.691302686886
8957,C5_05240C_A,91,C5,1146493,1147437,944,11.441857910842119,14.344279830583254
8959,C5_05250C_A,1454,C5,1147626,1148381,755,228.58335730779464,286.5674147841153
8961,C5_05260W_A,124,C5,1148532,1149152,620,23.73871179743947,29.760439912243058
8963,C5_05270C_A,1022,C5,1149197,1150108,911,133.15567210199308,166.93287371192318
8965,C5_05280C_A,436,C5,1150249,1150743,494,104.75787797250618,131.33149596900785
8967,C5_05290C_A,973,C5,1150915,1151262,347,332.82084407649285,417.2465134670389
8969,C5_05300W_A,805,C5,1151677,1152390,713,134.0088569210293,168.00248337556565
8971,C5_05310W_A,1383,C5,1152535,1153125,590,278.2257492869389,348.80244405620465
8973,C5_05320C_A,2262,C5,1153178,1154074,896,299.6482482466969,375.6591243386931
8975,C5_05330C_A,643,C5,1154306,1155292,986,77.40360895412566,97.03835123515357
8977,C5_05340W_A,1630,C5,1155735,1156982,1247,155.1487579383574,194.50487993967997
8979,C5_05350W_A,1026,C5,1157179,1158453,1274,95.58837639000352,119.83599430911059
8981,C5_05360C_A,2147,C5,1158484,1161177,2693,94.62869333290483,118.6328713174635
8983,C5_05370C_A,1023,C5,1161357,1164347,2990,40.60986984745916,50.9112542311449
8985,C5_05380W_A,1885,C5,1164505,1165881,1376,162.59982462999056,203.8460364628567
8987,C5_05390C_A,2175,C5,1165900,1167255,1355,190.5228714370142,238.8522391480762
8989,C5_05400W_A,1230,C5,1168093,1169409,1316,110.93698902298841,139.07804366283798
8991,C5_05410C_A,5024,C5,1169457,1171226,1769,337.0923913802597,422.6016114163627
8993,C5_05430W_A,1071,C5,1172085,1172609,524,242.5969497620007,304.13579337798006
8995,C5_05440C_A,8176,C5,1172634,1174892,2258,429.7779177499228,538.7983984112029
8997,C5_05450C_A,623,C5,1175166,1175846,680,108.74424595444697,136.32907400976046
8999,C5_05460C_A,68,C5,1175896,1176357,461,17.507943625009588,21.94913138863913
9001,C5_05470W_A,1273,C5,1176356,1178194,1838,82.2072364476073,103.06050056660885
9003,C5_05480W_A,2498,C5,1178288,1179400,1112,266.63355247303866,334.26968930208255
9005,C5_05490C_A,3471,C5,1179397,1180902,1505,273.7444141159881,343.1843419780586
9007,C5_05500C_A,827,C5,1182110,1182868,758,129.49811778682349,162.3475185186346
9009,C5_05510C_A,1,C5,1188747,1189058,311,0.3816513150713741,0.47846366418397196
9011,C6_00010W_A,1,C6,5,346,341,0.34807495304163444,0.43637008668978094
9013,C6_00020W_A,124,C6,3622,4008,386,38.129537083970135,47.80174286422459
9015,C6_00030W_A,83,C6,5545,6069,524,18.800697320491185,23.569814052635245
9017,C6_00060W_A,1,C6,6928,7038,110,1.0790323544290668,1.3527472687383209
9019,C6_00070C_A,1080,C6,7276,9894,2618,48.96449339426018,61.38517017804145
9021,C6_00080C_A,647,C6,10260,11345,1085,70.77855545135179,88.7327401991763
9023,C6_00090W_A,252,C6,11580,11948,368,81.27928495862427,101.89715839518003
9025,C6_00100C_A,1803,C6,11950,12543,593,360.8844634973303,452.4289474011318
9027,C6_00110C_A,273,C6,12648,13433,785,41.278142170069906,51.749045197722
9029,C6_00120W_A,75,C6,13533,13778,245,36.3347629552645,45.55169374322916
9031,C6_00130C_A,4643,C6,13792,16029,2237,246.35413248884993,308.84604942455184
9033,C6_00140C_A,84,C6,16129,16587,458,21.769124355730522,27.291233107297128
9035,C6_00150W_A,6454,C6,17283,18128,845,906.5659523116824,1136.5318295480276
9037,C6_00160W_A,700,C6,18356,18682,326,254.86347021790846,319.5139254381923
9039,C6_00170C_A,2359,C6,18679,20661,1982,141.2704872102919,177.10614973002367
9041,C6_00180C_A,47,C6,20920,21525,605,9.22082193784839,11.559840296491103
9043,C6_00190W_A,779,C6,21616,22845,1229,75.23375301141313,94.31807441675078
9045,C6_00200C_A,740,C6,22858,23190,332,264.55793268230735,331.6675532388533
9047,C6_00210W_A,987,C6,23379,24626,1247,93.94590434672315,117.7768812886283
9049,C6_00220C_A,2,C6,24672,24754,82,2.8949648533462766,3.629321940517446
9051,C6_00230W_A,227,C6,24834,25922,1088,24.764189237218567,31.046047151099142
9053,C6_00240C_A,361,C6,25917,26810,893,47.98250256929255,60.15408067368277
9055,C6_00250W_A,681,C6,26954,28600,1646,49.107116446100484,61.56397199343111
9057,C6_00260W_A,1010,C6,28770,29879,1109,108.09783099825908,135.51868490245937
9059,C6_00270W_A,254,C6,30052,30744,692,43.56671095772851,54.61814839385647
9061,C6_00280W_A,2749,C6,32516,35077,2561,127.40671364927978,159.7255941404845
9063,C6_00290W_A,1876,C6,39723,41777,2054,108.40755436221141,135.90697486701066
9065,C6_00300C_A,2321,C6,43796,46627,2831,97.31110929328332,121.99572772221146
9067,C6_00310W_A,1664,C6,47121,49541,2420,81.61408353499851,102.31688432638937
9069,C6_00320C_A,1315,C6,49594,53874,4280,36.46776403461788,45.7184328091117
9071,C6_00330C_A,5743,C6,54332,56071,1739,391.9822364942349,491.4151995860031
9073,C6_00340C_A,3100,C6,57603,59954,2351,156.507882969082,196.20877015728087
9075,C6_00350W_A,1331,C6,60860,63445,2585,61.1145559040463,76.61730275279595
9077,C6_00360C_A,347,C6,63637,64182,545,75.57186232762841,94.74195091328752
9079,C6_00370C_A,4306,C6,64428,65978,1550,329.7383645154012,413.3821105229632
9081,C6_00380C_A,195,C6,66443,67438,995,23.261551761310034,29.16224011501204
9083,C6_00390W_A,797,C6,67494,68984,1490,63.489105042145155,79.59419667804602
9085,C6_00400C_A,220,C6,69031,70365,1334,19.574649907933598,24.540092881159943
9087,C6_00410C_A,1649,C6,70595,73825,3230,60.59618537767444,75.96743872335728
9089,C6_00420W_A,155,C6,74105,74448,343,53.637031029199974,67.24297647810019
9091,C6_00430C_A,399,C6,74582,76120,1538,30.79241224700374,38.60343148564688
9093,C6_00440C_A,2094,C6,76654,78531,1877,132.41572323878066,166.00522423078576
9095,C6_00450C_A,3,C6,78916,79317,401,0.8879817380588331,1.1132334131761743
9097,C6_00460C_A,152,C6,80175,82049,1874,9.627225702270009,12.069335289917142
9099,C6_00470C_A,8,C6,83656,85536,1880,0.5050789744136057,0.6332008491966608
9101,C6_00480C_A,984,C6,87450,89309,1859,62.82649921646165,78.76350961174602
9103,C6_00490W_A,251,C6,92659,94050,1391,21.417745007754522,26.85072040968011
9105,C6_00500C_A,201,C6,94193,95188,995,23.97729181550419,30.059539810858567
9107,C6_00510C_A,823,C6,95673,97367,1694,57.66517062955338,72.29292221893753
9109,C6_00520W_A,45,C6,97678,97992,314,17.010223421732107,21.325155988072254
9111,C6_00530C_A,37,C6,98053,98313,260,16.891006471255007,21.175697629865255
9113,C6_00540W_A,455,C6,98512,100356,1844,29.287185108012363,36.716377874377955
9115,C6_00550W_A,2312,C6,100547,101452,905,303.2259761087296,380.1444037409168
9117,C6_00560W_A,332,C6,101799,103787,1988,19.822063170900165,24.850266727526897
9119,C6_00570C_A,1038,C6,103938,105929,1991,61.880418999854776,77.57744005250701
9121,C6_00580W_A,9,C6,107349,107708,359,2.9756045428545295,3.7304172591948124
9123,C6_00590W_A,713,C6,107872,109443,1571,53.86919640857524,67.53403455579026
9125,C6_00600C_A,1743,C6,109686,110591,905,228.5998600162265,286.5881036853019
9127,C6_00610C_A,19,C6,111167,111499,332,6.792703676978161,8.515788529105693
9129,C6_00620W_A,398,C6,112252,112774,522,90.49815417031523,113.45455062330208
9131,C6_00630W_A,37,C6,112915,113313,398,11.03432583549322,13.833370310967249
9133,C6_00640C_A,290,C6,113323,114414,1091,31.550075257825142,39.553288609305625
9135,C6_00650C_A,4899,C6,114676,115535,859,676.9263626056808,848.6402510481881
9137,C6_00660C_A,188,C6,115818,116422,604,36.944352797339576,46.31591641971602
9139,C6_00670W_A,507,C6,116838,118541,1703,35.3362503855015,44.299891472422864
9141,C6_00680C_A,208,C6,118692,119232,540,45.71900049877232,57.316402793949585
9143,C6_00690W_A,396,C6,119448,120974,1526,30.801211899692106,38.6144633199484
9145,C6_00700C_A,290,C6,121065,121958,893,38.54550067893307,48.323222701850426
9147,C6_00710W_A,388,C6,122466,124409,1943,23.702059128683775,29.714489670484575
9149,C6_00720C_A,2718,C6,124508,125947,1439,224.18977993551246,281.05933176329614
9151,C6_00730W_A,168,C6,126536,128452,1916,10.40736842894006,13.047374491797582
9153,C6_00740W_A,1347,C6,129790,131742,1952,81.90585243634982,102.68266537344108
9155,C6_00750C_A,6094,C6,131977,133230,1253,577.2693922330253,723.70359467362
9157,C6_00760W_A,272,C6,134254,135108,854,37.80403752285443,47.39367480169855
9159,C6_00770C_A,371,C6,135141,136989,1848,23.828631160308557,29.873168851304584
9161,C6_00780W_A,874,C6,137336,140659,3323,31.21822767222705,39.1372622378881
9163,C6_00790C_A,6002,C6,140815,141570,755,943.5744914452431,1182.9282142601512
9165,C6_00800C_A,3361,C6,142324,144471,2147,185.807662671621,232.9409374593594
9167,C6_00810C_A,14,C6,149369,150541,1172,1.4178411483112312,1.777500677352401
9169,C6_00820W_A,2501,C6,158273,159529,1256,236.34760432084443,296.3011951453817
9171,C6_00830C_A,124,C6,159840,161719,1879,7.832890534546286,9.819836479824746
9173,C6_00840W_A,88,C6,165020,165511,491,21.27298002214535,26.669233322580336
9175,C6_00850W_A,1646,C6,167136,167621,485,402.8239135936636,505.0070525314647
9177,C6_00860W_A,43,C6,169118,169807,689,7.40758060442596,9.286639450119386
9179,C6_00870C_A,8021,C6,170116,171318,1202,792.0474514445174,992.9637626293743
9181,C6_00880W_A,911,C6,172250,173392,1142,94.68461667017232,118.70298056065423
9183,C6_00890W_A,3639,C6,174611,176875,2264,190.77997400813214,239.17456016045162
9185,C6_00900C_A,204,C6,176941,177840,899,26.93379981466992,33.76601636316787
9187,C6_00910C_A,4050,C6,178343,181033,2690,178.70219847514846,224.03305138398585
9189,C6_00920W_A,3699,C6,182690,183145,455,964.9395048211935,1209.7128267624953
9191,C6_00930C_A,567,C6,183350,184084,734,91.68834869991949,114.94665824415405
9193,C6_00940C_A,177,C6,184756,185646,890,23.605348248015652,29.593246429590007
9195,C6_00950C_A,2716,C6,186531,188873,2342,137.64803851803075,172.56480529814718
9197,C6_00960W_A,1012,C6,191051,192766,1715,70.03958116329079,87.80631251075793
9199,C6_00970C_A,489,C6,192961,193944,983,59.044913880711604,74.02266081936345
9201,C6_00980C_A,79,C6,194243,195295,1052,8.913299581738205,11.174309662866927
9203,C6_00990W_A,113,C6,195918,196958,1040,12.896511697647407,16.1679312984782
9205,C6_01000C_A,344,C6,197030,198280,1250,32.66446743327671,40.950365319246444
9207,C6_01010W_A,21,C6,198680,199057,377,6.611577556316034,8.288716686433743
9209,C6_01020W_A,11,C6,199256,200110,854,1.5288397527624953,1.9166559662451617
9211,C6_01030W_A,334,C6,200518,201594,1076,36.843539685617024,46.18953034706868
9213,C6_01040C_A,776,C6,201650,204145,2495,36.91631333629866,46.28076427234592
9215,C6_01050W_A,802,C6,204367,205872,1505,63.25065402507128,79.29525850371738
9217,C6_01060C_A,886,C6,205994,207700,1706,61.642727586551494,77.27945416836856
9219,C6_01070C_A,165,C6,209410,210309,899,21.78469102657126,27.31074852903284
9221,C6_01080C_A,140,C6,211793,212791,998,16.650399056320268,20.87405605067148
9223,C6_01090C_A,51,C6,212992,213913,921,6.572607500919723,8.239861213487492
9225,C6_01100W_A,1187,C6,214553,216145,1592,88.49827545088145,110.94736864269004
9227,C6_01110W_A,937,C6,218197,219507,1310,84.89760669542284,106.43332899912882
9229,C6_01120C_A,22,C6,219755,220552,797,3.2763592192200024,4.107463475968301
9231,C6_01130W_A,29,C6,220839,221612,773,4.452927827462773,5.582488728687249
9233,C6_01140C_A,51,C6,221639,222187,548,11.046298372896104,13.848379886171497
9235,C6_01150W_A,477,C6,224375,226279,1904,29.735728800889255,37.278702306039754
9237,C6_01160W_A,125,C6,226945,227577,632,23.475783027531126,29.43081478663277
9239,C6_01170W_A,540,C6,228067,229164,1097,58.427093758511006,73.24812011217524
9241,C6_01180C_A,151,C6,229417,230640,1223,14.654723963259855,18.37214401777883
9243,C6_01190C_A,300,C6,232244,236857,4613,7.71906952008654,9.677142828607106
9245,C6_01200W_A,76,C6,237060,237734,674,13.383843446627594,16.778883036576204
9247,C6_01210W_A,446,C6,237854,238266,412,128.48865851526705,161.0819927288884
9249,C6_01220C_A,517,C6,238369,240150,1781,34.45512071666538,43.19524827240219
9251,C6_01250W_A,219,C6,242012,242335,323,80.47643782723289,100.89065543005
9253,C6_01260W_A,467,C6,244222,244632,410,135.19485865127112,169.48933462216473
9255,C6_01280W_A,398,C6,245451,247826,2375,19.890541674486126,24.936115968574182
9257,C6_01290C_A,247,C6,247958,250051,2093,14.007314414638198,17.560508022752114
9259,C6_01300W_A,156,C6,251632,252873,1241,14.92038291861627,18.705191886824807
9261,C6_01310W_A,14,C6,253187,253984,797,2.0849558667763652,2.6138403937980104
9263,C6_01320W_A,2048,C6,254510,265975,11465,21.20230342832797,26.580628408318265
9265,C6_01330C_A,38,C6,266126,266865,739,6.103322383644789,7.651533942254643
9267,C6_01340C_A,64,C6,267237,267944,707,10.744537164329039,13.470071813179318
9269,C6_01350W_A,519,C6,268142,270265,2123,29.01646590407698,36.3769861386108
9271,C6_01360W_A,7,C6,272338,272679,341,2.4365246712914415,3.0545906068284663
9273,C6_01370W_A,222,C6,274059,275504,1445,18.235273422254544,22.860960763037923
9275,C6_01380C_A,14,C6,275554,276168,614,2.7063677944963564,3.3928840290830844
9277,C6_01390W_A,373,C6,276517,277704,1187,37.29797599176463,46.75924215360851
9279,C6_01400W_A,42,C6,278810,280840,2030,2.4557288066316696,3.0786661978182472
9281,C6_01410C_A,274,C6,281102,282313,1211,26.85552036539395,33.66787999981254
9283,C6_01420C_A,1133,C6,282711,283952,1241,108.36406312046303,135.85245133187505
9285,C6_01430C_A,710,C6,284857,285648,791,106.53909845879915,133.5645533356041
9287,C6_01440C_A,35,C6,287462,288292,830,5.005150077773382,6.2747915477620895
9289,C6_01450C_A,110,C6,289441,290394,953,13.700200932415225,17.175489980832825
9291,C6_01460C_A,546,C6,292746,293900,1154,56.15830433882994,70.40381365721278
9293,C6_01470W_A,120,C6,294635,296263,1628,8.748910981857298,10.968221097878276
9295,C6_01480W_A,48,C6,296921,297466,545,10.453744644743988,13.105514823740062
9297,C6_01490C_A,86,C6,297609,298052,443,23.042090458011227,28.887108718430056
9299,C6_01500C_A,172,C6,298211,301176,2965,6.885427367891381,8.632033161729858
9301,C6_01510W_A,99,C6,304773,305993,1220,9.63169044240372,12.07493258734452
9303,C6_01520W_A,322,C6,306695,308335,1640,23.30446706943753,29.216041621165438
9305,C6_01530C_A,13,C6,310350,310466,116,13.301864369254876,16.676108571515506
9307,C6_01540C_A,6,C6,310465,310526,61,11.67477629382269,14.636281924053963
9309,C6_01550C_A,900,C6,314026,317713,3687,28.97320398385615,36.32275009630967
9311,C6_01560W_A,333,C6,319706,320740,1034,38.22529510902971,47.92179154147455
9313,C6_01570C_A,373,C6,321477,324401,2924,15.141141416629486,18.98194953362972
9315,C6_01590W_A,1697,C6,328457,329938,1481,136.00470601031324,170.50461354178415
9317,C6_01600W_A,56,C6,330122,330472,350,18.990969437951577,23.808351929794444
9319,C6_01610W_A,5990,C6,331191,332384,1193,595.9550866163555,747.1292333375353
9321,C6_01620W_A,233,C6,334854,336653,1799,15.372762225690375,19.272324901480356
9323,C6_01630W_A,3008,C6,337224,338591,1367,261.1779264326918,327.43015089987966
9325,C6_01640W_A,163,C6,339591,340175,584,33.12851047074173,41.53212076794194
9327,C6_01650C_A,884,C6,340292,347998,7706,13.616027270267644,17.069964237232586
9329,C6_01660C_A,2,C6,348429,348812,383,0.619809707504947,0.7770349846538657
9331,C6_01670W_A,308,C6,350639,352531,1892,19.32220727698562,24.223613882058302
9333,C6_01680C_A,122,C6,352702,353787,1085,13.346188199482098,16.731675895362457
9335,C6_01690W_A,1138,C6,354147,356351,2204,61.2855127619921,76.83162572625362
9337,C6_01700W_A,5844,C6,356945,357782,837,828.7277881973492,1038.9486908431807
9339,C6_01710C_A,2656,C6,358106,360544,2438,129.306846870384,162.10772848014267
9341,C6_01720C_A,1692,C6,364197,365009,812,247.32697266790387,310.0656670659807
9343,C6_01730W_A,12,C6,365969,366277,308,4.624424376124573,5.797488294592804
9345,C6_01740C_A,1583,C6,366437,368230,1793,104.79191515712962,131.37416726458662
9347,C6_01750C_A,165,C6,368561,369448,887,22.079410634597025,27.680228779707463
9349,C6_01760W_A,2429,C6,369850,372375,2525,114.18085337817915,143.14476939967997
9351,C6_01770W_A,257,C6,372715,373851,1136,26.85232804551912,33.66387789369043
9353,C6_01780C_A,190,C6,374139,375542,1403,16.073967361060227,20.151402649059804
9355,C6_01790C_A,336,C6,376564,378156,1592,25.050901896795423,31.40548935462835
9357,C6_01800W_A,1,C6,378683,378755,72,1.648521652599963,2.06669721612799
9359,C6_01810W_A,22,C6,378946,380427,1481,1.7631723819840257,2.2104310535764595
9361,C6_01820C_A,590,C6,380495,381680,1185,59.09637114130501,74.08717108955022
9363,C6_01830W_A,585,C6,381840,382496,656,105.84715245047325,132.69708345016912
9365,C6_01840C_A,761,C6,382542,383525,983,91.88789256282523,115.19681980273126
9367,C6_01850W_A,1584,C6,383676,385970,2294,81.95754029455999,102.74746473625328
9369,C6_01860C_A,540,C6,386043,386584,541,118.4741623901785,148.52714928476203
9371,C6_01870C_A,229,C6,386807,388339,1532,17.742052877329108,22.242626435716907
9373,C6_01880W_A,120,C6,389289,389918,629,22.64424018833654,28.388336959214364
9375,C6_01890C_A,886,C6,390049,391773,1724,60.999126022422764,76.47259211788675
9377,C6_01900C_A,485,C6,392015,392737,722,79.73182286536111,99.95715621494378
9379,C6_01910W_A,4109,C6,393707,394456,749,651.1506460325686,816.3260854433025
9381,C6_01920C_A,660,C6,394669,396216,1547,50.63849316842291,63.48380847472663
9383,C6_01930W_A,2182,C6,397028,397942,914,283.35814629109916,355.2367608780873
9385,C6_01940W_A,90,C6,398675,398908,233,45.84729746286593,57.477244465705475
9387,C6_01950C_A,920,C6,399034,400629,1595,68.46274248791322,85.82948187856933
9389,C6_01960W_A,446,C6,400918,402603,1685,31.416811458925828,39.38622018059467
9391,C6_01970C_A,7116,C6,402753,403626,873,967.4952643217598,1212.9168981415899
9393,C6_01980C_A,2078,C6,403985,404632,647,381.2136253097312,477.91494696786
9395,C6_01990W_A,45,C6,405913,407730,1817,2.939576309534332,3.6852498515435816
9397,C6_02000W_A,268,C6,409352,411181,1829,17.39194850113116,21.80371212816058
9399,C6_02010C_A,18513,C6,411489,412604,1115,1970.7388856771165,2470.6503322661692
9401,C6_02020C_A,2226,C6,414633,415973,1340,197.17303157126963,247.1893255397502
9403,C6_02030C_A,1121,C6,416245,417378,1133,117.4364339140761,147.226183325792
9405,C6_02040W_A,3638,C6,417949,418854,905,477.1349918181481,598.1684000040897
9407,C6_02050W_A,508,C6,419022,420419,1397,43.16129417716268,54.10989074953283
9409,C6_02060W_A,2383,C6,422258,424654,2396,118.04956221472926,147.99484205107512
9411,C6_02070C_A,2673,C6,424970,425898,928,341.88349479825274,428.60805972750916
9413,C6_02080W_A,1,C6,425509,425817,308,0.385368698010381,0.48312402454940023
9415,C6_02090C_A,1323,C6,426472,429609,3137,50.05788286262738,62.7559164869263
9417,C6_02100W_A,145,C6,434385,434888,503,34.21583708378452,42.895266275101825
9419,C6_02110W_A,93,C6,436350,437441,1091,10.11778275509565,12.68433048505318
9421,C6_02120W_A,5262,C6,437978,442957,4979,125.43994926503967,157.25992650956314
9423,C6_02130C_A,30,C6,443134,444234,1100,3.2370970632872003,4.058241806214962
9425,C6_02140W_A,528,C6,444603,447512,2909,21.54355419224483,27.008443234211644
9427,C6_02150C_A,75,C6,447639,449000,1361,6.540791274092434,8.199974259435082
9429,C6_02160W_A,120,C6,449471,451141,1670,8.528878490098013,10.69237362116517
9431,C6_02170C_A,104,C6,451184,452335,1151,10.724700377644243,13.445203088068105
9433,C6_02180W_A,165,C6,453038,453583,545,35.93474721630745,45.050207206606466
9435,C6_02190C_A,403,C6,454198,455418,1220,39.20779038675453,49.15351346161456
9437,C6_02200C_A,259,C6,458121,458522,401,76.66242338574592,96.10915133754304
9439,C6_02210W_A,684,C6,460066,460428,362,224.27180758906906,281.16216712671616
9441,C6_02220W_A,637,C6,461384,462114,730,103.57232476006125,129.84520701437552
9443,C6_02230W_A,1065,C6,463058,465112,2054,61.54266812140467,77.15401291757267
9445,C6_02240C_A,6710,C6,465254,465907,653,1219.6535693783985,1529.0394472523042
9447,C6_02250W_A,66,C6,466317,467456,1139,6.877765490039531,8.622427718209138
9449,C6_02260C_A,1844,C6,467667,470486,2819,77.64133478978074,97.33638027345901
9451,C6_02270C_A,176,C6,470964,472793,1829,11.421578120145837,14.3188557259562
9453,C6_02280W_A,444,C6,474133,475320,1187,44.397590724781494,55.65979494960369
9455,C6_02290C_A,855,C6,475632,478013,2381,42.62200459221072,53.43380118640868
9457,C6_02300C_A,100,C6,478575,478916,341,34.807495304163446,43.63700866897808
9459,C6_02310W_A,493,C6,479401,481050,1649,35.485703202357975,44.48725553892004
9461,C6_02320C_A,439,C6,481253,482839,1586,32.85401790377026,41.187998491408266
9463,C6_02330W_A,220,C6,486452,487012,560,46.6296124592561,58.45800697047743
9465,C6_02340W_A,1704,C6,489805,491106,1301,155.4602801800033,194.89542509785616
9467,C6_02350C_A,615,C6,491416,493362,1946,37.51106823079464,47.026388864412844
9469,C6_02360W_A,115,C6,493517,494062,545,25.045429878032472,31.398629265210566
9471,C6_02370C_A,264,C6,494226,495677,1451,21.595520036264716,27.073591098663567
9473,C6_02380W_A,1414,C6,496005,497672,1667,100.67947954882847,126.2185423992552
9475,C6_02390W_A,2,C6,497760,497843,83,2.860085758727647,3.5855951701497664
9477,C6_02400W_A,4,C6,498068,498158,90,5.275269288319882,6.613431091609567
9479,C6_02410W_A,762,C6,499151,500542,1391,65.02120197573285,81.51493606444718
9481,C6_02420W_A,444,C6,501489,502706,1217,43.303155456298796,54.28773755561182
9483,C6_02430W_A,1967,C6,503335,507153,3818,61.149877037144364,76.6615836922238
9485,C6_02440C_A,199,C6,507225,508085,860,27.465137486572413,34.43213687521144
9487,C6_02450W_A,481,C6,508862,509665,803,71.0978852712851,89.13307346070307
9489,C6_02460C_A,893,C6,509769,510749,980,108.15647773017065,135.59220837567884
9491,C6_02470W_A,542,C6,511041,512948,1907,33.734614038311996,42.29197281708374
9493,C6_02480W_A,916,C6,514254,515363,1109,98.03724078653993,122.9060548224285
9495,C6_02490C_A,1033,C6,515648,516388,740,165.68979247807414,207.7198272253181
9497,C6_02500C_A,1296,C6,517713,518897,1184,129.9213280805809,162.8780833034924
9499,C6_02510C_A,5,C6,519240,519686,446,1.330645280125531,1.6681860937355975
9501,C6_02520W_A,2468,C6,520747,521556,809,362.0960489250965,453.94787208538855
9503,C6_02530C_A,87,C6,521838,522290,452,22.845884141341084,28.641131331472852
9505,C6_02540C_A,55,C6,522595,523275,680,9.600214329846844,12.035472023333588
9507,C6_02550W_A,15,C6,523443,524150,707,2.5182508978896183,3.1570480812139032
9509,C6_02560W_A,2008,C6,524474,525520,1046,227.85532165037506,285.65470049609974
9511,C6_02570C_A,297,C6,525572,526570,998,35.322632283765145,44.28281890749594
9513,C6_02580W_A,596,C6,526774,528267,1493,47.38202354746793,59.401279932005565
9515,C6_02590C_A,396,C6,528273,529094,821,57.250486429878386,71.77304631698081
9517,C6_02600W_A,2605,C6,529546,532056,2510,123.18594468591597,154.43415532150033
9519,C6_02610C_A,799,C6,532206,533732,1526,62.14688966629796,77.91150553696659
9521,C6_02620C_A,14,C6,534068,534433,365,4.552629659782912,5.707481627005517
9523,C6_02630C_A,778,C6,534981,537278,2297,40.20182363606423,50.39970015612777
9525,C6_02640C_A,385,C6,537774,538826,1052,43.43823213885074,54.45707873675654
9527,C6_02650C_A,1028,C6,539180,540637,1457,83.7453525318043,104.98878596357538
9529,C6_02660C_A,178,C6,541584,543302,1718,12.297702851991344,15.417224401569454
9531,C6_02670C_A,1351,C6,547501,548802,1301,123.25518692675145,154.52096203474392
9533,C6_02680W_A,164,C6,552562,553404,842,23.118460420309226,28.982851220949296
9535,C6_02690C_A,2410,C6,553947,555881,1934,147.90665830359134,185.42569852250716
9537,C6_02710C_A,143,C6,558152,559408,1256,13.513677496153841,16.94165170163518
9539,C6_02720C_A,192,C6,561383,563818,2435,9.358999312337533,11.733068712835045
9541,C6_02730W_A,6105,C6,564311,566254,1943,372.9409045892125,467.54370989254727
9543,C6_02740W_A,861,C6,566592,566915,323,316.3936665262444,396.652302855128
9545,C6_02750C_A,209,C6,567103,568881,1778,13.952167507493952,17.491372164394825
9547,C6_02760W_A,21,C6,569269,569946,677,3.6817795254522077,4.615725540303576
9549,C6_02770W_A,340,C6,570239,570931,692,58.31764458908541,73.110907298863
9551,C6_02780C_A,587,C6,571363,572925,1562,44.60506986266635,55.91990470066157
9553,C6_02790C_A,407,C6,573291,575498,2207,21.88866266777949,27.441094345906038
9555,C6_02800W_A,231,C6,576265,576792,527,52.026967981105486,65.22449354580785
9557,C6_02810C_A,1034,C6,577043,580438,3395,36.14996759727896,45.32002189876189
9559,C6_02820W_A,1,C6,582651,582959,308,0.385368698010381,0.48312402454940023
9561,C6_02830W_A,1287,C6,583525,586143,2618,58.34935462816005,73.15066112883272
9563,C6_02840C_A,784,C6,586391,587995,1604,58.01480688651043,72.73124966084339
9565,C6_02850W_A,163,C6,588696,589763,1067,18.132193172364733,22.73173245405632
9567,C6_02860W_A,830,C6,590320,593553,3233,30.471900389537215,38.201616342656564
9569,C6_02870W_A,548,C6,594266,594967,701,92.7875468259403,116.32468667552921
9571,C6_02880W_A,596,C6,596395,597093,698,101.34865495181894,127.05746552791449
9573,C6_02890C_A,267,C6,597534,598598,1064,29.78494384359182,37.34040158162075
9575,C6_02900C_A,267,C6,599811,601172,1361,23.285216935769064,29.191908363588894
9577,C6_02910W_A,207,C6,601321,602160,839,29.284346496245355,36.712819200442866
9579,C6_02920C_A,528,C6,602192,603142,950,65.96863067920022,82.70269617718071
9581,C6_02930W_A,2215,C6,603414,606363,2949,89.15097767264908,111.7656398874506
9583,C6_02940C_A,465,C6,606561,607859,1298,42.52119023809458,53.30741355621349
9585,C6_02950C_A,61,C6,608693,609775,1082,6.691596209074897,8.389033431824522
9587,C6_02960W_A,127,C6,610396,611592,1196,12.603747484426476,15.800902461767844
9589,C6_02970C_A,320,C6,611719,613338,1619,23.46012283872956,29.411182124514447
9591,C6_02980C_A,1154,C6,614384,616048,1664,82.31512444184241,103.19575618608319
9593,C6_02990W_A,412,C6,617910,619601,1691,28.918832822427742,36.25458676476682
9595,C6_03000C_A,71,C6,620109,620915,806,10.455636089442944,13.10788606556611
9597,C6_03010W_A,824,C6,621127,629748,8621,11.344796729550009,14.222597429351744
9599,C6_03020W_A,75,C6,630448,632880,2432,3.6603688010032083,4.58888362133682
9601,C6_03030W_A,204,C6,635173,636429,1256,19.278253211296384,24.16851011981522
9603,C6_03040C_A,530,C6,637254,640202,2948,21.339072680873336,26.752091508630972
9605,C6_03050C_A,117,C6,640436,641836,1400,9.919390286787209,12.435612391901563
9607,C6_03060W_A,46,C6,643530,645755,2225,2.4538893093982375,3.0763600808161367
9609,C6_03070C_A,168,C6,646161,646484,323,61.73534956609646,77.39557128880548
9611,C6_03080C_A,2199,C6,646612,647655,1043,250.24653519927804,313.7258263040387
9613,C6_03090W_A,48,C6,648469,650490,2021,2.819045438587567,3.5341442745860134
9615,C6_03100W_A,1235,C6,652168,653727,1559,94.0260072797875,117.87730369345792
9617,C6_03110C_A,70,C6,653804,654937,1133,7.33322959320725,9.19342803996917
9619,C6_03120W_A,568,C6,655158,658325,3167,21.287635460918253,26.68760636273138
9621,C6_03130W_A,614,C6,658611,658802,191,381.55939904784907,478.3484320973099
9623,C6_03140C_A,1272,C6,659079,661430,2351,64.21871843118463,80.5088889161488
9625,C6_03150C_A,792,C6,661783,663006,1223,76.8645124430583,96.36250372238962
9627,C6_03160C_A,2579,C6,663217,665157,1940,157.78901475669176,197.8148828187496
9629,C6_03170C_A,1224,C6,666383,668077,1694,85.76205206631025,107.51705564517562
9631,C6_03180C_A,3295,C6,669284,672274,2990,130.8010959407409,163.9810192488978
9633,C6_03190C_A,8,C6,672825,673145,320,2.967338974679934,3.7200549890303822
9635,C6_03200W_A,861,C6,674165,675106,941,108.60271443993297,136.15164061871027
9637,C6_03210C_A,46,C6,675261,676253,992,5.503935194970845,6.90010199578216
9639,C6_03220W_A,162,C6,676467,677552,1085,17.721987609148364,22.217471270891128
9641,C6_03230W_A,100,C6,677961,678998,1037,11.445859111590874,14.349296003974475
9643,C6_03240W_A,53,C6,679400,680431,1031,6.1016087549189715,7.6493856224485075
9645,C6_03250W_A,1291,C6,682709,685078,2369,64.6827288528796,81.09060347552932
9647,C6_03260W_A,3421,C6,685751,686608,857,473.8047436350084,593.9933777116889
9649,C6_03270C_A,149,C6,686774,687667,893,19.804412417796645,24.82813856060591
9651,C6_03280W_A,18,C6,688257,689066,809,2.6408950083678024,3.3108029568626396
9653,C6_03290W_A,933,C6,689317,690756,1439,76.9569774392322,96.47842403795265
9655,C6_03300C_A,275,C6,690878,692836,1958,16.670443677977154,20.89918533163136
9657,C6_03310W_A,518,C6,693653,695770,2117,29.042637484822027,36.40979658606968
9659,C6_03320W_A,756,C6,696248,697177,929,96.59023745352121,121.09199447608046
9661,C6_03330C_A,168,C6,697118,699883,2765,7.211760546057562,9.041146302453587
9663,C6_03340C_A,1052,C6,700203,702257,2054,60.791443064523676,76.21222684440043
9665,C6_03350C_A,452,C6,703285,704691,1406,38.1575310542057,47.83683798127263
9667,C6_03360C_A,67,C6,704980,705516,536,14.83669487339967,18.60027494515191
9669,C6_03370W_A,2681,C6,710076,711305,1229,258.92386626906114,324.6043100273541
9671,C6_03380W_A,1831,C6,712164,713270,1106,196.49901130701477,246.34432856834104
9673,C6_03390W_A,289,C6,714482,715531,1049,32.70013207559584,40.9950769048534
9675,C6_03400C_A,221,C6,715854,716237,383,68.48897267929665,85.86236580425216
9677,C6_03410C_A,475,C6,716494,717594,1100,51.254036835380674,64.25549526507024
9679,C6_03420W_A,41,C6,717849,720047,2198,2.214029080288941,2.775655223844325
9681,C6_03430C_A,937,C6,720171,724973,4802,23.16032169325363,29.035331317963085
9683,C6_03440W_A,917,C6,725374,727680,2306,47.19947683922809,59.17242714554832
9685,C6_03450C_A,2148,C6,727787,730372,2585,98.62814882185684,123.64685673403885
9687,C6_03460W_A,1771,C6,730859,734344,3485,60.31744417972067,75.61799007831056
9689,C6_03470W_A,1759,C6,737336,739201,1865,111.9474371359143,140.34480913039016
9691,C6_03480W_A,618,C6,739894,741762,1868,39.26799756642825,49.228993216718976
9693,C6_03490C_A,178,C6,741928,743103,1175,17.980811489124367,22.541950231401124
9695,C6_03500C_A,273,C6,744962,746215,1253,25.86060782402624,32.420590965851375
9697,C6_03510C_A,13,C6,746965,747312,347,4.446732757445434,5.574722173763109
9699,C6_03520C_A,30,C6,748178,750613,2435,1.4623436425527394,1.8332919863804757
9701,C6_03530C_A,284,C6,751488,751889,401,84.06227120290288,105.3860964473445
9703,C6_03540W_A,1076,C6,752357,753754,1397,91.42037900517133,114.61071347735695
9705,C6_03550C_A,908,C6,753856,755475,1619,66.56809855489512,83.45422927830974
9707,C6_03560W_A,1143,C6,756804,758795,1991,68.13999895648747,85.42486895955253
9709,C6_03570W_A,7,C6,759011,759733,722,1.1507685774382015,1.4426806051641372
9711,C6_03580W_A,240,C6,759950,762031,2081,13.688829484347604,17.16123397150008
9713,C6_03590C_A,334,C6,762043,762732,689,57.53795167158769,72.13343200790408
9715,C6_03600C_A,102,C6,763188,764768,1580,7.6624955801861585,9.606217946356937
9717,C6_03610W_A,182,C6,767669,769633,1964,10.999097625086517,13.789205865652333
9719,C6_03620C_A,774,C6,769693,771234,1541,59.61636252828731,74.73906713846894
9721,C6_03630W_A,252,C6,771818,772507,689,43.411867728263765,54.424026544885706
9723,C6_03640W_A,2121,C6,772812,775011,2199,114.48341910497754,143.52408607064012
9725,C6_03650C_A,513,C6,775110,776588,1478,41.19742608960233,51.647854110218844
9727,C6_03660C_A,1137,C6,776892,778082,1190,113.4072072003726,142.17487470680823
9729,C6_03670C_A,42,C6,780255,780551,296,16.8416536400753,21.113825613415685
9731,C6_03690W_A,563,C6,782435,786478,4043,16.528437721937205,20.72115714889048
9733,C6_03700W_A,18042,C6,791291,795073,3782,566.2266502504006,709.8596733166172
9735,C6_03710W_A,695,C6,797842,803514,5672,14.543727696774006,18.232991659916188
9737,C6_03720W_A,4333,C6,804198,807107,2909,176.79587180870615,221.64315252621034
9739,C6_03730C_A,902,C6,807280,808662,1382,77.46858915083358,97.11981476426642
9741,C6_03740W_A,43,C6,808828,809445,617,8.2719984383298,10.370331573958278
9743,C6_03750C_A,807,C6,809483,810148,665,144.03864977844853,180.57650382842215
9745,C6_03760C_A,7955,C6,810622,812034,1412,668.7020267302797,838.32967245713
9747,C6_03770C_A,1666,C6,813339,814145,806,245.33929190157667,307.5737772568048
9749,C6_03780C_A,673,C6,815053,816966,1913,41.7568035537814,52.349127184891735
9751,C6_03790C_A,4019,C6,817349,818989,1640,290.8715936399672,364.6561219734904
9753,C6_03800C_A,983,C6,822645,824495,1850,63.067982964548655,79.06624982090521
9755,C6_03810W_A,452,C6,826674,828011,1337,40.126767884976225,50.30560523685064
9757,C6_03820C_A,235,C6,828137,829087,950,29.361038275780402,36.808965154616416
9759,C6_03830W_A,1619,C6,830112,831827,1715,112.04948804680612,140.47274699102482
9761,C6_03840C_A,8120,C6,832295,836782,4487,214.7964562014804,269.28323165524137
9763,C6_03850C_A,327,C6,838281,839459,1178,32.94804226554629,41.30587373218795
9765,C6_03860C_A,159,C6,841828,842499,671,28.1255974351183,35.26013372613
9767,C6_03870C_A,1,C6,843109,843181,72,1.648521652599963,2.06669721612799
9769,C6_03880W_A,161,C6,843973,844755,782,24.43690920324651,30.6357469684855
9771,C6_03890C_A,422,C6,844807,845961,1154,43.40440371975501,54.41466916363332
9773,C6_03900W_A,1270,C6,846169,848565,2396,62.913530848806616,78.87261829830693
9775,C6_03910C_A,103,C6,848580,849431,851,14.365965423832348,18.010136962168243
9777,C6_03920W_A,779,C6,849768,850778,1010,91.54681430794727,114.76922124572941
9779,C6_03930W_A,1009,C6,851234,853390,2156,55.54814518463921,69.63887725290641
9781,C6_03940C_A,1930,C6,853685,855274,1589,144.16524156405973,180.7352077741633
9783,C6_03950C_A,455,C6,855600,856616,1016,53.15508793225866,66.63878031530803
9785,C6_03960W_A,3530,C6,857389,859491,2102,199.32838402702504,249.89141981498096
9787,C6_03990C_A,207,C6,863059,864597,1538,15.975010864986901,20.02734415420778
9789,C6_04030W_A,265,C6,876301,877632,1331,23.631700324272952,29.6262831583186
9791,C6_04040C_A,2598,C6,877853,879175,1322,233.25708490827438,292.42671290471804
9793,C6_04050W_A,201,C6,879657,880859,1202,19.84809097872435,24.88289693161753
9795,C6_04060W_A,241,C6,881371,884007,2636,10.851725233654992,13.60444995988349
9797,C6_04070C_A,38,C6,884108,885451,1343,3.3584179013503346,4.2103377388877
9799,C6_04080W_A,2563,C6,886488,887828,1340,227.02357588372152,284.61196826521996
9801,C6_04100W_A,2955,C6,890053,891459,1406,249.4590802326943,312.7386199881872
9803,C6_04110W_A,367,C6,892609,894141,1532,28.433770331789443,35.64647992099609
9805,C6_04120C_A,340,C6,894295,897546,3251,12.413352831635528,15.562210966106798
9807,C6_04130C_A,2052,C6,898452,904754,6302,38.64791860389225,48.45162067591459
9809,C6_04140C_A,1844,C6,907998,910160,2162,101.23539443681403,126.91547455637418
9811,C6_04150W_A,3,C6,911713,911964,251,1.418648115384829,1.7785123453531706
9813,C6_04160C_A,1657,C6,913551,916088,2537,77.52275413550888,97.18771961881504
9815,C6_04170C_A,248,C6,916379,919258,2879,10.224384379584906,12.817973425210628
9817,C6_04180W_A,724,C6,920228,923212,2984,28.798303185901773,36.10348273536189
9819,C6_04190C_A,62,C6,923628,924761,1133,6.495146211126421,8.142750549686978
9821,C6_04210C_A,401,C6,928032,930284,2252,21.135043141148373,26.496306404994375
9823,C6_04220C_A,298,C6,930975,932251,1276,27.71996910516051,34.75161086931203
9825,C6_04230W_A,111,C6,933892,935499,1607,8.198497229358374,10.27818553285308
9827,C6_04240W_A,42,C6,935982,936497,515,9.679863063033572,12.135325012759305
9829,C6_04250W_A,1796,C6,936924,937175,251,849.2973384103843,1064.7360574180984
9831,C6_04260C_A,164,C6,937516,938199,683,28.5003567699859,35.72995714207805
9833,C6_04270W_A,2671,C6,939854,945904,6050,52.40173488509159,65.69432645091008
9835,C6_04280W_A,634,C6,946421,947119,698,107.81048194539129,135.158444873654
9837,C6_04290W_A,1485,C6,948163,950031,1868,94.35756696787371,118.29296913726161
9839,C6_04300W_A,210,C6,950494,952914,2420,10.299854292277457,12.912587565229424
9841,C6_04310W_A,160,C6,953455,954192,737,25.767936822186673,32.30441238778079
9843,C6_04320C_A,46,C6,954379,954726,347,15.73459283403769,19.72593999946946
9845,C6_04330W_A,498,C6,954954,957020,2066,28.61054810049578,35.86810037826003
9847,C6_04340W_A,144,C6,957364,958923,1559,10.963356314404374,13.744398163447723
9849,C6_04350C_A,1982,C6,959560,961938,2378,98.92793688504001,124.02269113975133
9851,C6_04360C_A,574,C6,964395,965546,1151,59.19209631507496,74.20717858222204
9853,C6_04370W_A,165,C6,965838,968477,2639,7.42115848157922,9.303661586813385
9855,C6_04380W_A,2018,C6,971215,978303,7088,33.792833244379835,42.36496031525571
9857,C6_04400W_A,87,C6,983785,984099,314,32.88643194868207,41.22863491027302
9859,C6_04410C_A,421,C6,984319,985389,1070,46.70092367627111,58.547407490908064
9861,C6_04420W_A,807,C6,985842,986297,455,210.5180265992709,263.9195055953862
9863,C6_04430W_A,320,C6,987663,988814,1151,32.99907808505922,41.36985565559418
9865,C6_04440C_A,507,C6,988798,991299,2501,24.061429190927253,30.165020062989264
9867,C6_04450W_A,364,C6,991302,992492,1190,36.306265101966254,45.51596692460703
9869,C6_04460W_A,2,C6,992696,992810,114,2.082343140126269,2.6105649045827244
9871,C6_04470C_A,1248,C6,992873,995203,2330,63.57491914850743,79.70177899244493
9873,C6_04480C_A,410,C6,995286,995987,701,69.42133977853197,87.03124368059666
9875,C6_04490W_A,179,C6,997774,999153,1379,15.406923175277974,19.315151357112065
9877,C6_04500C_A,1906,C6,999224,1003501,4277,52.894534353424866,66.31213288839756
9879,C6_04510C_A,562,C6,1003604,1005055,1451,45.9722812893211,57.63393256609441
9881,C6_04520W_A,9450,C6,1005227,1008493,3266,343.43359841672225,430.5513735007607
9883,C6_04530C_A,1299,C6,1008502,1011345,2843,54.232477356443674,67.98946789659468
9885,C6_04540C_A,717,C6,1012024,1013172,1148,74.13177856604572,92.93656540539317
9887,C6_04550C_A,720,C6,1013238,1015511,2273,37.59760777421122,47.13488063531676
9889,C6_04560W_A,1850,C6,1015669,1016658,989,222.02536312064217,278.3458738000488
9891,C6_04570W_A,3150,C6,1016757,1019129,2372,157.6242457039088,197.60831729250768
9893,C6_04580W_A,1381,C6,1019276,1020757,1481,110.67913906908815,138.7547856813223
9895,C6_04590C_A,337,C6,1021000,1021746,746,53.61894018590551,67.22029658462407
9897,C6_04600W_A,215,C6,1021987,1023228,1241,20.563348253221136,25.77959138248291
9899,C6_04610C_A,117,C6,1023237,1024922,1685,8.241629911870678,10.332259554102189
9901,C6_04620C_A,8,C6,1025130,1026875,1745,0.544153852090303,0.6821877343780642
9903,C6_04650W_A,2635,C6,1028580,1031093,2513,124.45584080034422,156.02618219013223
9905,C7_00010C_A,2250,C7,117,1155,1038,257.28372612831794,322.54812043616033
9907,C7_00020C_A,3671,C7,1246,2040,794,548.7708501788433,687.9759125808833
9909,C7_00030W_A,1533,C7,2278,2769,491,370.5849815221457,464.5901668581324
9911,C7_00040C_A,332,C7,2747,3421,674,58.46626347737318,73.29722589662236
9913,C7_00050C_A,2913,C7,3464,5761,2297,150.5243088070117,188.70736061028302
9915,C7_00060C_A,1084,C7,5799,6467,668,192.61050590138015,241.46943761131342
9917,C7_00070C_A,2610,C7,6523,7476,953,325.0684039418521,407.52753499976063
9919,C7_00080C_A,3234,C7,7583,9430,1847,207.8261882861918,260.54483669787237
9921,C7_00090C_A,1309,C7,10024,13080,3056,50.84092562638787,63.73759136964359
9923,C7_00100W_A,767,C7,14047,15825,1778,51.20245204903283,64.19082512005181
9925,C7_00110W_A,12201,C7,15982,16662,680,2129.676637062934,2669.9053483035113
9927,C7_00120W_A,950,C7,16744,17208,464,243.0148298229256,304.65967582576405
9929,C7_00130W_A,1333,C7,17255,18298,1043,151.6956031926501,190.1757737441035
9931,C7_00140C_A,1186,C7,18321,18851,530,265.6048319977662,332.98001637660633
9933,C7_00150W_A,2967,C7,19179,19871,692,508.907210281813,638.0001822227251
9935,C7_00160C_A,1122,C7,19888,20349,461,288.88106981265827,362.1606679125456
9937,C7_00170W_A,1701,C7,21072,23375,2303,87.66727913036156,109.90557596770611
9939,C7_00180W_A,539,C7,23536,25842,2306,27.74320394366842,34.78073961990245
9941,C7_00190W_A,1043,C7,26062,27036,974,127.10203493187561,159.34362848290303
9943,C7_00200W_A,540,C7,27138,28232,1094,58.58731430812301,73.44898333003314
9945,C7_00210C_A,733,C7,28225,30591,2366,36.771926769913634,46.09975159694455
9947,C7_00220W_A,181,C7,30551,31618,1067,20.13452125274857,25.241985117694437
9949,C7_00230W_A,395,C7,31779,33545,1766,26.54810634198355,33.28248517932052
9951,C7_00240W_A,358,C7,33810,34454,644,65.98182316369046,82.71923515980602
9953,C7_00250C_A,1131,C7,34632,35195,563,238.4412348392899,298.9259106638268
9955,C7_00260C_A,1125,C7,35365,38295,2930,45.57346548143242,57.13395034347004
9957,C7_00270W_A,536,C7,38507,39679,1172,54.283061106772855,68.05288307577763
9959,C7_00280W_A,176,C7,41587,43167,1580,13.22156100110553,16.575434887831577
9961,C7_00290C_A,169,C7,43379,45102,1723,11.64202638934205,14.595224449126746
9963,C7_00300W_A,1927,C7,46309,47109,800,285.9031102104116,358.4272981930773
9965,C7_00310C_A,646,C7,47152,47988,836,91.71775012647068,114.98351784275727
9967,C7_00320C_A,2493,C7,48461,51214,2753,107.4838512731867,134.74895877446775
9969,C7_00330C_A,483,C7,51707,52855,1148,49.93814372022327,62.605803473925945
9971,C7_00340C_A,3581,C7,52951,55866,2915,145.81188155511276,182.79954601328024
9973,C7_00350C_A,3329,C7,56058,57377,1319,299.56850482818805,375.5591526454023
9975,C7_00360W_A,3017,C7,59071,60084,1013,353.5029293824032,443.1749615757024
9977,C7_00370W_A,139,C7,60279,61298,1019,16.19077988147246,20.297846652609348
9979,C7_00380W_A,342,C7,61437,62255,818,49.62493542007518,62.21314455982351
9981,C7_00390W_A,5072,C7,62478,63944,1466,410.6505669734413,514.8190696961009
9983,C7_00400W_A,1460,C7,64158,65279,1121,154.58750769072984,193.80125901817513
9985,C7_00410C_A,1388,C7,65303,68746,3443,47.84974146797268,59.9876424603447
9987,C7_00420C_A,194,C7,69078,69539,461,49.94913328311559,62.61958072641164
9989,C7_00430W_A,2934,C7,70601,72361,1760,197.86755799343015,248.06003040488957
9991,C7_00440C_A,3252,C7,72658,74332,1674,230.58031889269162,289.070939649386
9993,C7_00450C_A,235,C7,74657,75454,797,34.99747347803184,43.87517803875232
9995,C7_00460W_A,52,C7,75620,76342,722,8.548566575255212,10.71705592407645
9997,C7_00470C_A,916,C7,76425,77930,1505,72.24139537028091,90.56665435087919
9999,C7_00480W_A,34,C7,79446,80990,1544,2.6137182678527915,3.2767323737573313
10001,C7_00490C_A,183,C7,81174,81905,731,29.71398261922998,37.2514398354342
10003,C7_00500W_A,1,C7,81346,81816,470,0.25253948720680286,0.3166004245983304
10005,C7_00510W_A,1162,C7,82584,83879,1295,106.50340968580952,133.51981149817155
10007,C7_00520W_A,5016,C7,84177,87452,3275,181.79141736787236,227.90590320581862
10009,C7_00530C_A,118,C7,87578,88111,533,26.27737328422005,32.94307607546605
10011,C7_00540W_A,2,C7,88271,88384,113,2.1007709555256167,2.633667248871067
10013,C7_00550C_A,4876,C7,88681,91080,2399,241.246266620081,302.4424864779015
10015,C7_00560C_A,263,C7,91359,92165,806,38.73003227497879,48.554563876674464
10017,C7_00570W_A,4793,C7,92423,95923,3500,162.54235092161053,203.77398357054423
10019,C7_00580C_A,313,C7,96043,96723,680,54.633947004401136,68.49277715097115
10021,C7_00590W_A,530,C7,96928,97902,974,64.58684421274599,80.97039606513768
10023,C7_00600C_A,766,C7,97943,99298,1355,67.09908943482891,84.11991502870178
10025,C7_00610C_A,954,C7,99537,101327,1790,63.259025292618034,79.30575328569797
10027,C7_00620W_A,5483,C7,101629,103806,2177,298.94202293376344,374.7737529601027
10029,C7_00630C_A,170,C7,103977,105816,1839,10.972215893324389,13.75550512528907
10031,C7_00640C_A,3,C7,106320,106646,326,1.0922720152196075,1.36934539473511
10033,C7_00650W_A,4,C7,114110,114475,365,1.3007513313665462,1.6307090362872907
10035,C7_00660W_A,2076,C7,115894,117909,2015,122.28676350244254,153.30688153304365
10037,C7_00670C_A,1511,C7,122844,126245,3401,52.733304213365244,66.11000398029883
10039,C7_00680W_A,65,C7,126561,127202,641,12.036008321634679,15.089146601371286
10041,C7_00690W_A,829,C7,127379,128182,803,122.53668792078032,153.62020353206412
10043,C7_00700W_A,1327,C7,129228,129608,380,414.49040204213395,519.6329442571913
10045,C7_00710W_A,4783,C7,131585,131860,275,2064.4047004936906,2588.076074550155
10047,C7_00720W_A,2339,C7,132567,134273,1706,162.73401786111054,204.01427009008356
10049,C7_00730W_A,1649,C7,135510,136031,521,375.6730878500738,470.96895792023804
10051,C7_00740W_A,4417,C7,137282,143053,5771,90.84551205102248,113.89002174006028
10053,C7_00750W_A,236,C7,143529,143912,383,73.13754548558374,91.69012818915616
10055,C7_00760C_A,45,C7,144060,144569,509,10.49353664916283,13.155400747062256
10057,C7_00770W_A,1087,C7,145917,146819,902,143.03758161760922,179.32149769738473
10059,C7_00780W_A,1459,C7,148191,150485,2294,75.48993136979988,94.63923677411208
10061,C7_00790W_A,315,C7,150850,153243,2393,15.624099908469356,19.587418663511414
10063,C7_00800C_A,210,C7,153347,153889,542,45.988279312382744,57.653988759880455
10065,C7_00810W_A,728,C7,154466,155746,1280,67.5069616739685,84.6312510004412
10067,C7_00820W_A,380,C7,156150,157241,1091,41.34147792404674,51.82844714322806
10069,C7_00830C_A,2596,C7,157502,159808,2306,133.62032919807646,167.51539898565258
10071,C7_00840C_A,241,C7,160710,163940,3230,8.856082884184074,11.10257897654888
10073,C7_00850W_A,429,C7,165660,168671,3011,16.911171307043396,21.200977619316294
10075,C7_00860W_A,1707,C7,171720,172424,704,287.7981607828777,360.803060583799
10077,C7_00870W_A,117,C7,174289,176121,1832,7.580320088156164,9.503197242719535
10079,C7_00880C_A,625,C7,176562,179318,2756,26.91708068468736,33.74505614142219
10081,C7_00890C_A,1069,C7,188023,188811,788,161.0195616209568,201.86491285652178
10083,C7_00900W_A,11,C7,189687,189995,308,4.239055678114192,5.314364270043403
10085,C7_00910C_A,388,C7,190074,191255,1181,38.99500498478626,48.8867514223129
10087,C7_00920C_A,90,C7,191453,192481,1028,10.391459444404438,13.027429922674491
10089,C7_00930W_A,6044,C7,195079,197781,2702,265.5010623681054,332.8499238149464
10091,C7_00940W_A,1590,C7,198460,200568,2108,89.52692542203216,112.23695317947454
10093,C7_00950W_A,1739,C7,200872,201708,836,246.89964004633518,309.5299342547289
10095,C7_00960W_A,13212,C7,202217,203082,865,1812.9240477905796,2272.80307584136
10097,C7_00970C_A,732,C7,205033,206040,1007,86.27972708900543,108.1660477445974
10099,C7_00980W_A,2789,C7,209134,211122,1988,166.51727163747154,208.75721055142324
10101,C7_00990W_A,10434,C7,211801,212739,938,1320.3076700132378,1655.2261729442646
10103,C7_01000C_A,1,C7,211827,212249,422,0.28126435778956715,0.352611847301458
10105,C7_01010W_A,457,C7,212898,214127,1229,44.135847402074205,55.33165598004506
10107,C7_01020C_A,1067,C7,214245,214766,521,243.0825862559301,304.74461983074224
10109,C7_01030C_A,3330,C7,214925,218578,3653,108.19861796533458,135.64503819842508
10111,C7_01040C_A,618,C7,218779,220611,1832,40.03963944000435,50.19637517949293
10113,C7_01050W_A,64,C7,221546,222589,1043,7.283209755686127,9.130719819671887
10115,C7_01060W_A,2,C7,222726,223154,428,0.5546427990055951,0.6953373811271742
10117,C7_01070C_A,1390,C7,223296,226653,3357,49.14627554131794,61.613064459365276
10119,C7_01100C_A,159,C7,230874,232412,1538,12.270660519482693,15.383322321348002
10121,C7_01130C_A,1,C7,236122,236562,440,0.2697580886072667,0.3381868171845802
10123,C7_01150W_A,335,C7,244441,245340,899,44.229524205462866,55.449095498339396
10125,C7_01160C_A,352,C7,245475,245753,278,150.28824735069594,188.41141814945243
10127,C7_01170C_A,206,C7,246116,247258,1142,21.410571936394618,26.841727766734106
10129,C7_01180W_A,407,C7,248250,249536,1286,37.56475778210679,47.093697683837185
10131,C7_01190W_A,253,C7,249860,250768,908,33.07210399092613,41.46140582487606
10133,C7_01200C_A,1192,C7,250792,252975,2183,64.8111416915892,81.25159041546891
10135,C7_01210C_A,643,C7,253347,254183,836,91.29181630235395,114.44953865772898
10137,C7_01220W_A,742,C7,254404,255339,935,94.19317729251384,118.08687922398049
10139,C7_01230C_A,2635,C7,255373,256806,1433,218.2536831341696,273.61744301730795
10141,C7_01250W_A,10185,C7,257912,259124,1212,997.4372098057797,1250.4541275008066
10143,C7_01260W_A,1,C7,258488,258578,90,1.3188173220799706,1.6533577729023918
10145,C7_01270C_A,592,C7,259274,261082,1808,38.86426267722391,48.72284410411474
10147,C7_01280C_A,303,C7,261260,262552,1292,27.83602815257028,34.89711026861319
10149,C7_01290W_A,67,C7,263352,263858,506,15.716340814510323,19.703058044666843
10151,C7_01300C_A,29,C7,263896,264606,710,4.848046775533413,6.077836320105977
10153,C7_01310C_A,14,C7,264744,265073,329,5.050789744136058,6.332008491966608
10155,C7_01320W_A,929,C7,266119,267939,1820,60.585888076432056,75.95452933646649
10157,C7_01330C_A,577,C7,268107,273401,5294,12.936566591540023,16.218146797661735
10159,C7_01340W_A,731,C7,273669,275717,2048,42.36571856427796,53.11250384728925
10161,C7_01350C_A,263,C7,275786,276745,959,32.55099688595715,40.808111037121606
10163,C7_01360C_A,22,C7,277182,277736,554,4.713462631260545,5.909112617954398
10165,C7_01370W_A,250,C7,278053,279501,1448,20.49267247707137,25.690987493303748
10167,C7_01380W_A,62,C7,281375,282502,1127,6.529725516598257,8.18610148429046
10169,C7_01390W_A,255,C7,285900,286292,392,77.21137127993705,96.79734920436198
10171,C7_01400C_A,665,C7,286775,289093,2318,34.05143085698285,42.689155611824056
10173,C7_01410C_A,689,C7,290111,291139,1028,79.55239507994065,99.73221351914137
10175,C7_01420W_A,424,C7,292252,293031,779,64.6034262009906,80.99118435681038
10177,C7_01430C_A,2155,C7,295832,296773,941,271.8221249919344,340.774431513729
10179,C7_01440W_A,127,C7,302675,303043,368,40.96217932438605,51.352933000745494
10181,C7_01450C_A,3901,C7,303151,305370,2219,208.66316972016983,261.594132712168
10183,C7_01460C_A,539,C7,305828,308848,3020,21.184049104006416,26.557743564071203
10185,C7_01470C_A,1667,C7,309229,310165,936,211.3911996064722,265.0141737911815
10187,C7_01480W_A,422,C7,310445,311785,1340,37.37961335268454,46.861588220024515
10189,C7_01490W_A,560,C7,312570,313262,692,96.05259108790537,120.41796496283318
10191,C7_01500W_A,157,C7,313805,315115,1310,14.225105924419834,17.833546054283055
10193,C7_01510W_A,700,C7,317084,318727,1643,50.569379970199726,63.3971635379493
10195,C7_01520W_A,1550,C7,320555,322387,1832,100.42304390292352,125.89705748901949
10197,C7_01530W_A,4,C7,322903,323229,326,1.4563626869594766,1.8257938596468133
10199,C7_01540W_A,61,C7,325170,326693,1523,4.75397708353187,5.959904250317881
10201,C7_01550W_A,2875,C7,329715,336473,6758,50.49481830248482,63.30368803469871
10203,C7_01560C_A,46,C7,336677,337897,1220,4.475330912632032,5.6105747375540185
10205,C7_01570C_A,168,C7,338747,339883,1136,17.553272807965808,22.005959090038882
10207,C7_01580W_A,1850,C7,340590,343976,3386,64.8502906456926,81.30067016782289
10209,C7_01590C_A,494,C7,344244,345575,1331,44.05305645355034,55.227863698903334
10211,C7_01600W_A,2258,C7,345794,346918,1124,238.44311049207445,298.9282621078506
10213,C7_01610W_A,694,C7,347245,347582,337,244.4312461041987,306.43539019431284
10215,C7_01620C_A,492,C7,347813,349792,1979,29.50845428079894,36.993775737300616
10217,C7_01630W_A,328,C7,350989,352284,1295,30.06292459289632,37.68889687728078
10219,C7_01640W_A,8137,C7,352678,354111,1433,673.9773129649859,844.9431247938652
10221,C7_01650W_A,1437,C7,354542,356139,1597,106.80190623957583,133.89402678113112
10223,C7_01660C_A,1950,C7,356175,358622,2447,94.58620352473838,118.57960324657532
10225,C7_01670W_A,540,C7,359156,360895,1739,36.85711434910096,46.20654845489146
10227,C7_01680C_A,1438,C7,363741,364475,734,232.5358825934466,291.5225653528986
10229,C7_01690W_A,155,C7,369530,369886,356,51.67837540172919,64.78747452805722
10231,C7_01700W_A,1845,C7,370380,371207,827,264.8000197477378,331.97104980706433
10233,C7_01710W_A,497,C7,371481,372662,1181,49.94978731298652,62.62040066208636
10235,C7_01720W_A,338,C7,373129,373893,764,52.51102478752971,65.83133959645389
10237,C7_01730C_A,310,C7,373998,374338,340,108.22059790009172,135.67259371757865
10239,C7_01740C_A,207,C7,374590,375264,674,36.45336307173569,45.70037879699044
10241,C7_01750W_A,288,C7,375744,376628,884,38.66939478315932,48.478544653427605
10243,C7_01760C_A,1984,C7,377222,377785,563,418.27357199040773,524.3757796260234
10245,C7_01770W_A,3,C7,379039,379386,347,1.0261690978720233,1.2864743477914868
10247,C7_01780W_A,3468,C7,380242,384336,4094,100.54451943517354,126.04934735669141
10249,C7_01790C_A,18745,C7,384487,385383,896,2483.1593339453284,3113.054945061362
10251,C7_01800C_A,7168,C7,385958,388798,2840,299.5758559226164,375.56836846999687
10253,C7_01810W_A,3865,C7,390347,391843,1496,306.6514742550252,384.43883777011837
10255,C7_01820C_A,565,C7,392020,392511,491,136.58220127854685,171.22860030974874
10257,C7_01830W_A,161,C7,393003,393695,692,27.615119937772793,34.62016492681454
10259,C7_01840W_A,1956,C7,394415,399358,4943,46.96835957494599,58.882683055176436
10261,C7_01850C_A,1518,C7,399687,401742,2055,87.67728590879103,109.91812113572983
10263,C7_01860W_A,5,C7,401550,402020,470,1.2626974360340146,1.583002122991652
10265,C7_01870W_A,1076,C7,402404,404011,1607,79.47372088999649,99.63358228243165
10267,C7_01880C_A,313,C7,404173,405123,950,39.10640417157134,49.02640890806356
10269,C7_01890C_A,431,C7,405642,405839,197,259.67981687046733,325.55202035981614
10271,C7_01900W_A,5012,C7,406702,408138,1436,414.2702769107473,519.3569806412332
10273,C7_01910C_A,278,C7,408386,409249,863,38.23500509668699,47.93396463269739
10275,C7_01920W_A,1619,C7,411053,411787,734,261.8050027251669,328.2162957624081
10277,C7_01930C_A,613,C7,412311,412922,611,119.08208127520781,149.2892771375204
10279,C7_01940C_A,15496,C7,413292,416609,3317,554.4996653800453,695.1579392223672
10281,C7_01950W_A,641,C7,418439,419293,854,89.08966195643269,111.68877039664989
10283,C7_01960W_A,1066,C7,419928,421982,2054,61.60045466424167,77.2264580001244
10285,C7_01970C_A,9640,C7,422229,423401,1172,976.2849049800193,1223.9361806912248
10287,C7_01990C_A,572,C7,429941,431671,1730,39.24434435877277,49.19933997052899
10289,C7_02000C_A,8,C7,432211,433887,1676,0.5665563674806556,0.7102730289318152
10291,C7_02010C_A,351,C7,435297,437282,1985,20.98813058161525,26.312126975308097
10293,C7_02020W_A,1137,C7,438032,439222,1190,113.4072072003726,142.17487470680823
10295,C7_02030W_A,50487,C7,439525,441648,2123,2822.648004044575,3538.660692061741
10297,C7_02040C_A,13858,C7,449870,450904,1034,1590.7691880508519,1994.2948564016647
10299,C7_02050C_A,1702,C7,455359,457362,2003,100.85693329815773,126.44101031112753
10301,C7_02060W_A,1660,C7,458219,460717,2498,78.87562366643219,98.88376752266508
10303,C7_02070W_A,86,C7,460994,461365,371,27.51387081643928,34.49323224330058
10305,C7_02080W_A,248,C7,461678,462148,470,62.62979282728711,78.51690530038594
10307,C7_02090C_A,302,C7,462241,463041,800,44.806818517667004,56.17283033435877
10309,C7_02100W_A,7056,C7,463552,464776,1224,684.2334576909025,857.8009151175941
10311,C7_02110W_A,1131,C7,465064,467130,2066,64.97696767401753,81.45948097954235
10313,C7_02120C_A,629,C7,467306,467767,461,161.94847853133868,203.02946534491193
10315,C7_02130W_A,22,C7,468121,469158,1037,2.518089004549992,3.1568451208743844
10317,C7_02140W_A,111,C7,469496,470368,872,15.108927806856546,18.941564393686807
10319,C7_02150C_A,851,C7,470403,471722,1319,76.57939249287715,96.00505824609114
10321,C7_02160W_A,631,C7,472182,475838,3656,20.48567716655403,25.682217703262264
10323,C7_02170C_A,1219,C7,475895,476923,1028,140.74654514143344,176.44930084155783
10325,C7_02180C_A,354,C7,477161,477799,638,65.85818163239476,82.56422985058026
10327,C7_02190W_A,28,C7,479891,480038,147,22.608296949942353,28.34327610689815
10329,C7_02200W_A,1509,C7,480365,482479,2114,84.72496712946112,106.216896470139
10331,C7_02210W_A,14,C7,483232,483624,392,4.239055678114191,5.314364270043403
10333,C7_02220C_A,228,C7,483803,485029,1226,22.073516679511417,27.67283972264036
10335,C7_02230W_A,4,C7,486519,486872,353,1.3449695069370804,1.686143904376377
10337,C7_02240W_A,328,C7,487109,487966,857,45.427639845741815,56.951133554350776
10339,C7_02250W_A,2,C7,489299,491008,1709,0.1389041064800437,0.17413949626824493
10341,C7_02260W_A,1372,C7,492273,492731,458,355.5623644769318,445.75680741918643
10343,C7_02270W_A,250,C7,493961,494419,458,64.7890605825313,81.22390805743193
10345,C7_02280W_A,1752,C7,495607,496065,458,454.0417365623794,569.2171476664829
10347,C7_02290W_A,45,C7,496851,497402,551,9.693666341967116,12.152629728229924
10349,C7_02300W_A,495,C7,497855,499960,2105,27.911311970861135,34.99149110821927
10351,C7_02310C_A,35,C7,500154,501344,1190,3.490987029035216,4.376535281212214
10353,C7_02320W_A,679,C7,502656,504995,2339,34.45614645246131,43.196534203533645
10355,C7_02330W_A,1455,C7,505458,510197,4739,36.442103466210625,45.68626300096396
10357,C7_02340C_A,127,C7,510339,511619,1280,11.776626555760988,14.763968237714328
10359,C7_02350C_A,813,C7,511805,514204,2399,40.22420319157626,50.427756666639446
10361,C7_02360W_A,51,C7,515708,516121,413,14.657073870089746,18.375090018455158
10363,C7_02370W_A,1599,C7,517530,518033,503,377.31809308256175,473.0312467164677
10365,C7_02380C_A,17788,C7,519130,519618,488,4326.477514885792,5423.9621430223315
10367,C7_02390W_A,816,C7,520547,521104,557,173.88499844443993,217.99388661032617
10369,C7_02420C_A,1352,C7,523711,526224,2513,63.85741812602102,80.05593864176804
10371,C7_02430C_A,427,C7,526542,527896,1354,37.431425175430775,46.92654299308635
10373,C7_02450W_A,783,C7,529016,530869,1853,50.15491456393714,62.8775619300764
10375,C7_02460C_A,855,C7,530886,532163,1277,79.46984568054326,99.62872406017155
10377,C7_02470C_A,440,C7,532246,533123,877,59.54979014180939,74.65560753356297
10379,C7_02480W_A,879,C7,533816,534331,515,202.5857055334883,253.9750163384626
10381,C7_02490W_A,1539,C7,534960,538232,3272,55.82805234758458,69.98978762980144
10383,C7_02500C_A,128,C7,538375,539295,920,16.51388646778398,20.702914721560386
10385,C7_02510W_A,254,C7,540438,540911,473,63.73819023836814,79.90646657198454
10387,C7_02520W_A,79,C7,541379,542170,791,11.854350391894554,14.86140804720102
10389,C7_02530C_A,385,C7,542111,543661,1550,29.48194852262644,36.96054634262444
10391,C7_02540W_A,409,C7,545757,547433,1676,28.96519428744852,36.31270860413905
10393,C7_02550C_A,256,C7,547659,548327,668,45.4873519471894,57.02599264621424
10395,C7_02560W_A,416,C7,548601,552542,3941,12.528931879897005,15.707108606309456
10397,C7_02570C_A,1032,C7,552627,553001,374,327.51805581494034,410.598582746455
10399,C7_02600C_A,83892,C7,554233,558933,4700,2118.6042660753105,2656.024282040313
10401,C7_02610C_A,27035,C7,558964,559916,952,3370.672654641681,4225.701118841865
10403,C7_02630W_A,460,C7,560574,562490,1916,28.4963659363835,35.72495396563624
10405,C7_02640W_A,2101,C7,563064,564953,1889,132.01438191217662,165.5020758486571
10407,C7_02650W_A,42,C7,565312,566472,1160,4.297525411605422,5.387665846181933
10409,C7_02660C_A,53,C7,566564,567244,680,9.251115626943323,11.597818495212369
10411,C7_02670W_A,250,C7,568036,571017,2981,9.954173011338256,12.479218346294472
10413,C7_02680W_A,488,C7,571203,571655,452,128.14702828706262,160.6537021811351
10415,C7_02690C_A,227,C7,571898,573106,1208,22.30417043881937,27.96200273211579
10417,C7_02750W_A,386,C7,585449,586982,1533,29.886310351636126,37.4674814289818
10419,C7_02760W_A,90,C7,590345,590770,425,25.135106609053558,31.51105402472794
10421,C7_02770W_A,1278,C7,593118,596198,3080,49.25011960572669,61.74325033741335
10423,C7_02780W_A,3599,C7,596435,597913,1478,289.0244376149684,362.34040339703233
10425,C7_02790C_A,3651,C7,597970,601086,3116,139.07258788904286,174.3507158530157
10427,C7_02800W_A,3577,C7,601521,604766,3245,130.83724514551773,164.02633831447366
10429,C7_02810W_A,2503,C7,605320,606051,731,406.41583877558827,509.5101306453103
10431,C7_02830C_A,695,C7,609391,610782,1391,59.30411466290594,74.34761228975171
10433,C7_02840C_A,26831,C7,612138,613691,1553,2050.6547850518305,2570.838259128762
10435,C7_02850W_A,1775,C7,614917,616851,1934,108.93540186260357,136.56871986616193
10437,C7_02860C_A,3304,C7,617611,621030,3419,114.70123395545484,143.79715336363128
10439,C7_02870C_A,402,C7,621309,621806,497,96.0056553578538,120.3591231863351
10441,C7_02880C_A,92,C7,622107,623468,1361,8.023370629553385,10.0586350915737
10443,C7_02890C_A,5932,C7,624651,627284,2633,267.40987159591896,335.2429349780209
10445,C7_02910W_A,20657,C7,629776,632691,2915,841.1158998279711,1054.4792577482074
10447,C7_02920W_A,344,C7,633412,635133,1721,23.724918240323007,29.743147384693817
10449,C7_02930C_A,1419,C7,635249,636553,1304,129.1611657997186,161.9250929274268
10451,C7_02940C_A,4610,C7,636728,639031,2303,237.59327265782883,297.8628484486333
10453,C7_02950C_A,1661,C7,639193,640713,1520,129.703948340615,162.60556149419642
10455,C7_02960C_A,405,C7,641273,642400,1127,42.653852164875715,53.473727437703815
10457,C7_02970W_A,574,C7,642586,644340,1754,38.84270402431658,48.69581673211948
10459,C7_02980C_A,742,C7,644348,647710,3362,26.1959014778407,32.8409375593164
10461,C7_02990W_A,1081,C7,648090,652049,3959,32.40912787702964,40.630254540458125
10463,C7_03000C_A,644,C7,652101,652583,482,158.58641491235497,198.8145570900885
10465,C7_03010W_A,2772,C7,653587,656172,2585,127.27990155222867,159.5666139975585
10467,C7_03020C_A,637,C7,656372,657406,1034,73.12166061396974,91.67021384960749
10469,C7_03030W_A,240,C7,658010,658528,518,54.99315474310302,68.9431040438063
10471,C7_03040W_A,88,C7,658745,659356,611,17.094980672460505,21.43141335742544
10473,C7_03050W_A,335,C7,659498,660100,602,66.05040242643042,82.80521071928092
10475,C7_03060C_A,513,C7,660102,662387,2285,26.647613024259186,33.4072334244654
10477,C7_03070C_A,2829,C7,662700,667772,5072,66.20348548398685,82.99712589879299
10479,C7_03080W_A,929,C7,669562,671481,1919,57.460300312197155,72.03608306011934
10481,C7_03090C_A,147,C7,671607,672854,1247,13.991943200575793,17.541237638731875
10483,C7_03110W_A,41,C7,675478,676158,680,7.156523409522194,8.97189732648504
10485,C7_03120W_A,3251,C7,676794,677996,1202,321.02559090464115,402.45919365516716
10487,C7_03130C_A,278,C7,678065,678643,578,57.087905533634725,71.5692240104115
10489,C7_03140W_A,19,C7,679341,681512,2171,1.0387736622555273,1.302276274372681
10491,C7_03150W_A,25,C7,682298,684385,2087,1.4218203041111326,1.782489213718439
10493,C7_03160W_A,1268,C7,685122,687359,2237,67.27913848715522,84.34563658633033
10495,C7_03170W_A,261,C7,687921,690194,2273,13.629132818151565,17.08639423030233
10497,C7_03180C_A,753,C7,691394,692238,844,105.89603070777206,132.75836050899895
10499,C7_03190C_A,26,C7,692216,692593,377,8.18576268877223,10.26222065939416
10501,C7_03200C_A,306,C7,693435,694121,686,52.94494030624255,66.37532516870536
10503,C7_03210W_A,180,C7,695611,696768,1157,18.465722227913158,23.14986682888397
10505,C7_03220C_A,3958,C7,697006,700323,3317,141.63072248155777,177.55776480653907
10507,C7_03230C_A,58,C7,700560,700940,380,18.116385319098544,22.7119146698697
10509,C7_03240W_A,1829,C7,703277,705439,2162,100.41189610896575,125.88308186746657
10511,C7_03250C_A,17601,C7,705589,707268,1679,1244.2676186620968,1559.8972688963372
10513,C7_03260C_A,164,C7,708439,709125,686,28.375719641254182,35.5737036851885
10515,C7_03270W_A,4805,C7,710680,711873,1193,478.0574609668762,599.3248691463867
10517,C7_03280C_A,531,C7,713476,715191,1715,36.750017389038945,46.07228452886608
10519,C7_03290C_A,1254,C7,716697,721385,4688,31.74951428539793,39.80331873928412
10521,C7_03300C_A,1017,C7,727464,728846,1382,87.34540484079574,109.50205278853541
10523,C7_03310W_A,557,C7,731779,732447,668,98.9705274788457,124.07608556227083
10525,C7_03320C_A,1157,C7,732621,735782,3161,43.444621242703995,54.46508854550018
10527,C7_03330C_A,4891,C7,736055,737536,1481,391.98527819472133,491.41901286556646
10529,C7_03340C_A,361,C7,737814,738770,956,44.82047572633707,56.189951926358496
10531,C7_03350C_A,737,C7,738908,739837,929,94.16270503074753,118.04867715459167
10533,C7_03360W_A,11991,C7,740654,742282,1628,874.2349298620906,1095.9994932054867
10535,C7_03370C_A,1176,C7,742537,743631,1094,127.59015115991235,159.9555636965166
10537,C7_03380W_A,458,C7,744358,744657,299,181.8115385155063,227.9311284248716
10539,C7_03390C_A,1247,C7,744898,745518,620,238.72720654360504,299.28442395618623
10541,C7_03400C_A,2128,C7,745808,748996,3188,79.22832293750187,99.32593496432439
10543,C7_03410C_A,145,C7,749268,751232,1964,8.763017338667828,10.985905772085651
10545,C7_03420C_A,149,C7,753811,755640,1829,9.6694042039871,12.122213086178828
10547,C7_03440W_A,243,C7,756765,758426,1661,17.3645604057128,21.7693765763849
10549,C7_03450C_A,213,C7,758521,759939,1418,17.829145320361803,22.351811358631068
10551,C7_03460W_A,133,C7,762312,764132,1820,8.673760079833654,10.874006891011888
10553,C7_03470W_A,59,C7,765204,765881,677,10.34404723817525,12.967990803710048
10555,C7_03480W_A,619,C7,771011,774148,3137,23.420883969740252,29.361989648834
10557,C7_03490W_A,2115,C7,774906,777236,2330,107.74114903773494,135.07152449440787
10559,C7_03500W_A,496,C7,777676,778842,1166,50.49057054686954,63.29836276360445
10561,C7_03520W_A,241,C7,779702,780436,734,38.97159089361657,48.85739794857341
10563,C7_03530C_A,180,C7,780464,781264,800,26.706050772119408,33.48049490127344
10565,C7_03540C_A,1042,C7,781559,783811,2252,54.91948866103892,68.85075130674349
10567,C7_03550C_A,4,C7,784193,786196,2003,0.237031570618467,0.29715866113073447
10569,C7_03560W_A,17,C7,789476,790456,980,2.0589699007983215,2.581262645449653
10571,C7_03570W_A,724,C7,792047,793453,1406,61.1195851399224,76.62360773991456
10573,C7_03580C_A,387,C7,793704,795782,2078,22.105104585199893,27.712440438012663
10575,C7_03590C_A,293,C7,796798,798657,1859,18.707484014657787,23.452955605936566
10577,C7_03600W_A,582,C7,800395,802665,2270,30.431564462796857,38.15104852186224
10579,C7_03610C_A,645,C7,802914,806345,3431,22.31342044498464,27.97359915971549
10581,C7_03620C_A,1297,C7,806681,808660,1979,77.78956341909802,97.52220961642054
10583,C7_03630C_A,112,C7,809086,809449,363,36.62170415031984,45.91142245414907
10585,C7_03640C_A,912,C7,809748,811217,1469,73.68858120920625,92.38094349886205
10587,C7_03650W_A,171,C7,811482,812438,956,21.23075165984388,26.61629301774876
10589,C7_03660C_A,5341,C7,812904,814979,2075,305.5143607472873,383.013276075398
10591,C7_03670W_A,5741,C7,815421,817079,1658,410.988975962304,515.2433218823504
10593,C7_03680W_A,48,C7,817565,819406,1841,3.0946718258476227,3.879687984214196
10595,C7_03690W_A,90,C7,820478,821188,710,15.045662406827834,18.862250648604757
10597,C7_03700C_A,356,C7,822571,823998,1427,29.61100700731763,37.122342707633244
10599,C7_03710C_A,451,C7,824288,827590,3302,16.211627832594186,20.323983041219893
10601,C7_03720C_A,2256,C7,827988,829871,1883,142.20534735800172,178.27815305900248
10603,C7_03730C_A,528,C7,830249,833116,2867,21.85915561396589,27.404102325888267
10605,C7_03740C_A,12,C7,834984,835313,329,4.329248352116621,5.427435850257093
10607,C7_03760W_A,251,C7,836244,836981,737,40.423450889805345,50.67754693333112
10609,C7_03770C_A,612,C7,837011,837775,764,95.07913363895914,119.19757347050229
10611,C7_03780C_A,251,C7,838198,839559,1361,21.889848130629346,27.442580521576073
10613,C7_03790W_A,1203,C7,840836,842005,1169,122.14572409033227,153.13006507454406
10615,C7_03800W_A,178,C7,842328,842942,614,34.40953338716796,43.138096941199215
10617,C7_03810W_A,3188,C7,843505,846696,3191,118.5819699314275,148.66230404298162
10619,C7_03820C_A,89,C7,846800,847324,524,20.159783873779705,25.27365603234382
10621,C7_03830C_A,96,C7,847595,848101,506,22.5189360924327,28.23124734758235
10623,C7_03840W_A,494,C7,848744,849739,995,58.929264461985426,73.8776749580305
10625,C7_03850W_A,1141,C7,850058,852295,2237,60.54061278694331,75.89776919952912
10627,C7_03860W_A,4276,C7,853117,854598,1481,342.69659569834965,429.6274175042246
10629,C7_03870W_A,509,C7,855127,855881,754,80.1260232420205,100.45135222368512
10631,C7_03880C_A,391,C7,856037,856963,926,50.11790665658118,62.831166337403005
10633,C7_03890C_A,2628,C7,857114,859144,2030,153.65845961495305,192.63654209205603
10635,C7_03900W_A,13,C7,859698,860027,329,4.690019048126339,5.879722171111851
10637,C7_03910W_A,268,C7,860161,861222,1061,29.981030922308097,37.5862294838885
10639,C7_03920C_A,2494,C7,861407,861733,326,908.0421353192338,1138.3824714897883
10641,C7_03930C_A,3780,C7,862087,862881,794,565.0650541204105,708.4034185659872
10643,C7_03940C_A,1282,C7,863305,864765,1460,104.22270042574453,130.66056153251918
10645,C7_03950C_A,2,C7,865870,865985,115,2.0642358084729975,2.5878643401950483
10647,C7_03960C_A,1055,C7,866443,867900,1457,85.94489000102485,107.74627353265761
10649,C7_03970C_A,345,C7,868066,868530,464,88.25275398832562,110.63956648409327
10651,C7_03980W_A,244,C7,868824,869354,530,54.6438271563701,68.50516357157836
10653,C7_03990C_A,581,C7,869412,870218,806,85.55950095727253,107.26312400132268
10655,C7_04000W_A,847,C7,870453,872111,1658,60.635370604436766,76.01656394954725
10657,C7_04010W_A,3987,C7,872285,874201,1916,246.98915432252394,309.6421553499819
10659,C7_04020C_A,2585,C7,874326,875177,851,360.54388952045264,452.0019810408244
10661,C7_04030C_A,1190,C7,875398,878340,2942,48.00997117429125,60.18851715766356
10663,C7_04040C_A,1274,C7,878586,879851,1265,119.53801909066358,149.86087133674963
10665,C7_04050W_A,873,C7,880352,881347,995,104.14017788524954,130.55710574566928
10667,C7_04060W_A,428,C7,881557,883278,1721,29.51821222923909,37.00600895537487
10669,C7_04070C_A,8,C7,883464,883853,389,2.440998642410228,3.0601994768373326
10671,C7_04080C_A,4,C7,885185,885985,800,0.5934677949359868,0.7440109978060764
10673,C7_04090C_A,2643,C7,887242,888585,1343,233.58680298076143,292.84006957579453
10675,C7_04100C_A,142,C7,889548,890204,656,25.69281307344821,32.21023222209233
10677,C7_04110W_A,450,C7,890327,891421,1094,48.82276192343584,61.20748610836095
10679,C7_04120W_A,124,C7,891570,891977,407,36.16216539167684,45.335313871230206
10681,C7_04130C_A,3258,C7,892096,892941,845,457.6374144145432,573.7249303792182
10683,C7_04140C_A,741,C7,893178,893816,638,137.85568528136872,172.82512519570616
10685,C7_04150W_A,794,C7,893966,896869,2903,32.46389453525136,40.69891369328451
10687,C7_04160W_A,379,C7,897141,898802,1661,27.08299750520638,33.95306058621348
10689,C7_04170W_A,128,C7,898905,899724,819,18.550397497388598,23.256021421044636
10691,C7_04180W_A,765,C7,900072,902312,2240,40.53596992196695,50.81860833229005
10693,C7_04190C_A,1817,C7,902362,904020,1658,130.07611379960048,163.07213305351522
10695,C7_04200C_A,2399,C7,904199,907276,3077,92.54008710116557,116.01445458152601
10697,C7_04210C_A,4005,C7,907552,908649,1097,433.3342787089566,543.2568908319665
10699,C7_04220W_A,25,C7,915497,915931,434,6.837186577603535,8.571555274263552
10701,C7_04230W_A,8576,C7,918812,919744,932,1092.1845084487175,1369.2356903830284
10703,C7_04240C_A,1801,C7,924629,926377,1748,122.29239115328517,153.31393673326588
10705,C7_04250W_A,315,C7,928797,930488,1691,22.11027266763286,27.71891949247949
10707,C7_04260W_A,1985,C7,930547,932679,2132,110.50971603639152,138.54238561398327
10709,C7_04270C_A,1347,C7,932671,933591,920,173.78285212582045,217.86582914017066
10711,C7_04280C_A,1102,C7,933644,934390,746,175.33552547438538,219.81236449927513
10713,C7_04290W_A,408,C7,934460,934858,398,121.67580921300633,152.54094829390914
10715,C7_04300W_A,10617,C7,934878,939083,4205,299.6835947127406,375.7034370371992
10717,C7_04310C_A,1396,C7,939080,940303,1223,135.48340829609774,169.85107979350494
10719,C7_04320W_A,231,C7,940458,940859,401,68.37459383053016,85.7189728145654
10721,C7_04330C_A,293,C7,940993,941499,506,68.72966953211231,86.16411950876696
10723,C7_04340C_A,24,C7,942019,942219,200,14.243227078463683,17.856263947345834
10725,C7_04360C_A,10,C7,942825,943352,527,2.2522496961517526,2.8235711491691706
10779,CR_00010C_A,204,CR,4884,6890,2006,12.07053142242685,15.132427074021894
10781,CR_00020W_A,115,CR,9111,9863,752,18.15127564298896,22.755655518004993
10783,CR_00030W_A,1,CR,10308,10418,110,1.0790323544290668,1.3527472687383209
10785,CR_00040C_A,164,CR,10646,11815,1169,16.65161990923898,20.87558659370343
10787,CR_00050W_A,516,CR,13684,14823,1139,53.77162110394543,67.41170761508963
10789,CR_00060C_A,1540,CR,14971,16827,1856,98.48495734929091,123.46734230833597
10791,CR_00070W_A,1241,CR,16909,21366,4457,33.048846018198766,41.432248071677854
10793,CR_00080W_A,4112,CR,21385,24462,3077,158.61810677782108,198.8542881364047
10795,CR_00090C_A,1023,CR,24474,25163,689,176.23151065878503,220.93563156911935
10797,CR_00100C_A,3688,CR,25279,27540,2261,193.60541598619366,242.7167235655736
10799,CR_00110W_A,960,CR,28507,30687,2180,52.26872322371993,65.52757411870031
10801,CR_00120C_A,1582,CR,30873,32402,1529,122.80785501487652,153.96015677295134
10803,CR_00130C_A,970,CR,33075,34247,1172,98.23613670442103,123.15540407370209
10805,CR_00140W_A,382,CR,36752,38833,2081,21.788053595919937,27.314964071304296
10807,CR_00150C_A,1724,CR,39001,40227,1226,166.90676647139335,209.2455073764561
10809,CR_00160C_A,235,CR,40843,41283,440,63.39315082270768,79.47390203837635
10811,CR_00170W_A,285,CR,41616,43364,1748,19.352210704434352,24.26122818932858
10813,CR_00180C_A,649,CR,43351,44739,1388,55.49864537657859,69.57682097638957
10815,CR_00190W_A,1148,CR,45583,48474,2891,47.13255126852389,59.08852476522835
10817,CR_00200W_A,3328,CR,49655,51316,1661,237.81587255231355,298.14191459345244
10819,CR_00210W_A,2661,CR,52344,53912,1568,201.43084213324755,252.5272021890267
10821,CR_00220W_A,269,CR,54836,56452,1616,19.757776836358964,24.769673070524078
10823,CR_00230W_A,1723,CR,56627,62170,5543,36.895003091275676,46.25404832112105
10825,CR_00240W_A,320,CR,62271,62572,301,126.18584344153872,158.19502943385015
10827,CR_00250W_A,3093,CR,62794,63164,370,992.2139944524363,1243.9059547103755
10829,CR_00260W_A,4123,CR,63737,67375,3638,134.51719178235697,168.63976602278467
10831,CR_00270C_A,313,CR,67399,67866,467,79.55264231904233,99.73252347464751
10833,CR_00280C_A,673,CR,67793,69016,1223,65.31542534618465,81.88379419844472
10835,CR_00290W_A,5469,CR,72120,73049,929,698.7460431657507,875.9948648011695
10837,CR_00300W_A,328,CR,73423,74526,1103,35.295999408704205,44.249430150569914
10839,CR_00310C_A,136,CR,75931,76707,776,20.801963946209845,26.078736005573813
10841,CR_00320C_A,4651,CR,82153,83460,1307,422.37470761243685,529.5172380713177
10843,CR_00330C_A,685,CR,83900,86197,2297,35.396207185994854,44.37505733540813
10845,CR_00340C_A,105,CR,86887,87078,191,65.25038583065825,81.8022563032859
10847,CR_00350W_A,895,CR,88058,89263,1205,88.15828655065695,110.52113577368272
10849,CR_00360C_A,2624,CR,89445,91775,2330,133.6703428250669,167.57809942001242
10851,CR_00370W_A,994,CR,92310,94889,2579,45.74695526687638,57.35144876457852
10853,CR_00380W_A,180,CR,95282,96580,1298,16.459815576036615,20.635127828211672
10855,CR_00390W_A,342,CR,96952,102066,5114,7.93766076918684,9.951183466940874
10857,CR_00400C_A,1054,CR,102094,104001,1907,65.60199851730782,82.24306152990086
10859,CR_00410W_A,82,CR,104225,105304,1079,9.02027046983335,11.308415536626185
10861,CR_00420W_A,226,CR,105862,107451,1589,16.881525696102333,21.163811894798396
10863,CR_00430C_A,57,CR,107586,107855,269,25.15067978539126,31.5305776021906
10865,CR_00440C_A,2066,CR,108217,112623,4406,55.65612638845886,69.77424972616224
10867,CR_00450C_A,22,CR,112872,112934,62,42.11706931803777,52.800780489463484
10869,CR_00460C_A,220,CR,115600,116151,551,47.391257671839234,59.41285644912407
10871,CR_00470W_A,671,CR,116814,118070,1256,63.410332866568005,79.49544259998045
10873,CR_00480W_A,478,CR,118387,119088,701,80.9351229613129,101.4656938520127
10875,CR_00490W_A,1368,CR,119368,120249,881,184.30509499941655,231.05721793387346
10877,CR_00500C_A,4,CR,120697,120831,134,3.543091313050667,4.441856703319859
10879,CR_00510C_A,1981,CR,120977,121852,875,268.7222175470148,336.8881798065914
10881,CR_00520C_A,1597,CR,122317,125556,3239,58.522264187265876,73.36743213932104
10883,CR_00530W_A,4,CR,126526,127080,554,0.8569932056837354,1.074384112355345
10885,CR_00540C_A,1534,CR,127168,128181,1013,179.73930847617052,225.33324198114929
10887,CR_00550W_A,4,CR,129408,130007,599,0.7926114122684297,0.9936707817109535
10889,CR_00560W_A,1745,CR,130642,133365,2723,76.06326126796158,95.35800155502045
10891,CR_00570W_A,881,CR,134039,135571,1532,68.2565440389823,85.57097768500695
10893,CR_00580W_A,2208,CR,136149,136787,638,410.77645492747934,514.9768912714159
10895,CR_00590W_A,343,CR,137383,141375,3992,10.198369421996166,12.785359331036283
10897,CR_00600C_A,75,CR,141503,143776,2273,3.9164174764803357,4.909883399512163
10899,CR_00610W_A,314,CR,145023,149603,4580,8.137506009165932,10.20172285201345
10901,CR_00620C_A,2971,CR,149870,151120,1250,282.11085100077065,353.6730679170965
10903,CR_00630W_A,404,CR,152179,153792,1613,29.72857894037677,37.2697387617675
10905,CR_00640W_A,11412,CR,155196,162011,6815,198.7572846899334,249.17545141490663
10907,CR_00650W_A,10,CR,163014,164153,1139,1.04208568030902,1.3064284421528998
10909,CR_00660W_A,136,CR,164515,165780,1265,12.76073045237853,15.997706830296664
10911,CR_00670C_A,132,CR,165832,167064,1232,12.717167034342575,15.943092810130208
10913,CR_00680W_A,522,CR,167245,168624,1379,44.92968657818493,56.3268659687849
10915,CR_00690C_A,375,CR,168752,170080,1328,33.516629985089615,42.018693400192575
10917,CR_00700W_A,86,CR,170219,171604,1385,7.3701415688801255,9.239703366255968
10919,CR_00710C_A,49,CR,171645,172334,689,8.441196502717954,10.582449605949998
10921,CR_00720W_A,1,CR,171661,171984,323,0.3674723188458122,0.46068792433812783
10923,CR_00730C_A,1,CR,172432,172504,72,1.648521652599963,2.06669721612799
10925,CR_00740C_A,1375,CR,172978,174627,1649,98.9712817509984,124.0770311683875
10927,CR_00750C_A,254,CR,175807,177243,1436,20.99454316347363,26.320166217652286
10929,CR_00760C_A,447,CR,177792,181469,3677,14.429159876877133,18.089361763356877
10931,CR_00770W_A,1,CR,178149,178532,383,0.3099048537524735,0.38851749232693283
10933,CR_00780C_A,2903,CR,182254,184239,1985,173.58559281603723,217.61853165048265
10935,CR_00790C_A,10,CR,185398,185736,338,3.5116437570176737,4.402431939680926
10937,CR_00800C_A,909,CR,186234,189002,2768,38.978484508440175,48.86604024607828
10939,CR_00810W_A,122,CR,189237,189632,395,36.6597827757926,45.95916037080574
10941,CR_00820C_A,173,CR,189674,190655,981,20.931687772461917,26.241366487349897
10943,CR_00830W_A,23,CR,191176,192171,995,2.7436702077442607,3.4396488340783438
10945,CR_00840C_A,1,CR,191346,191900,554,0.21424830142093385,0.26859602808883626
10947,CR_00850C_A,1254,CR,192172,197094,4922,30.24008999795723,37.9110033014555
10949,CR_00860C_A,6072,CR,197957,198460,503,1432.8176742947562,1796.276253947712
10951,CR_00870C_A,97,CR,198806,199867,1061,10.851343281581663,13.603971119168596
10953,CR_00880W_A,244,CR,200121,201206,1085,26.692376398964196,33.463351790724914
10955,CR_00890C_A,153,CR,201467,201727,260,69.84659432708152,87.56437128025361
10957,CR_00900W_A,927,CR,202216,203886,1670,65.88558633600715,82.59858622350094
10959,CR_00910W_A,5194,CR,206330,206494,164,3759.111862070141,4712.674539761903
10961,CR_00920W_A,31,CR,207723,208721,998,3.6868740767566313,4.622112411220114
10963,CR_00930W_A,18,CR,210182,210634,452,4.726734649932638,5.925751309959901
10965,CR_00970W_A,35,CR,215621,216148,527,7.882873936531133,9.882499022092096
10967,CR_00980C_A,2196,CR,216776,218971,2195,118.74763350154234,148.8699909960951
10969,CR_00990W_A,77,CR,221203,221703,500,18.278808084028395,22.915538732427155
10971,CR_01000C_A,1272,CR,221874,225995,4121,36.63630357479133,45.92972527101816
10973,CR_01010W_A,30,CR,227653,228033,380,9.370544130568211,11.74754207062226
10975,CR_01020C_A,388,CR,228566,230386,1820,25.303901586281636,31.7226667196437
10977,CR_01030W_A,384,CR,231760,234396,2636,17.29071572499385,21.676799936079924
10979,CR_01040C_A,98,CR,234556,235158,602,19.322207276985615,24.223613882058302
10981,CR_01050C_A,770,CR,235391,237199,1808,50.54980111733516,63.37261817596004
10983,CR_01060W_A,562,CR,238178,239416,1238,53.881890267209144,67.54994842762761
10985,CR_01070W_A,50,CR,239879,240880,1001,5.928749200159708,7.432677300760004
10987,CR_01080W_A,394,CR,241115,247618,6503,7.191336650923537,9.015541538846506
10989,CR_01090W_A,708,CR,248128,250674,2546,33.00669275841937,41.379401920400795
10991,CR_01100C_A,303,CR,250793,251212,419,85.83328967331933,107.60636388317
10993,CR_01110W_A,1870,CR,251455,253125,1670,132.90835647069406,166.62282226315722
10995,CR_01120C_A,541,CR,253261,253995,734,87.48394470309778,109.675735643893
10997,CR_01130W_A,1244,CR,254233,258486,4253,34.7177962332644,43.52455590269265
10999,CR_01140C_A,2450,CR,258558,259598,1040,279.6146341525323,350.54364319709373
11001,CR_01150C_A,562,CR,259797,262358,2561,26.046770851544284,32.65397741249629
11003,CR_01160W_A,19,CR,269096,269497,401,5.623884341039275,7.050478283449102
11005,CR_01170W_A,1621,CR,269855,274990,5135,37.4687943755106,46.97339152652969
11007,CR_01180W_A,208,CR,275359,276201,842,29.320974191611697,36.758738133886915
11009,CR_01190C_A,31,CR,276255,276551,296,12.430744353388912,15.584014143235384
11011,CR_01200W_A,217,CR,277552,278730,1178,21.86460297132583,27.410931498118607
11013,CR_01210C_A,1316,CR,278915,280411,1496,104.41224841387147,130.89819159261987
11015,CR_01220W_A,52,CR,282664,284229,1565,3.943811544622532,4.9442264390946935
11017,CR_01230C_A,136,CR,288278,290905,2627,6.14477503702278,7.703501766397137
11019,CR_01240C_A,1057,CR,291720,295238,3518,35.662049985636045,44.70833568396946
11021,CR_01250C_A,3,CR,299565,299870,305,1.167477629382269,1.4636281924053962
11023,CR_01260W_A,537,CR,300879,303074,2195,29.038014203246004,36.40400053046588
11025,CR_01270C_A,236,CR,303468,305003,1535,18.24865141431829,22.8777323103888
11027,CR_01280C_A,220,CR,305767,306345,578,45.17747919927927,56.63751540392278
11029,CR_01290C_A,1497,CR,307230,310298,3068,57.91533826722114,72.60654913400889
11031,CR_01300W_A,664,CR,310826,311203,377,209.05178559018316,262.0813276091431
11033,CR_01310W_A,4131,CR,311996,313136,1140,430.1079755930809,539.2121810415617
11035,CR_01320C_A,404,CR,313501,316497,2996,16.00540648559003,20.065450141098456
11037,CR_01330W_A,805,CR,318322,321771,3449,27.703193674889498,34.7305800657519
11039,CR_01340W_A,75,CR,322485,324131,1646,5.40827273635468,6.780173127029858
11041,CR_01350C_A,740,CR,324493,325374,881,99.6972005113803,124.98709157241693
11043,CR_01360W_A,142,CR,325668,326258,590,28.566924366410216,35.81341074185181
11045,CR_01370C_A,2139,CR,326329,327291,962,263.9142647334877,330.8606079640743
11047,CR_01380W_A,505,CR,327526,330459,2933,20.436497541266508,25.620562829326193
11049,CR_01390W_A,2136,CR,330749,331477,728,348.2547280173813,436.59546464664265
11051,CR_01400W_A,3451,CR,332022,333152,1130,362.4880283759452,454.4392837927026
11053,CR_01410C_A,376,CR,333193,334479,1286,34.70356001491929,43.506708425363094
11055,CR_01420W_A,1765,CR,334910,336898,1988,105.37934185734574,132.1106047412198
11057,CR_01430W_A,187,CR,337258,337875,617,35.973574603899365,45.098883821632505
11059,CR_01440C_A,524,CR,338122,338310,188,330.8267282409118,414.74655622381283
11061,CR_01450C_A,1,CR,339491,339606,115,1.0321179042364987,1.2939321700975241
11063,CR_01460C_A,2,CR,340527,340859,332,0.7150214396819118,0.8963987925374416
11065,CR_01470W_A,2029,CR,341030,341995,965,249.56397013992066,312.8701170048765
11067,CR_01480W_A,1179,CR,342520,344247,1727,81.03051884534203,101.58528852499875
11069,CR_01490C_A,640,CR,344477,344854,377,201.4956969543934,252.6085085389331
11071,CR_01500W_A,1088,CR,345897,348482,2585,49.956902196545734,62.629320356906085
11073,CR_01510C_A,5,CR,349038,349379,341,1.7403747652081725,2.1818504334489046
11075,CR_01520W_A,1184,CR,349630,351381,1751,80.25880858985818,100.61782083408275
11077,CR_01530C_A,29,CR,352937,353272,335,10.274964807846935,12.881384439627592
11079,CR_01540W_A,497,CR,353346,355763,2417,24.406577913379017,30.597721630916013
11081,CR_01550C_A,61,CR,355983,357224,1241,5.83425229509995,7.31420964805329
11083,CR_01560W_A,108,CR,357404,358150,746,17.18351792307951,21.54240958795074
11085,CR_01570W_A,224,CR,358522,359118,596,44.60965975357753,55.92565889549031
11087,CR_01580C_A,650,CR,359334,361136,1802,42.81399186552624,53.67448929788564
11089,CR_01590C_A,1190,CR,361874,363512,1638,86.23036336676732,108.10416207438718
11091,CR_01600C_A,453,CR,363823,366783,2960,18.164926426081216,22.772769054469773
11093,CR_01610C_A,1246,CR,367035,368150,1115,132.6387215229129,166.28478982356435
11095,CR_01620C_A,24071,CR,368747,371050,2303,1240.5873462357047,1555.2834327564103
11097,CR_01630C_A,35,CR,372034,373998,1964,2.115211081747407,2.6517703587792947
11099,CR_01640C_A,36,CR,374212,375279,1067,4.004656160767671,5.020505327276243
11101,CR_01650W_A,350,CR,377249,377905,656,63.32735616694981,79.39141744881913
11103,CR_01660C_A,1135,CR,378021,378848,827,162.89865713478716,204.22067291654093
11105,CR_01670W_A,267,CR,379272,380720,1448,21.88617420551222,27.437974642848403
11107,CR_01680C_A,1366,CR,380831,383137,2306,70.3102348553823,88.14562211648746
11109,CR_01690C_A,7723,CR,384286,387579,3293,278.3693762703083,348.9825044674357
11111,CR_01700C_A,486,CR,387843,390590,2747,20.99929729442225,26.32612631479819
11113,CR_01710W_A,285,CR,390661,391524,863,39.19775702358198,49.14093496517539
11115,CR_01720W_A,636,CR,391750,394848,3098,24.367044388591843,30.548159754981576
11117,CR_01730W_A,7782,CR,395478,396188,710,1300.94827611038,1630.9559394160244
11119,CR_01740W_A,1267,CR,396471,396890,419,358.91345879899535,449.95796382830497
11121,CR_01750C_A,2315,CR,397246,397878,632,434.7715016698764,545.0586898484389
11123,CR_01760C_A,6237,CR,398686,400464,1778,416.36205140784585,521.9793693269403
11125,CR_01770C_A,1752,CR,400727,403447,2720,76.45261593587124,95.8461226585475
11127,CR_01780W_A,230,CR,404537,405496,959,28.466651269088004,35.68770166744475
11129,CR_01790C_A,360,CR,405497,407908,2411,17.72280432824183,22.218495164677517
11131,CR_01800C_A,176,CR,408029,409024,995,20.995041589695212,26.320791078164717
11133,CR_01810C_A,42,CR,409235,410230,995,5.010180379359085,6.28109787092567
11135,CR_01820W_A,1377,CR,410663,413719,3056,53.48201267191451,67.04863507715754
11137,CR_01830C_A,9,CR,414010,415965,1955,0.5464153610663817,0.6850229135810423
11139,CR_01870C_A,1,CR,418960,419550,590,0.20117552370711414,0.2522071179003649
11141,CR_01900C_A,169,CR,420757,422253,1496,13.40856381606708,16.80987414829237
11143,CR_01910C_A,45,CR,422477,423115,638,8.371802749880692,10.49545294710766
11145,CR_01920W_A,35,CR,423365,424666,1301,3.193139557687861,4.00313373147005
11147,CR_01930C_A,612,CR,425221,426345,1124,64.62674208199714,81.02041470770797
11149,CR_01950W_A,941,CR,427487,428386,899,124.23875306668822,155.75402645951453
11151,CR_01960C_A,299,CR,428526,429932,1406,25.24137563099005,31.644279992036537
11153,CR_01970C_A,2054,CR,430298,431046,748,325.9312435290152,408.6092485277222
11155,CR_01980C_A,1056,CR,431374,432228,854,146.76861626519954,183.99897275953552
11157,CR_01990C_A,132,CR,433224,435581,2357,6.647242166444655,8.333428231684522
11159,CR_02000C_A,2076,CR,436061,437755,1694,145.45916673991837,182.35735908446455
11161,CR_02020C_A,365,CR,440887,443238,2351,18.427541059262882,23.10200035722824
11163,CR_02030C_A,330,CR,445207,446703,1496,26.18240271776412,32.82401460909161
11165,CR_02040W_A,1935,CR,447150,449222,2072,110.84557752906703,138.96344408829708
11167,CR_02050C_A,959,CR,449417,451918,2501,45.51264416982097,57.05770067141362
11169,CR_02060W_A,409,CR,452957,453880,923,52.59552072130413,65.93726936136191
11171,CR_02070C_A,6931,CR,454017,455027,1010,814.5198587527375,1021.136678375033
11173,CR_02080W_A,6,CR,456551,456671,120,5.934677949359868,7.4401099780607645
11175,CR_02090C_A,1670,CR,456872,458434,1562,126.90028393637618,159.0906999149997
11177,CR_02100C_A,219,CR,458808,459412,604,43.036240758603014,53.953115403818124
11179,CR_02110W_A,1057,CR,459667,462309,2642,47.486408724249664,59.53214418478598
11181,CR_02120C_A,156,CR,462365,463117,752,24.622600002663283,30.868541398337214
11183,CR_02130W_A,1368,CR,463707,464792,1085,149.65233981058617,187.61420184308068
11185,CR_02140W_A,588,CR,465453,466273,820,85.11196668838055,106.70206505121291
11187,CR_02150W_A,527,CR,467256,469313,2057,30.409093624819157,38.122877573534495
11189,CR_02160W_A,882,CR,470534,475072,4538,23.069131561636862,28.921009258041405
11191,CR_02170W_A,940,CR,475602,476831,1229,90.78270581608261,113.81128363510363
11193,CR_02180W_A,5,CR,478027,479415,1388,0.4275704574466764,0.5360309782464527
11195,CR_02190C_A,874,CR,479677,482430,2753,37.68186362325118,47.24050941391288
11197,CR_02200C_A,939,CR,484025,485110,1085,102.72189114191549,128.7790464405356
11199,CR_02210W_A,1065,CR,490308,493292,2984,42.36214487981407,53.108023636961896
11201,CR_02220C_A,68,CR,493892,496609,2717,2.970615388711601,3.7241625212229077
11203,CR_02230W_A,3,CR,497838,498158,320,1.1127521155049753,1.3950206208863933
11205,CR_02240C_A,26,CR,499907,502696,2789,1.1065014462772074,1.3871843630661878
11207,CR_02250C_A,778,CR,504777,507014,2237,41.28010232098326,51.751502574262624
11209,CR_02260C_A,321,CR,507449,508468,1019,37.3902182874292,46.87488327688921
11211,CR_02270C_A,276,CR,508632,509357,725,45.185410042022724,56.64745803985575
11213,CR_02280W_A,2921,CR,510499,511347,848,408.8489219358531,512.56040674329
11215,CR_02290W_A,61,CR,511771,512280,509,14.224571902198504,17.832876568239946
11217,CR_02300C_A,4159,CR,512524,514905,2381,207.3273884198882,259.91950775938443
11219,CR_02310C_A,2,CR,515738,515811,73,3.2518783284163657,4.076772590718226
11221,CR_02320W_A,1,CR,516594,516683,89,1.3336354942381725,1.671934826530509
11223,CR_02330C_A,222,CR,516753,517862,1109,23.760117308528237,29.78727529539206
11225,CR_02340W_A,13,CR,518245,519572,1327,1.162785430922054,1.457745737977241
11227,CR_02350C_A,966,CR,520042,522621,2579,44.458308639640414,55.735914996562215
11229,CR_02360W_A,3698,CR,525541,526779,1238,354.5466729682196,444.48346847930054
11231,CR_02370W_A,1368,CR,527702,528628,926,175.3485839033326,219.82873542088825
11233,CR_02380C_A,77,CR,528825,529232,407,22.45553818676707,28.151767484554245
11235,CR_02390W_A,849,CR,530045,532714,2669,37.75602532039361,47.333483487250575
11237,CR_02400W_A,20,CR,533719,535104,1385,1.713986411367471,2.14876822471069
11239,CR_02410W_A,788,CR,535397,538387,2990,31.28111186686004,39.21609807834035
11241,CR_02420W_A,636,CR,538766,539575,809,93.3116236289957,116.98170447581326
11243,CR_02430C_A,1579,CR,539688,542237,2549,73.52574721097866,92.17680388668454
11245,CR_02440W_A,112,CR,542623,542955,332,40.041200622187056,50.198332382096716
11247,CR_02460W_A,609,CR,544683,546848,2165,33.38770319778439,41.857062139852246
11249,CR_02470W_A,1172,CR,547329,547457,128,1086.7878994765258,1362.4701397323774
11251,CR_02480W_A,3,CR,548257,548727,470,0.7576184616204087,0.9498012737949911
11253,CR_02490W_A,72,CR,550905,552005,1100,7.7690329518892804,9.73978033491591
11255,CR_02500W_A,144,CR,552462,554012,1550,11.02701451235898,13.82420434633226
11257,CR_02510W_A,1407,CR,556957,560259,3302,50.575965322527765,63.40541937693214
11259,CR_02520W_A,140,CR,560832,561227,395,42.06860318533577,52.74002009764593
11261,CR_02530W_A,3892,CR,561929,564680,2751,167.92269413964817,210.5191423817702
11263,CR_02540W_A,263,CR,566051,568717,2666,11.709079524993589,14.679286753413212
11265,CR_02550C_A,202,CR,568818,569693,875,27.40125590333013,34.35205064156056
11267,CR_02560C_A,512,CR,570071,573043,2972,20.447880956071682,25.63483384096306
11269,CR_02570C_A,247,CR,574720,575925,1205,24.329717070404772,30.501363727485625
11271,CR_02580W_A,316,CR,576979,577929,950,39.48122593679407,49.496310590888456
11273,CR_02590C_A,528,CR,578065,581277,3212,19.511269970498198,24.460635544309362
11275,CR_02600W_A,8,CR,581329,581982,653,1.4541324225077776,1.822997850673388
11277,CR_02610C_A,989,CR,582048,583778,1730,67.85429470424172,85.06669096303
11279,CR_02620C_A,701,CR,584443,584970,527,157.88270370023784,197.93233755675885
11281,CR_02630C_A,19,CR,585248,586093,845,2.6688492553334315,3.3458482741575035
11283,CR_02640W_A,1149,CR,600287,602089,1802,75.68196408229177,94.87998185118555
11285,CR_02650C_A,455,CR,609126,610355,1229,43.9426927088485,55.08950431273633
11287,CR_02660C_A,2,CR,612660,612749,89,2.667270988476345,3.343869653061018
11289,CR_02670C_A,626,CR,613118,614518,1400,53.07297708998968,66.53584066094342
11291,CR_02680W_A,207,CR,615879,618245,2366,10.38443225289512,13.018620164485021
11293,CR_02690W_A,155,CR,618837,619685,848,21.69516703185801,27.198515249986286
11295,CR_02700W_A,76,CR,620000,620383,383,23.552768885187984,29.5273294168469
11297,CR_02710W_A,525,CR,620810,622459,1649,37.789034850381206,47.3748664461116
11299,CR_02720C_A,404,CR,622652,623521,869,55.18089508725861,69.17846792028881
11301,CR_02740W_A,1843,CR,627510,629489,1979,110.53675048681392,138.57627781269315
11303,CR_02750C_A,3,CR,630053,630646,593,0.6004733169672716,0.7527935896857434
11305,CR_02760C_A,490,CR,632985,634427,1442,40.332762762639874,50.56385421983044
11307,CR_02770C_A,199,CR,634965,636134,1169,20.20531928011315,25.330742269188917
11309,CR_02780W_A,70,CR,636866,637357,491,16.921688653979256,21.214162870234357
11311,CR_02790C_A,159,CR,637548,638519,971,19.435917486060124,24.3661686202196
11313,CR_02800C_A,120,CR,638889,641339,2450,5.813562072842319,7.2882709989166665
11315,CR_02810W_A,410,CR,641816,643483,1667,29.192776955459458,36.59802148776141
11317,CR_02820W_A,1239,CR,644421,646103,1682,87.43241354645512,109.6111327326669
11319,CR_02850C_A,2591,CR,647406,649544,2138,143.84238135445665,180.33044857956446
11321,CR_02860W_A,1831,CR,653851,654447,596,364.64413843214487,457.1423278466195
11323,CR_02870W_A,762,CR,655163,657649,2486,36.38153336614819,45.610328264539845
11325,CR_02880W_A,70,CR,658227,658640,413,20.117552370711415,25.220711790036486
11327,CR_02890C_A,310,CR,658855,660642,1787,20.59037676890385,25.813476141005452
11329,CR_02910W_A,667,CR,664676,666961,2285,34.64709139801341,43.43591558307685
11331,CR_02920C_A,225,CR,667781,668602,821,32.52868547152181,40.78013995283001
11333,CR_02930W_A,3479,CR,672970,678726,5756,71.73990474573655,89.93795209754482
11335,CR_02940C_A,214,CR,678887,679966,1079,23.54070586029679,29.51220640046346
11337,CR_02950C_A,760,CR,680604,681185,581,155.26179833092942,194.6465949509873
11339,CR_02960W_A,115,CR,681670,682533,863,15.81663879898922,19.828798319281297
11341,CR_02970C_A,1307,CR,682676,685207,2531,61.29295993530896,76.84096200178126
11343,CR_02980C_A,997,CR,685569,686855,1286,92.01981206083651,115.36220292576333
11345,CR_02990C_A,652,CR,686998,688026,1028,75.28035064168549,94.37649232870852
11347,CR_03000C_A,347,CR,689760,690260,500,82.37332993711496,103.2687264954834
11349,CR_03010C_A,604,CR,690457,691064,607,118.10693513717827,148.0667685913905
11351,CR_03020C_A,430,CR,691388,692170,782,65.26627923848447,81.82218134440227
11353,CR_03030C_A,12368,CR,692731,693531,800,1835.0024219420711,2300.482005216388
11355,CR_03040C_A,472,CR,693874,695364,1490,37.59957036372963,47.13734106905612
11357,CR_03050C_A,1045,CR,695733,697517,1784,69.52621588655899,87.16272339768496
11359,CR_03060W_A,3248,CR,698441,699550,1109,347.6255000815302,435.80662233979007
11361,CR_03070W_A,484,CR,699794,700975,1181,48.64325364081586,60.98244249587486
11363,CR_03080C_A,202,CR,700998,701573,575,41.69756333115455,52.27485967193998
11365,CR_03090C_A,381,CR,701827,702325,498,90.8077228396028,113.84264665225508
11367,CR_03100W_A,1309,CR,702956,706177,3221,48.23653173369802,60.47254865744515
11369,CR_03110W_A,1047,CR,706382,707911,1529,81.27675360339806,101.89398491863466
11371,CR_03120W_A,1672,CR,708144,709112,968,205.0161473415227,257.02198106028095
11373,CR_03130W_A,56,CR,709559,709993,434,15.315297933831916,19.20028381435036
11375,CR_03140C_A,180,CR,710184,710984,800,26.706050772119408,33.48049490127344
11377,CR_03150W_A,1627,CR,711420,714107,2687,71.86989969191295,90.10092247342659
11379,CR_03160W_A,148,CR,714284,715111,827,21.24141079819251,26.62965602788375
11381,CR_03170W_A,4880,CR,715385,717121,1736,333.65470498705247,418.29189738406143
11383,CR_03180W_A,184,CR,717480,718601,1121,19.482261243215266,24.424268259824807
11385,CR_03190C_A,6,CR,718810,719053,243,2.9307051601777125,3.674128384227538
11387,CR_03200C_A,488,CR,719189,721528,2339,24.763769468042884,31.04552090033051
11389,CR_03210C_A,398,CR,721748,722428,680,69.4706418778008,87.09305209612305
11391,CR_03220C_A,204,CR,722592,723932,1340,18.069765696558402,22.653469186931282
11393,CR_03230W_A,977,CR,724231,726348,2117,54.777329773496376,68.67253139882254
11395,CR_03240C_A,282,CR,726435,728183,1748,19.14850322333504,24.005846839967226
11397,CR_03250C_A,593,CR,728528,729391,863,81.55884180696181,102.24762959420703
11399,CR_03260W_A,218,CR,731819,732900,1081,23.936351396123058,30.00821415758088
11401,CR_03270W_A,215,CR,734584,736089,1505,16.956222712456764,21.257457080173612
11403,CR_03280W_A,1337,CR,737211,738287,1076,147.48446874152683,184.89641339530192
11405,CR_03290C_A,259,CR,738489,740051,1562,19.68094223923439,24.673348070649652
11407,CR_03300C_A,22,CR,740776,741861,1085,2.406689675316444,3.0171874565407704
11409,CR_03310C_A,387,CR,742230,743781,1551,29.615994408797793,37.128595248349654
11411,CR_03320C_A,1,CR,743131,743781,650,0.182605475364919,0.22892646086340815
11413,CR_03330W_A,428,CR,744085,745158,1073,47.344681497223185,59.35446543541486
11415,CR_03340C_A,225,CR,745188,746252,1064,25.099671778307712,31.466630546309624
11417,CR_03350C_A,1589,CR,746467,748209,1742,108.2686941622598,135.73289041490878
11419,CR_03360W_A,294,CR,748450,749193,743,46.966226570977156,58.88000897846204
11421,CR_03370C_A,271,CR,749202,750068,866,37.14313450985044,46.56512249548423
11423,CR_03380W_A,340,CR,750308,751414,1106,36.488074191362664,45.74389498265207
11425,CR_03390C_A,335,CR,751411,753240,1829,21.73993562641395,27.254640160200722
11427,CR_03400W_A,2673,CR,753492,756413,2921,108.61618732378587,136.16853112876703
11429,CR_03410W_A,152,CR,756742,757680,938,19.23392427084648,24.112936389450663
11431,CR_03420C_A,1923,CR,757726,759538,1812,125.9645220377376,157.91756609062747
11433,CR_03430W_A,125,CR,759808,760161,353,42.03029709178377,52.691997011761785
11435,CR_03440W_A,58,CR,760304,761083,779,8.837261131267582,11.078982765790098
11437,CR_03450W_A,1,CR,762146,763934,1788,0.06638342225234752,0.08322270668971772
11439,CR_03460W_A,780,CR,764417,765511,1094,84.62612066728879,106.09297592115898
11441,CR_03470W_A,1381,CR,767511,769010,1499,109.350103376464,137.08861747434176
11443,CR_03480W_A,334,CR,770493,772619,2126,18.647059596295353,23.37720350585414
11445,CR_03490W_A,478,CR,773209,775044,1835,30.918540161242692,38.761553891150356
11447,CR_03500W_A,22004,CR,777835,779331,1496,1745.810876974793,2188.6655074498535
11449,CR_03510W_A,154,CR,780328,782037,1709,10.695616198963368,13.40874121265486
11451,CR_03520C_A,1459,CR,782046,783887,1841,94.06512903982669,117.92634935351066
11453,CR_03530W_A,4333,CR,784375,786078,1703,301.9960018153413,378.6024255424227
11455,CR_03540W_A,207,CR,786518,787492,974,25.225427834034758,31.624286765063207
11457,CR_03550W_A,553,CR,787654,789012,1358,48.333975051487585,60.594710130597974
11459,CR_03560W_A,263,CR,789311,790126,815,38.30233866703424,48.018378508711194
11461,CR_03570C_A,199,CR,790132,791100,968,24.400845287657308,30.590534827150663
11463,CR_03580C_A,205,CR,791587,792717,1130,21.532902294137575,26.995089300928438
11465,CR_03590C_A,39,CR,794436,795215,779,5.942296277921306,7.449660825272652
11467,CR_03600C_A,348,CR,795625,796227,602,68.61355237133668,86.01854725465601
11469,CR_03610C_A,882,CR,796561,798915,2354,44.47226806572136,55.753415468560696
11471,CR_03620C_A,624,CR,801143,803746,2603,28.45362305340421,35.67136862320336
11473,CR_03630W_A,169,CR,804770,807595,2825,7.100605829676584,8.901795301184206
11475,CR_03640C_A,579,CR,808438,809547,1109,61.96895460197229,77.68843421636036
11477,CR_03650W_A,1857,CR,809883,812918,3035,72.62403263236425,91.04635406430867
11479,CR_03660C_A,782,CR,812990,814756,1766,52.55852951754719,65.89089470943962
11481,CR_03670W_A,10,CR,816393,818339,1946,0.6099360687934089,0.764656729502648
11483,CR_03680C_A,1296,CR,818425,822147,3722,41.32908448345185,51.81290989557631
11485,CR_03690W_A,351,CR,823246,825456,2210,18.851329956790167,23.633290518545955
11487,CR_03700C_A,1072,CR,825518,829063,3545,35.89266438202414,44.99744934545072
11489,CR_03710C_A,936,CR,829626,830528,902,123.16759557873252,154.41115165110588
11491,CR_03720W_A,12311,CR,831859,832830,971,1504.877862709976,1886.6157351165
11493,CR_03730C_A,679,CR,833215,834933,1718,46.9109002050681,58.81064813857112
11495,CR_03740C_A,620,CR,836037,836567,530,138.84906900389126,174.07049759991222
11497,CR_03750C_A,300,CR,836856,838037,1181,30.150777050092472,37.79903460488111
11499,CR_03760W_A,528,CR,839136,839924,788,79.53070957517792,99.70502711715947
11501,CR_03770C_A,2847,CR,840282,840809,527,641.2154884944039,803.8707061684628
11503,CR_03780C_A,497,CR,841232,841969,737,80.04165375391734,100.34558097954408
11505,CR_03790C_A,995,CR,844006,844398,392,301.2757428374015,377.69946062094186
11507,CR_03800C_A,224,CR,847829,848824,995,26.72096202324845,33.49918864493691
11509,CR_03810W_A,127,CR,849445,852048,2603,5.7910418714460485,7.260038165299401
11511,CR_03820C_A,255,CR,852102,853577,1475,20.519903418125647,25.725126025837216
11513,CR_03830C_A,931,CR,853958,856669,2711,40.761233278155935,51.10101357118828
11515,CR_03840C_A,134,CR,857988,858500,512,31.06432989118056,38.944325666411814
11517,CR_03850W_A,414,CR,860662,862605,1943,25.290341441430627,31.7056668133521
11519,CR_03860C_A,710,CR,862757,864421,1664,50.644487308239256,63.49132313008585
11521,CR_03870W_A,728,CR,864747,865049,302,286.12222166450226,358.7019909952475
11523,CR_03880W_A,85,CR,866454,869279,2825,3.571310624393549,4.477234323080814
11525,CR_03890W_A,79,CR,878579,880504,1925,4.871060342851217,6.106687670304419
11527,CR_03900W_A,649,CR,884029,885798,1769,43.545573647649,54.591649245465646
11529,CR_03910C_A,774,CR,885976,888228,2252,40.794322671443496,51.142496652034026
11531,CR_03920C_A,283,CR,888806,890914,2108,15.93466660027365,19.976765880371882
11533,CR_03930C_A,331,CR,892917,894218,1301,30.19797695984806,37.85820757475962
11535,CR_03940W_A,175,CR,894731,895831,1100,18.883066202508672,23.673077202920613
11537,CR_03950W_A,383,CR,896166,896951,785,57.91036062687463,72.60030883050376
11539,CR_03960C_A,218,CR,897030,898727,1697,15.247610995408973,19.115426932436613
11541,CR_03970C_A,93,CR,899035,899762,727,15.183632717757021,19.035219476193976
11543,CR_03980W_A,483,CR,900136,900864,728,78.74861125112132,98.72453624734476
11545,CR_03990C_A,1391,CR,901285,902727,1442,114.4956591894532,143.53943106078395
11547,CR_04000W_A,2793,CR,903050,904336,1286,257.7846891533765,323.17616125542327
11549,CR_04010C_A,1999,CR,904414,905430,1016,233.53191379469243,292.7712568138478
11551,CR_04020C_A,231,CR,905753,906449,696,39.393982939716366,49.38693692333438
11553,CR_04030W_A,687,CR,906681,909368,2687,30.34703201496263,38.04507298048191
11555,CR_04040C_A,290,CR,909343,910701,1358,25.346930858827122,31.7766110992286
11557,CR_04050C_A,1609,CR,911098,912951,1853,103.06418586637915,129.2081700453294
11559,CR_04060C_A,1328,CR,913389,913856,467,337.52686581370045,423.14629768157147
11561,CR_04070W_A,581,CR,914672,915199,527,130.8557073464168,164.0494837667288
11563,CR_04080C_A,2421,CR,915381,917402,2021,142.18560430876042,178.25340184943207
11565,CR_04090C_A,8900,CR,917825,919603,1778,594.1353627593118,744.8479055651383
11567,CR_04100C_A,7586,CR,920395,921009,614,1466.464720646383,1838.4584460445917
11569,CR_04110W_A,802,CR,921803,923548,1745,54.55142367205288,68.38932037140096
11571,CR_04120C_A,3056,CR,923584,926355,2771,130.9013050396518,164.1066480906077
11573,CR_04130C_A,1644,CR,926631,927968,1337,145.9478017763294,182.96994471102315
11575,CR_04140W_A,2601,CR,928306,929691,1385,222.90393279833955,279.44730762362525
11577,CR_04150W_A,202,CR,929946,930866,920,26.060977081971593,32.671787294962485
11579,CR_04160C_A,637,CR,930968,932329,1361,55.55312055462506,69.6451147101353
11581,CR_04170W_A,2205,CR,932629,934485,1856,141.0125525683029,176.7827855778447
11583,CR_04180C_A,3080,CR,934581,936911,2330,156.8996402062523,196.6999032826365
11585,CR_04190W_A,3187,CR,937197,938834,1637,231.07903023347467,289.69615760634883
11587,CR_04200W_A,2844,CR,939255,940436,1181,285.8293664348766,358.3348480542729
11589,CR_04210C_A,694,CR,941149,942678,1529,53.873989494515996,67.54004348952479
11591,CR_04220C_A,109,CR,943890,945383,1493,8.66550430650001,10.863656900316455
11593,CR_04230W_A,293,CR,947438,948166,728,47.770896680286846,59.88879735087374
11595,CR_04240C_A,2425,CR,948342,951470,3128,92.01786462402609,115.35976148847412
11597,CR_04250W_A,24,CR,952020,953492,1472,1.9352210704434352,2.426122818932858
11599,CR_04260W_A,114,CR,953783,954152,369,36.66955480905284,45.97141124655432
11601,CR_04270C_A,116,CR,954290,954736,446,30.870970498912317,38.701917374665854
11603,CR_04275W_A,302,CR,955228,955492,264,135.77823793232426,170.22069798290536
11605,CR_04280C_A,227,CR,955596,957281,1685,15.990170854655073,20.046349733172622
11607,CR_04290W_A,253,CR,957628,957945,317,94.73019061123321,118.76011510721598
11609,CR_04300W_A,7287,CR,958467,960608,2141,403.9794321997698,506.4556880908808
11611,CR_04310C_A,119,CR,960689,961276,587,24.06223768224274,30.166033641881803
11613,CR_04330W_A,409,CR,961901,963100,1199,40.488461739586086,50.7590488911902
11615,CR_04340W_A,9662,CR,963533,966769,3236,354.3934384840237,444.29136346120583
11617,CR_04350C_A,291,CR,966882,968228,1346,25.661088904364362,32.17046067779617
11619,CR_04360C_A,681,CR,968673,969152,479,168.74804524067096,211.55385783128935
11621,CR_04370W_A,112,CR,969415,970200,785,16.93462242874663,21.230377517014155
11623,CR_04380C_A,3698,CR,970313,973171,2858,153.57899969722038,192.53692581433663
11625,CR_04390C_A,534,CR,973585,975972,2387,26.553146417747545,33.288803756049
11627,CR_04400W_A,12,CR,977144,977368,224,6.3585835171712874,7.971546405065104
11629,CR_04410W_A,19,CR,977512,978837,1325,1.7020208458541506,2.133767389934408
11631,CR_04420C_A,279,CR,979245,979751,506,65.44565801863254,82.04706260391119
11633,CR_04430W_A,7,CR,980798,981112,314,2.646034754491661,3.317246487033462
11635,CR_04440C_A,104,CR,982073,982408,335,36.84814965572694,46.19530971452654
11637,CR_04450C_A,1526,CR,984184,986580,2396,75.59531344510148,94.77135080568219
11639,CR_04460C_A,240,CR,986837,987634,797,35.742100573309116,44.80869246510874
11641,CR_04470W_A,87,CR,987812,988726,914,11.297964586308721,14.163885516220711
11643,CR_04480C_A,1040,CR,988875,990404,1529,80.73335601483666,101.21274528689595
11645,CR_04490C_A,225,CR,990786,991736,950,28.111632391704635,35.24262621186678
11647,CR_04500C_A,915,CR,992082,993203,1121,96.88189694316289,121.45763835728098
11649,CR_04510W_A,14371,CR,995376,996830,1454,1173.139708531646,1470.726554260127
11651,CR_04520W_A,119,CR,997160,997549,389,36.30985480585215,45.52046721795532
11653,CR_04530W_A,1115,CR,997809,999197,1388,95.34821201060883,119.53490814895898
11655,CR_04540C_A,102,CR,999194,999619,425,28.486454156927365,35.71252789469167
11657,CR_04550W_A,1076,CR,999810,1000746,936,136.44686909212004,171.05893881182442
11659,CR_04560C_A,634,CR,1000795,1001913,1118,67.30922754730155,84.38335824848882
11661,CR_04570C_A,1708,CR,1002171,1003244,1073,188.93625233004013,236.8631471114219
11663,CR_04580W_A,2010,CR,1004038,1004661,623,382.94390620267524,480.08414304661756
11665,CR_04590C_A,1222,CR,1004818,1005627,809,179.28742779030307,224.7667340714525
11667,CR_04600W_A,519,CR,1006481,1008139,1658,37.15437702916491,46.57921687109212
11669,CR_04610C_A,157,CR,1008189,1009691,1502,12.406716884813571,15.5538916984759
11671,CR_04620C_A,4,CR,1009945,1011462,1517,0.3129691733347326,0.3923591287045887
11673,CR_04630C_A,92,CR,1011959,1013122,1163,9.389344305092138,11.771111229262086
11675,CR_04640W_A,74,CR,1014145,1015671,1526,5.755782021659635,7.215834054737831
11677,CR_04650W_A,97,CR,1015922,1016209,287,40.11594153922698,50.29203260431318
11679,CR_04660C_A,3614,CR,1016385,1018027,1642,261.2414873201774,327.50983508783924
11681,CR_04670C_A,3,CR,1018393,1018749,356,1.0002266206786294,1.2539511198978819
11683,CR_04680C_A,6,CR,1019056,1019358,302,2.35815017855359,2.956335090620171
11685,CR_04690C_A,1,CR,1019991,1020106,115,1.0321179042364987,1.2939321700975241
11687,CR_04700C_A,1,CR,1020200,1020314,114,1.0411715700631345,1.3052824522913622
11689,CR_04710W_A,20,CR,1020906,1021310,404,5.875918761742444,7.36644552283244
11691,CR_04720C_A,993,CR,1021410,1025573,4163,28.311963505713905,35.49377472118347
11693,CR_04730W_A,193,CR,1026934,1027266,332,68.99956892930449,86.50248347986312
11695,CR_04740C_A,2279,CR,1027449,1031561,4112,65.78371131610476,82.47086887159767
11697,CR_04750W_A,49,CR,1032104,1032370,266,21.86460297132583,27.410931498118607
11699,CR_04760C_A,255,CR,1032764,1034449,1685,17.962526731000196,22.519027233299642
11701,CR_04770C_A,92,CR,1034922,1035491,569,19.19122570619008,24.059406607437275
11703,CR_04780W_A,297,CR,1036032,1036478,446,79.04032963945653,99.09025396789448
11705,CR_04790W_A,261,CR,1037049,1037616,567,54.63671762902735,68.49625059167053
11707,CR_04800W_A,159,CR,1038242,1040401,2159,8.74121161600944,10.958568656893576
11709,CR_04810W_A,5337,CR,1040990,1041745,755,839.0298335293674,1051.864025242657
11711,CR_04820W_A,1180,CR,1043307,1043612,305,459.20786755702585,575.6937556794559
11713,CR_04830C_A,198,CR,1044383,1046803,2420,9.711291189861601,12.174725418644886
11715,CR_04840C_A,635,CR,1048237,1050153,1916,39.337374716529396,49.31596906125872
11717,CR_04850C_A,17,CR,1051306,1052082,776,2.6002454932762307,3.2598420006967266
11719,CR_04860C_A,90,CR,1052051,1053439,1388,7.696268234040175,9.64855760843615
11721,CR_04870C_A,730,CR,1054455,1055960,1505,57.57229107020205,72.17648217919412
11723,CR_04880W_A,264,CR,1056963,1058072,1109,28.255274637168714,35.42270575668245
11725,CR_04890W_A,18,CR,1058318,1059307,989,2.160246776308951,2.7082301234599346
11727,CR_04900C_A,51,CR,1059951,1060796,845,7.163753264316053,8.980961156949087
11729,CR_04910W_A,54,CR,1062959,1064113,1154,5.554118011532632,6.963014537526538
11731,CR_04920W_A,624,CR,1064625,1065713,1088,68.07424706618673,85.34243798363818
11733,CR_04930W_A,992,CR,1066170,1067528,1358,86.70398417916036,108.69792486356818
11735,CR_04940W_A,115,CR,1068772,1069845,1073,12.721117692010901,15.948045619328758
11737,CR_04950W_A,161,CR,1070692,1073802,3110,6.144586172649123,7.703264993361948
11739,CR_04960C_A,194,CR,1073848,1074759,911,25.276125624057396,31.68784491204804
11741,CR_04970C_A,1,CR,1075494,1076363,869,0.13658637397836287,0.17123383148586338
11743,CR_04980C_A,1,CR,1077754,1078335,581,0.20429183990911765,0.2561139407249833
11745,CR_04990C_A,1,CR,1079939,1080766,827,0.1435230459337332,0.17993010829651182
11747,CR_05000C_A,1,CR,1081690,1082016,326,0.36409067173986914,0.4564484649117033
11749,CR_05010W_A,322,CR,1082017,1084071,2054,18.607266793513897,23.327316581651083
11751,CR_05020W_A,85,CR,1084330,1085919,1589,6.349246390126983,7.959840756893202
11753,CR_05030W_A,904,CR,1087249,1090161,2912,36.84717627899259,46.194089424223435
11755,CR_05040W_A,30,CR,1091568,1091867,299,11.90905274119037,14.929986578048355
11757,CR_05050W_A,9393,CR,1095486,1096607,1121,994.5482600952226,1246.8323465463827
11759,CR_05070W_A,4,CR,1098929,1099026,97,4.894579752049375,6.136173177782074
11761,CR_05080W_A,424,CR,1099596,1101072,1476,34.096252717189486,42.7453472994277
11763,CR_05090C_A,27,CR,1101386,1103358,1972,1.6251146514474282,2.037352630909134
11765,CR_05100W_A,655,CR,1105182,1109018,3836,20.267018023100693,25.40809194801773
11767,CR_05120W_A,853,CR,1110467,1113241,2774,36.49805544919948,45.75640815635064
11769,CR_05130C_A,228,CR,1113311,1114213,902,30.00236302558869,37.612972838089895
11771,CR_05140W_A,72,CR,1114420,1115133,713,11.98588533952063,15.02630907210028
11773,CR_05150W_A,206,CR,1115354,1115629,275,88.91226600495511,111.46637494403764
11775,CR_05160C_A,90,CR,1115649,1116845,1196,8.931789555892777,11.197489933536268
11777,CR_05170C_A,328,CR,1117036,1118175,1139,34.180410314135855,42.85085290261512
11779,CR_05180C_A,3190,CR,1119608,1120399,791,478.675667723337,600.099894564193
11781,CR_05190W_A,1,CR,1122154,1122981,827,0.1435230459337332,0.17993010829651182
11783,CR_05200C_A,258,CR,1124185,1124604,419,73.08577140500458,91.62522073220416
11785,CR_05210W_A,71,CR,1125688,1126713,1025,8.221700183503428,10.307274311069547
11787,CR_05220C_A,1209,CR,1126971,1128866,1895,75.72586428259714,94.93501808417376
11789,CR_05240C_A,1067,CR,1129264,1132713,3449,36.719636833673405,46.0341974287668
11791,CR_05250C_A,198,CR,1132887,1134713,1826,12.870385914274411,16.135178265673947
11793,CR_05260C_A,213,CR,1135405,1136463,1058,23.895773217649374,29.957342633779636
11795,CR_05270W_A,7,CR,1136783,1137096,313,2.654488539649781,3.327844718621428
11797,CR_05280W_A,3,CR,1137083,1137402,319,1.1162403666507588,1.3993937262810217
11799,CR_05290W_A,99,CR,1138119,1139255,1136,10.343892904694135,12.967797320915768
11801,CR_05300C_A,1350,CR,1139330,1141312,1982,80.84576419410516,101.35366771323946
11803,CR_05310W_A,261,CR,1142603,1143064,461,67.19960714893385,84.24593077110019
11805,CR_05320C_A,12,CR,1146067,1146381,314,4.536059579128562,5.686708263485935
11807,CR_05330W_A,153,CR,1147599,1147784,185,98.16278121643889,123.06344071819426
11809,CR_05340C_A,150,CR,1148612,1149919,1307,13.622061092639331,17.077528641302443
11811,CR_05350W_A,14,CR,1151638,1151704,66,25.177421603344893,31.564102937227485
11813,CR_05360C_A,595,CR,1151763,1153322,1559,45.299979215768076,56.79108963369025
11815,CR_05370W_A,163,CR,1153825,1155368,1543,12.538593723210091,15.71922134055612
11817,CR_05380C_A,2769,CR,1155586,1156452,866,379.51785777777076,475.78901915127614
11819,CR_05390W_A,9202,CR,1157977,1158576,599,1823.4025539235229,2285.9396333260484
11821,CR_05400C_A,3,CR,1158859,1158954,95,3.748217652227285,4.6990168282489035
11823,CR_05410C_A,3,CR,1158985,1159078,93,3.8288244834579794,4.80007095358759
11825,CR_05420W_A,55,CR,1160039,1160353,314,20.790273071005906,26.0640795409772
11827,CR_05430W_A,155,CR,1160460,1161524,1064,17.2908850028342,21.677012154124405
11829,CR_05440W_A,507,CR,1162025,1162540,515,116.84977554661954,146.4907090825945
11831,CR_05450C_A,561,CR,1162653,1163300,647,102.91667170296404,129.02323640470135
11833,CR_05460W_A,256,CR,1163597,1164436,839,36.21638986975271,45.403293310692625
11835,CR_05470C_A,4,CR,1164573,1164644,71,6.686961069701259,8.383222510491002
11837,CR_05480W_A,1620,CR,1165883,1166743,860,223.58554134797643,280.3018177781032
11839,CR_05490W_A,289,CR,1167478,1168518,1040,32.9831139877885,41.34984199345309
11841,CR_05500C_A,279,CR,1168592,1171228,2636,12.562785643940844,15.749549953558066
11843,CR_05510W_A,929,CR,1171820,1174612,2792,39.49366629624153,49.51190665915795
11845,CR_05520W_A,1538,CR,1174805,1176949,2144,85.14491311674885,106.74336890165537
11847,CR_05530C_A,724,CR,1177061,1178797,1736,49.50123082184959,62.05806018566813
11849,CR_05540C_A,310,CR,1179301,1181166,1865,19.729224282054254,24.73387767505455
11851,CR_05550C_A,1902,CR,1181749,1185222,3473,65.00292231317287,81.49201945448648
11853,CR_05560W_A,252,CR,1185511,1186995,1484,20.15551001669389,25.268298038696933
11855,CR_05570C_A,220,CR,1187177,1189627,2450,10.658197133544252,13.361830164680557
11857,CR_05580C_A,1,CR,1190023,1190650,627,0.18930392182966085,0.23732408223479312
11859,CR_05590C_A,1,CR,1190766,1190860,94,1.2626974360340144,1.583002122991652
11861,CR_05600C_A,1,CR,1190939,1191036,97,1.2236449380123438,1.5340432944455185
11863,CR_05610C_A,318,CR,1194011,1194859,848,44.51008462019901,55.800824835455735
11865,CR_05620C_A,735,CR,1198841,1200487,1646,53.00107281627585,66.4456966448926
11867,CR_05630W_A,519,CR,1201081,1202403,1322,46.59754698514026,58.41780754332128
11869,CR_05640C_A,84,CR,1202423,1202998,575,17.33958079117318,21.738060457638408
11871,CR_05650W_A,1160,CR,1203262,1204923,1661,82.89255173097466,103.91965773089088
11873,CR_05660W_A,1972,CR,1205203,1207482,2279,102.70456266904483,128.7573223057115
11875,CR_05670C_A,1434,CR,1207729,1208400,671,253.6610485657839,318.00648907717243
11877,CR_05680C_A,28,CR,1208432,1208830,398,8.35030063226514,10.468496451542785
11879,CR_05690W_A,270,CR,1209450,1210475,1025,31.265620416139793,39.196676957588416
11881,CR_05700C_A,417,CR,1210658,1211560,902,54.87274290206352,68.79214769071704
11883,CR_05710C_A,47,CR,1211886,1212743,857,6.509448392530077,8.160680722727092
11885,CR_05720W_A,686,CR,1213671,1215107,1436,56.70179767772798,71.08517332799003
11887,CR_05730C_A,664,CR,1215325,1216785,1460,53.98118025171168,67.67442500592257
11889,CR_05740C_A,450,CR,1217854,1218891,1037,51.50636600215893,64.57183201788513
11891,CR_05750W_A,1388,CR,1219964,1220992,1028,160.2593967648151,200.91191925191325
11893,CR_05760C_A,222,CR,1221035,1222030,995,26.482382005183734,33.2000887463214
11895,CR_05770W_A,211,CR,1222388,1223902,1514,16.541836820540716,20.73795515681402
11897,CR_05780W_A,4070,CR,1224232,1225770,1538,314.0980397125444,393.77435124456844
11899,CR_05790C_A,4971,CR,1225928,1228303,2375,248.4318659896244,311.45083537633735
11901,CR_05800C_A,235,CR,1228646,1229050,404,69.04204545047372,86.55573489328117
11903,CR_05810C_A,4,CR,1229471,1229561,90,5.275269288319882,6.613431091609567
11905,CR_05820C_A,2,CR,1230058,1230148,90,2.637634644159941,3.3067155458047837
11907,CR_05830C_A,401,CR,1230747,1232063,1316,36.16726227497427,45.34170366568946
11909,CR_05840W_A,456,CR,1232321,1233040,719,75.27713894042002,94.37246592477632
11911,CR_05850W_A,1,CR,1233214,1233287,73,1.6259391642081829,2.038386295359113
11913,CR_05860W_A,1290,CR,1233738,1234418,680,225.16866337277148,282.2865256381878
11915,CR_05870W_A,2,CR,1234600,1234681,81,2.9307051601777125,3.674128384227538
11917,CR_05880W_A,522,CR,1235017,1235643,626,98.9745012640847,124.08106736574182
11919,CR_05890C_A,1001,CR,1235775,1236602,827,143.66656897966692,180.11003840480834
11921,CR_05900W_A,384,CR,1236909,1238417,1508,30.22435454315901,37.89127628083997
11923,CR_05910W_A,220,CR,1238642,1239028,386,67.64917869736637,84.80954379136624
11925,CR_05920C_A,1738,CR,1239215,1242844,3629,56.84469702941554,71.2643215313839
11927,CR_05930C_A,1,CR,1243713,1243794,81,1.4653525800888563,1.837064192113769
11929,CR_05940W_A,204,CR,1244534,1245652,1118,21.65785870607179,27.151743032636777
11931,CR_05950C_A,1514,CR,1245828,1248944,3116,57.67074721008242,72.29991339399228
11933,CR_05960W_A,67,CR,1249568,1249843,275,28.918067098698994,36.25362680218699
11935,CR_05970C_A,1707,CR,1249893,1251227,1334,151.8814881492848,190.40881158245466
11937,CR_05980W_A,1494,CR,1251495,1255409,3914,45.30612599051427,56.79879564242607
11939,CR_05990C_A,3954,CR,1255695,1258112,2417,194.17225164889464,243.42734673771008
11941,CR_06000W_A,3704,CR,1274159,1276636,2477,177.48927835630965,222.51245344155893
11943,CR_06010W_A,762,CR,1278556,1279848,1292,70.00347674012724,87.76104958641334
11945,CR_06020W_A,492,CR,1280965,1282092,1127,51.816531518811985,64.96067629469204
11947,CR_06030C_A,320,CR,1282621,1285008,2387,15.911997853331863,19.948346820104266
11949,CR_06040W_A,3978,CR,1290764,1292656,1892,249.5575991813272,312.86212994424653
11951,CR_06050W_A,638,CR,1293451,1294404,953,79.4611654080083,99.61784188883037
11953,CR_06060W_A,678,CR,1295059,1295826,767,104.92077313340262,131.5357122588057
11955,CR_06070W_A,1655,CR,1295893,1297119,1226,160.22662326575173,200.87083219723596
11957,CR_06080W_A,2296,CR,1297516,1298547,1031,264.32629625082944,331.37715828569384
11959,CR_06090W_A,540,CR,1298889,1299875,986,65.00458605789713,81.49410523636537
11961,CR_06100C_A,208,CR,1299955,1301847,1892,13.04876335588639,16.358804180091322
11963,CR_06110C_A,839,CR,1302431,1304986,2555,38.976084536304725,48.86303148017989
11965,CR_06120W_A,848,CR,1308687,1309574,887,113.47478920083806,142.25960003146625
11967,CR_06130C_A,1,CR,1315840,1316193,353,0.3362423767342701,0.42153597609409427
11969,CR_06140W_A,2589,CR,1316618,1318372,1754,175.19818940584605,219.64019080044832
11971,CR_06150C_A,1956,CR,1318865,1320313,1448,160.33466946060636,201.00628614760848
11973,CR_06160C_A,87,CR,1320937,1321353,416,24.82293180741868,31.119690773619546
11975,CR_06170W_A,224,CR,1321747,1322535,788,33.740301031893665,42.299102413340385
11977,CR_06180W_A,1948,CR,1322879,1324033,1154,200.35966456417717,251.18430220558696
11979,CR_06190C_A,2,CR,1324260,1324350,90,2.637634644159941,3.3067155458047837
11981,CR_06200C_A,1,CR,1324465,1324551,86,1.3801576626418297,1.730258134432736
11983,CR_06210C_A,1,CR,1324474,1324560,86,1.3801576626418297,1.730258134432736
11985,CR_06220C_A,1,CR,1324683,1324826,143,0.8300248880223591,1.0405748221064006
11987,CR_06230W_A,261,CR,1326329,1328179,1850,16.74541561927487,20.993175181339023
11989,CR_06240C_A,65,CR,1328224,1330083,1859,4.150124440111796,5.2028741105320035
11991,CR_06250W_A,204,CR,1330782,1331681,899,26.93379981466992,33.76601636316787
11993,CR_06260W_A,334,CR,1331745,1332917,1172,33.82563882399652,42.40608758826443
11995,CR_06270W_A,52,CR,1334033,1334527,494,12.494058840757617,15.663389427496346
11997,CR_06290C_A,1219,CR,1335351,1336430,1079,134.0940207649616,168.10925047740633
11999,CR_06300C_A,297,CR,1336646,1337380,734,48.027230271386394,60.210154318366406
12001,CR_06310W_A,55,CR,1338711,1339799,1088,6.000133956154278,7.5221700145834935
12003,CR_06320C_A,263,CR,1339957,1341360,1403,22.249754820836,27.89378366685646
12005,CR_06330C_A,150,CR,1342340,1342891,551,32.31222113989039,40.50876576076641
12007,CR_06340C_A,6854,CR,1343151,1344803,1652,492.44894267448586,617.3669950318218
12009,CR_06350C_A,39,CR,1346060,1346347,287,16.129089897214975,20.220507954311486
12011,CR_06380C_A,336,CR,1348951,1350489,1538,25.930452418529462,32.508152830018425
12013,CR_06420W_A,540,CR,1364396,1365844,1448,44.26417255047416,55.49253298553609
12015,CR_06430W_A,71,CR,1366337,1367128,791,10.653909845879916,13.356455333560412
12017,CR_06440C_A,1541,CR,1368264,1370486,2222,82.31628010768277,103.19720500622536
12019,CR_06450W_A,237,CR,1378087,1380147,2060,13.655521106779501,17.119476357285446
12021,CR_06460W_A,205,CR,1380753,1381400,647,37.60769643334692,47.14752845448089
12023,CR_06470W_A,783,CR,1381903,1383804,1901,48.88850956705709,61.28991176035327
12025,CR_06480C_A,332,CR,1383886,1385961,2075,18.990969437951577,23.808351929794444
12027,CR_06490C_A,12261,CR,1386423,1388123,1700,856.0598392600158,1073.213981658859
12029,CR_06500C_A,42,CR,1389144,1389644,500,9.970258954924578,12.499384763142084
12031,CR_06510W_A,63,CR,1390614,1391096,482,15.513888415339073,19.44925015011735
12033,CR_06520C_A,56,CR,1391227,1391886,659,10.086250839579744,12.644799962713288
12035,CR_06530W_A,366,CR,1392635,1393051,416,104.42750622431306,130.91731980626153
12037,CR_06540W_A,263,CR,1393317,1396052,2735,11.413676787434335,14.308950085776827
12039,CR_06550C_A,7157,CR,1396675,1397004,329,2582.035871341555,3237.0131983575016
12041,CR_06560C_A,905,CR,1400076,1400852,776,138.4248336126464,173.53864768414928
12043,CR_06570C_A,116,CR,1401467,1403584,2117,6.503756656832731,8.153545181436453
12045,CR_06580W_A,13,CR,1406153,1406851,698,2.2106250241168564,2.7713876709108862
12047,CR_06590C_A,1186,CR,1409035,1410333,1298,108.45189596210793,135.9625644681058
12049,CR_06600C_A,26,CR,1416506,1416586,80,38.57540667083914,48.36071485739497
12051,CR_06610W_A,61,CR,1418649,1420058,1409,5.138613980283207,6.442110839768725
12053,CR_06620W_A,233,CR,1420374,1421720,1346,20.546507610710982,25.758478824489718
12055,CR_06630W_A,3,CR,1424337,1424474,137,2.5991290289167304,3.2584423261579984
12057,CR_06640C_A,922,CR,1424764,1426245,1481,73.89295164496689,92.63715597261343
12059,CR_06650C_A,41,CR,1426753,1427130,377,12.908318086140827,16.182732578275402
12061,CR_06660W_A,97,CR,1429410,1431239,1829,6.294847032125831,7.891642076237224
12063,CR_06670W_A,28,CR,1433878,1436097,2219,1.4977105234977584,1.877630278374956
12065,CR_06680C_A,1759,CR,1436296,1439613,3317,62.94301183553819,78.90957763888385
12067,CR_06690C_A,329,CR,1439829,1440640,811,48.15065463229091,60.36488736823654
12069,CR_06700C_A,733,CR,1440889,1441668,779,111.68469671067479,140.0154201262783
12071,CR_06710C_A,683,CR,1441949,1443298,1349,60.09466329744684,75.33869703507045
12073,CR_06720W_A,1894,CR,1443567,1445129,1562,143.92163938652484,180.4298117598859
12075,CR_06730W_A,243,CR,1445416,1447335,1919,15.029981674772777,18.84259223208719
12077,CR_06740W_A,327,CR,1447534,1450149,2615,14.842368561687776,18.607387861000916
12079,CR_06750C_A,1281,CR,1450291,1451058,767,198.23526605293324,248.52101386951338
12081,CR_06760C_A,6629,CR,1451389,1453027,1638,480.3538476960508,602.2037734379097
12083,CR_06770C_A,810,CR,1453898,1454575,677,142.01149598172802,178.03512798313793
12085,CR_06780W_A,716,CR,1455508,1456623,1115,76.21936164559041,95.55369944917501
12087,CR_06790C_A,106,CR,1457397,1459211,1814,6.935786798590364,8.695167118792073
12089,CR_06800C_A,1654,CR,1460975,1461292,317,619.3033014663231,776.4001201080443
12091,CR_06810W_A,1105,CR,1462250,1462660,410,319.8936162947636,401.04007442717773
12093,CR_06820W_A,100,CR,1462868,1463392,524,22.651442554808657,28.3973663284762
12095,CR_06830C_A,165,CR,1463495,1464340,845,23.17684879631664,29.05605080189411
12097,CR_06840W_A,529,CR,1464905,1467055,2150,29.204136141501117,36.61226212459669
12099,CR_06850C_A,13,CR,1467125,1467409,284,5.433155869132273,6.81136828977394
12101,CR_06860C_A,2550,CR,1467616,1469505,1889,160.22687952215634,200.87115345743726
12103,CR_06870C_A,23,CR,1470593,1472848,2255,1.2106216659448068,1.51771644785275
12105,CR_06880C_A,1,CR,1474054,1474135,81,1.4653525800888563,1.837064192113769
12107,CR_06900C_A,236,CR,1475518,1477209,1691,16.56515666527414,20.76719047690527
12109,CR_06910W_A,1025,CR,1479588,1484264,4676,26.018156108185906,32.61810405266161
12111,CR_06920W_A,20,CR,1484615,1485739,1124,2.1119850353593836,2.64772597084013
12113,CR_06930W_A,246,CR,1486110,1487075,965,30.257632653731143,37.93299595032016
12115,CR_06940W_A,115,CR,1487266,1489308,2042,6.684505036007687,8.380143462066483
12117,CR_06950C_A,74,CR,1489480,1489704,224,39.21126502255627,49.15786949790147
12119,CR_06960W_A,85,CR,1490321,1491811,1490,6.771109069739447,8.488716082351207
12121,CR_06970C_A,344,CR,1491831,1493075,1244,32.82201309613818,41.14787511982159
12123,CR_06980W_A,28,CR,1493258,1493704,446,7.451613568702973,9.341842124919346
12125,CR_06990W_A,1,CR,1496722,1499319,2597,0.045704104346244646,0.05729772797890462
12127,CR_07000C_A,1506,CR,1499481,1506116,6635,26.940843984132513,33.774847406057305
12129,CR_07010W_A,7382,CR,1507086,1509926,2840,308.5196663533419,386.7809285777786
12131,CR_07020W_A,1013,CR,1510568,1511113,545,220.61756927345124,276.5809690926809
12133,CR_07030C_A,217,CR,1511408,1512253,845,30.4810678109134,38.213109236430434
12135,CR_07040W_A,206,CR,1512664,1514073,1409,17.35335213013673,21.755325131022246
12137,CR_07050C_A,9920,CR,1514438,1521088,6650,177.05866242902223,221.97260445823395
12139,CR_07060C_A,1462,CR,1523634,1525187,1553,111.7385597162154,140.08294639954715
12141,CR_07070C_A,1295,CR,1532277,1535744,3467,44.334629041944204,55.58086196474583
12143,CR_07080W_A,667,CR,1538707,1539444,737,107.42008662749069,134.66901914156117
12145,CR_07090W_A,1115,CR,1540034,1545817,5783,22.884889896373,28.69003155987464
12147,CR_07100W_A,3524,CR,1547917,1550352,2435,171.7766332118618,215.35069866682656
12149,CR_07110C_A,155,CR,1550708,1552915,2207,8.335977183060985,10.45053961576274
12151,CR_07120C_A,273,CR,1553189,1554349,1160,27.93391517543524,35.019828000182564
12153,CR_07130C_A,2334,CR,1555145,1556692,1547,179.07612584105922,224.5018317878969
12155,CR_07140C_A,131,CR,1557476,1558195,719,21.625669300866278,27.111388237161616
12157,CR_07150W_A,2900,CR,1559026,1560444,1418,242.744232061264,304.3204363381695
12159,CR_07160C_A,588,CR,1560577,1561917,1340,52.08344230184482,65.29529353880193
12161,CR_07170W_A,559,CR,1563256,1564104,848,78.24257013424919,98.09012919188602
12163,CR_07180W_A,1164,CR,1564407,1565804,1397,98.89713862641212,123.98408037885082
12165,CR_07190W_A,423,CR,1566214,1568853,2639,19.025151743684912,23.851205158921587
12167,CR_07200W_A,1007,CR,1569149,1570732,1583,75.50499930518492,94.65812694765874
12169,CR_07210W_A,608,CR,1570998,1571474,476,151.60857954667225,190.06667506978758
12171,CR_07220C_A,1572,CR,1571688,1574810,3122,59.76498229592384,74.92538683863883
12173,CR_07230W_A,953,CR,1576200,1576703,503,224.8806395920459,281.9254397253244
12175,CR_07240C_A,1929,CR,1576964,1577719,755,303.2581129619917,380.18469265375404
12177,CR_07250C_A,357,CR,1579345,1581459,2114,20.044276517705516,25.128848270271455
12179,CR_07260C_A,13,CR,1582019,1582624,605,2.5504401104687036,3.197402635199668
12181,CR_07270C_A,254,CR,1582853,1584550,1697,17.765565104742564,22.27210293962798
12183,CR_07280W_A,1674,CR,1586232,1587092,860,231.0383927262423,289.64521170404004
12185,CR_07290W_A,4706,CR,1587150,1588361,1211,461.24846291804346,578.251982770503
12187,CR_07300W_A,22,CR,1589557,1591749,2192,1.1912674715868348,1.493452732822416
12189,CR_07310W_A,545,CR,1592134,1594029,1895,34.136142294471014,42.795355546629196
12191,CR_07320C_A,2008,CR,1594104,1595033,929,256.55184762787115,321.63058850260524
12193,CR_07330W_A,215,CR,1595318,1595608,290,87.99694890430149,110.31887208848718
12195,CR_07340C_A,420,CR,1595677,1596750,1073,46.45973417951808,58.24503617493981
12197,CR_07350W_A,816,CR,1597334,1599787,2453,39.48387449390666,49.49963099957263
12199,CR_07360W_A,1094,CR,1600181,1602901,2720,47.73924762205659,59.84911997057703
12201,CR_07370W_A,301,CR,1603281,1603664,383,93.28136097949452,116.9437651904068
12203,CR_07380C_A,465,CR,1603744,1604676,932,59.21942588953517,74.2414407682029
12205,CR_07390C_A,1824,CR,1604878,1605645,767,282.26473480136633,353.86598696174275
12207,CR_07400C_A,11540,CR,1606023,1607498,1475,928.626217432039,1164.1880562280842
12209,CR_07410C_A,1,CR,1607966,1608040,74,1.6039670133405046,2.0108405346110176
12211,CR_07420W_A,8009,CR,1609157,1610482,1325,717.4465765497839,899.4391066307722
12213,CR_07440W_A,727,CR,1611767,1614118,2351,36.70362287694278,46.014121259465554
12215,CR_07450C_A,1616,CR,1614446,1617163,2717,70.59580100232276,88.50362697494438
12217,CR_07460C_A,425,CR,1618134,1620149,2015,25.034621622609862,31.385079311918858
12219,CR_07470W_A,153,CR,1620898,1621350,452,40.17724452442742,50.36888613465915
12221,CR_07480W_A,2190,CR,1622533,1623873,1340,193.98424938952405,243.19165450676232
12223,CR_07490C_A,522,CR,1624294,1625424,1130,54.8301219392186,68.73871519553485
12225,CR_07500W_A,28,CR,1626254,1626940,686,4.844635060701933,6.073559165763889
12227,CR_07510W_A,242,CR,1627319,1627769,450,63.83075838867058,80.02251620847578
12229,CR_07520C_A,1831,CR,1627966,1628634,668,325.3411774035305,407.86950209069636
12231,CR_07530C_A,2668,CR,1629332,1631914,2582,122.64694631210014,153.75843084017131
12233,CR_07540C_A,14,CR,1634660,1636483,1823,0.9115248633136385,1.1427486526917245
12235,CR_07550C_A,1,CR,1637820,1638125,305,0.3891592097940897,0.48787606413513207
12237,CR_07560W_A,295,CR,1639406,1642045,2639,13.268131830702243,16.633819200666355
12239,CR_07570W_A,218,CR,1642482,1643309,827,31.28802401355384,39.22476360863958
12241,CR_07580C_A,479,CR,1643364,1647227,3863,14.717632605453671,18.451010507331638
12243,CR_07590W_A,580,CR,1649718,1650320,602,114.35592061889446,143.36424542442668
12245,CR_07600W_A,1482,CR,1650950,1654243,3293,53.41750817462086,66.96776791670848
12247,CR_07610C_A,41,CR,1654471,1654964,493,9.87106677175475,12.37503079515178
12249,CR_07620W_A,2388,CR,1655311,1656561,1250,226.75217508914182,284.2717220417457
12251,CR_07630C_A,3126,CR,1657163,1657839,676,548.8699192218623,688.1001121721287
12253,CR_07640C_A,372,CR,1658503,1659099,596,74.08389923361983,92.87654066572497
12255,CR_07650W_A,1983,CR,1660822,1661814,992,237.26746720928665,297.454396905131
12257,CR_07660C_A,426,CR,1662889,1663806,917,55.14008301913421,69.12730317674777
12259,CR_07670W_A,74,CR,1664072,1664860,788,11.146349448036299,13.973810618692807
12261,CR_07680C_A,152,CR,1665030,1667474,2444,7.381923472198853,9.25447394979735
12263,CR_07690W_A,176,CR,1669651,1669986,335,62.35840710969175,78.17667797842952
12265,CR_07700W_A,389,CR,1671100,1672311,1211,38.126997891015506,47.79855956177766
12267,CR_07710W_A,2191,CR,1672493,1673734,1241,209.55486522236055,262.7120219489305
12269,CR_07720C_A,340,CR,1673907,1675646,1739,23.20633125684135,29.093011990116846
12271,CR_07730W_A,302,CR,1677339,1679117,1778,20.160548264417102,25.274614323670992
12273,CR_07740W_A,72,CR,1679654,1679848,194,44.051217768444374,55.22555860003866
12275,CR_07750C_A,758,CR,1679976,1681796,1820,49.433910830931644,61.97366333373692
12277,CR_07760W_A,364,CR,1682063,1682338,275,157.10711080487215,196.9600023282995
12279,CR_07770C_A,917,CR,1682501,1683802,1301,83.66025641142197,104.88210376451529
12281,CR_07780W_A,825,CR,1684645,1686483,1838,53.27648866400317,66.79097640805364
12283,CR_07790C_A,2225,CR,1686913,1688109,1196,220.81368624290474,276.82683446797995
12285,CR_07800W_A,346,CR,1692632,1693828,1196,34.3377687370989,43.04812796670609
12287,CR_07810W_A,119,CR,1696870,1698072,1202,11.750859833175113,14.731665347574557
12289,CR_07820W_A,271,CR,1699955,1702141,2186,14.71452629713197,18.447116231056423
12291,CR_07830C_A,687,CR,1702917,1703366,449,181.6090757777385,227.6773075691646
12293,CR_07840C_A,282,CR,1703463,1704053,590,56.73149768540619,71.1224072479029
12295,CR_07850W_A,675,CR,1706856,1708703,1847,43.377451172906454,54.38087964473217
12297,CR_07860C_A,174,CR,1708816,1709559,743,27.796338174659947,34.84735225255916
12299,CR_07870W_A,203,CR,1712422,1713414,992,24.289105316936556,30.45045011182127
12301,CR_07880C_A,3,CR,1713590,1713660,70,5.086866813737029,6.377237124052082
12303,CR_07890W_A,2624,CR,1723489,1725146,1657,187.9613148958394,235.64090021039763
12305,CR_07900C_A,8,CR,1725543,1725878,335,2.8344730504405335,3.5534853626558878
12307,CR_07910C_A,1450,CR,1726113,1729280,3167,54.343435595653986,68.12857258091638
12309,CR_07920W_A,1257,CR,1731199,1733115,1916,77.86941735224796,97.62231985827118
12311,CR_07930C_A,34,CR,1733827,1734141,314,12.852168807530925,16.112340079876816
12313,CR_07940W_A,368,CR,1734390,1736519,2129,20.51631268543383,25.72062444270889
12315,CR_07950W_A,784,CR,1736935,1737786,851,109.34870769208311,137.08686775087284
12317,CR_07960C_A,815,CR,1737861,1741031,3170,30.515851916266826,38.25671692188973
12319,CR_07970C_A,4,CR,1742830,1743189,359,1.3224909079353464,1.6579632263088053
12321,CR_07990C_A,1,CR,1748632,1749009,377,0.3148370264912397,0.39470079459208296
12323,CR_08000C_A,2276,CR,1749562,1751244,1682,160.61030930728964,201.35184673087156
12325,CR_08010W_A,120,CR,1751963,1752281,318,44.790022259319755,56.15177341932653
12327,CR_08020C_A,593,CR,1752667,1752846,179,393.21385742686056,492.9592421217914
12329,CR_08030C_A,1672,CR,1753067,1755388,2321,85.50436476802842,107.19400157964323
12331,CR_08040W_A,465,CR,1755653,1756840,1187,46.49747677257521,58.29235281884171
12333,CR_08050C_A,1566,CR,1756914,1757813,899,206.75652210673087,259.20383149372987
12335,CR_08060C_A,2237,CR,1758278,1758928,650,408.4884483913238,512.108492951444
12337,CR_08070W_A,972,CR,1760025,1761143,1118,103.19332677598912,129.37006974373995
12339,CR_08080W_A,141,CR,1761311,1762069,758,22.07888102532299,27.679564826030813
12341,CR_08090W_A,42278,CR,1762392,1764233,1841,2725.7611552747044,3417.1968457626613
12343,CR_08100C_A,1868,CR,1764414,1765817,1403,158.03247910768684,198.12010604444058
12345,CR_08110W_A,214,CR,1765907,1767181,1274,19.93753659596565,24.995031951412933
12347,CR_08120C_A,3510,CR,1767218,1769941,2723,152.9983077653554,191.80893149462565
12349,CR_08130W_A,748,CR,1770028,1771158,1130,78.56883373665808,98.49915510777791
12351,CR_08140W_A,1,CR,1771650,1771740,90,1.3188173220799706,1.6533577729023918
12353,CR_08150W_A,5333,CR,1772154,1772513,359,1763.211003004801,2210.4794714762147
12355,CR_08160W_A,1389,CR,1773596,1775338,1742,94.6414198812957,118.64882617137084
12357,CR_08170C_A,424,CR,1775806,1776909,1103,45.62653582100787,57.20048287756598
12359,CR_08180C_A,490,CR,1777046,1777843,797,72.97345533717278,91.48441378293036
12361,CR_08190W_A,102,CR,1778013,1778471,458,26.433936717672772,33.13935448743222
12363,CR_08200C_A,2073,CR,1778586,1783058,4472,55.02051605108679,68.97740601305887
12365,CR_08210C_A,47270,CR,1783404,1785737,2333,2404.905500782177,3014.9506957816743
12367,CR_08220C_A,1,CR,1786876,1786961,85,1.3963948116140865,1.750614112484886
12369,CR_08230C_A,1,CR,1787634,1787708,74,1.6039670133405046,2.0108405346110176
12371,CR_08240W_A,1,CR,1788639,1788713,74,1.6039670133405046,2.0108405346110176
12373,CR_08250C_A,4726,CR,1788887,1791586,2699,207.83466460670422,260.55546318129063
12375,CR_08260C_A,1,CR,1791590,1791892,302,0.3930250297589316,0.4927225151033619
12377,CR_08270W_A,9,CR,1792283,1793203,920,1.161132642266061,1.4556736913597148
12379,CR_08280W_A,230,CR,1793368,1794405,1037,26.325475956659012,33.00338080914129
12381,CR_08290W_A,1237,CR,1794674,1795927,1253,117.17791896820681,146.90209166578077
12383,CR_08300C_A,2052,CR,1796429,1800589,4160,58.54788053887716,73.39954651433024
12385,CR_08310C_A,54,CR,1800912,1802069,1157,5.539716668373948,6.94496004866519
12387,CR_08320W_A,392,CR,1802701,1803603,902,51.58301011417003,64.6679182128563
12389,CR_08330W_A,384,CR,1804012,1804677,665,68.53883706929892,85.92487914512282
12391,CR_08340W_A,3446,CR,1805596,1806795,1199,341.13261406996,427.6667053277297
12393,CR_08350W_A,1077,CR,1807225,1808469,1244,102.7596165829675,128.82634158153445
12395,CR_08360C_A,2858,CR,1808666,1809337,671,505.5531916325038,633.7953596810034
12397,CR_08370W_A,1566,CR,1810203,1811660,1457,127.5731732147914,159.9342790067695
12399,CR_08380C_A,64,CR,1811724,1812676,952,7.979398923509065,10.003509214199347
12401,CR_08390W_A,1,CR,1813131,1813216,85,1.3963948116140865,1.750614112484886
12403,CR_08400C_A,939,CR,1813616,1813984,368,302.8620975243976,379.68822116299225
12405,CR_08410W_A,1103,CR,1814233,1815585,1352,96.83357659976234,121.39706073670152
12407,CR_08420W_A,1593,CR,1816595,1818214,1619,116.78742400655058,146.41254101359849
12409,CR_08430W_A,2609,CR,1818617,1821289,2672,115.89502073263394,145.29376446677045
12411,CR_08440W_A,521,CR,1821550,1823403,1853,33.37255490141922,41.83807122039566
12413,CR_08450C_A,701,CR,1823510,1825432,1922,43.29041875651683,54.27176997524033
12415,CR_08460W_A,5139,CR,1826834,1827706,872,699.5025225174394,876.943238010419
12417,CR_08470W_A,674,CR,1828604,1830001,1397,57.26518164450323,71.79146922280536
12419,CR_08480C_A,1603,CR,1831039,1831209,170,1119.2104415086903,1403.117211156636
12421,CR_08490W_A,3623,CR,1832314,1834842,2528,170.1055238174905,213.25568394394105
12423,CR_08500W_A,757,CR,1835068,1836330,1262,71.19732500262155,89.257737771664
12425,CR_08510W_A,15848,CR,1838763,1840133,1370,1373.0332283424116,1721.3264661650658
12427,CR_08520C_A,196,CR,1840750,1841170,420,55.390327527358764,69.44102646190046
12429,CR_08530C_A,23,CR,1841759,1841873,114,23.9469461114521,30.021496402701327
12431,CR_08540C_A,582,CR,1842179,1844686,2507,27.554707351634967,34.544427660401794
12433,CR_08550W_A,603,CR,1845221,1846249,1028,69.62277827750974,87.28378048191908
12435,CR_08560C_A,645,CR,1846338,1846997,659,116.17199627730244,145.64099957053696
12437,CR_08570W_A,2182,CR,1847067,1850804,3737,69.30407966552438,86.88423854497503
12439,CR_08580C_A,112,CR,1850799,1851599,800,16.61709825820763,20.83230793857014
12441,CR_08590W_A,549,CR,1851759,1854059,2300,28.331636471291894,35.51843806917704
12443,CR_08600C_A,1996,CR,1854148,1855146,998,237.38711797439473,297.60439912243055
12445,CR_08610W_A,425,CR,1855954,1856352,398,126.74563459688159,158.89682113948868
12447,CR_08620C_A,322,CR,1856428,1857492,1064,35.920419167178146,45.032244604051996
12449,CR_08630W_A,457,CR,1857629,1859377,1748,31.031439620794732,38.90309221937951
12451,CR_08640C_A,1116,CR,1859509,1861272,1763,75.13443665894059,94.19356478180163
12453,CR_08650C_A,861,CR,1861693,1863837,2144,47.66565032088476,59.75685346184998
12455,CR_08660W_A,3152,CR,1864316,1871566,7250,51.603047990020144,64.69303903682078
12457,CR_08670C_A,363,CR,1871583,1872386,803,53.655992418870035,67.26674774685074
12459,CR_08680C_A,1104,CR,1872526,1874673,2147,61.032924602638985,76.51496428299099
12461,CR_08690C_A,1524,CR,1874776,1875693,917,197.2617054487337,247.30049305484417
12463,CR_08700C_A,319,CR,1875929,1876468,539,70.24720838017802,88.0666079035764
12465,CR_08710W_A,2899,CR,1876702,1878855,2153,159.82007780022533,200.36115955780915
12467,CR_08720W_A,128,CR,1879051,1880910,1859,8.172552743604767,10.245659786893793
12469,CR_08730W_A,3,CR,1880901,1880994,93,3.8288244834579794,4.80007095358759
12471,CR_08740W_A,8,CR,1881722,1882402,680,1.3963948116140865,1.750614112484886
12473,CR_08750C_A,1,CR,1882565,1882635,70,1.6956222712456763,2.1257457080173614
12475,CR_08760C_A,89,CR,1888934,1889054,120,88.03105624883804,110.36163134123467
12477,CR_08770W_A,185395,CR,1891236,1893022,1786,12320.936376501373,15446.35150484407
12479,CR_08780W_A,1671,CR,1893023,1893161,138,1437.2241816493245,1801.8005468608026
12481,CR_08790W_A,1715,CR,1893162,1893318,156,1304.868292711817,1635.8703349197708
12483,CR_08800W_A,1140,CR,1893319,1893469,150,902.0710483027,1130.8967166652362
12485,CR_08810W_A,213204,CR,1893470,1896830,3360,7531.5302233054845,9442.030998586113
12487,CR_08820C_A,1,CR,1893653,1893922,269,0.4412399962349344,0.553168028108607
12489,CR_08830W_A,2634,CR,1898484,1898747,263,1188.740815103718,1490.2851469362777
12491,CR_08840C_A,462,CR,1899386,1900285,899,60.997134874399535,76.47009588129195
12493,CR_08850W_A,69,CR,1900674,1900997,323,25.355590000361047,31.78746677933082
12495,CR_08860W_A,3497,CR,1902380,1903915,1535,270.40480506725027,338.99758427724424
12497,CR_08870W_A,1310,CR,1904766,1905881,1115,139.45162535715562,174.8259026234906
12499,CR_08880C_A,32,CR,1906305,1906673,368,10.321179042364987,12.939321700975242
12501,CR_08890C_A,2067,CR,1907038,1907814,776,316.1592608589393,396.35843620236085
12503,CR_08900C_A,1408,CR,1908216,1909313,1097,152.3432370592287,190.98769095915327
12505,CR_08910C_A,1881,CR,1910065,1911267,1202,185.74258274119651,232.859348897376
12507,CR_08920W_A,1307,CR,1911649,1912971,1322,117.34680907433204,147.1138236206569
12509,CR_08930C_A,677,CR,1913084,1913587,503,159.7525634877388,200.2765190913375
12511,CR_08940W_A,855,CR,1914210,1915217,1007,100.77755008346945,126.34149019348469
12513,CR_08950W_A,2179,CR,1915454,1916695,1241,208.40714345939003,261.2731610345593
12515,CR_08960C_A,737,CR,1916751,1918823,2072,42.21870317256972,52.928195500297136
12517,CR_08970W_A,2,CR,1919560,1919633,73,3.2518783284163657,4.076772590718226
12519,CR_08980C_A,1097,CR,1919749,1921311,1562,83.35904878934411,104.50448970464352
12521,CR_08990C_A,15134,CR,1922057,1923109,1052,1707.5174160762783,2140.6582587066846
12523,CR_09010C_A,2098,CR,1924790,1925941,1151,216.35020569516945,271.2311161419893
12525,CR_09020C_A,2621,CR,1926708,1929737,3029,102.70578346168513,128.7588527731744
12527,CR_09030C_A,7,CR,1930897,1931196,299,2.7787789729444197,3.48366353487795
12529,CR_09040W_A,450,CR,1931725,1932549,824,64.82051158281409,81.2633371390132
12531,CR_09050C_A,192,CR,1932933,1934693,1760,12.948388253148803,16.23296722485985
12533,CR_09060W_A,9,CR,1935842,1936579,737,1.4494464462480001,1.81712319681267
12535,CR_09070C_A,78,CR,1936663,1938141,1478,6.263936130582811,7.852890098629764
12537,CR_09090C_A,287,CR,1940339,1941622,1283,26.551092306567142,33.286228584621036
12539,CR_09100C_A,1293,CR,1942195,1943244,1049,146.3019749956589,183.41395999299465
12541,CR_09110C_A,369,CR,1943868,1944725,857,51.10609482645953,64.07002524864463
12543,CR_09120C_A,4179,CR,1945291,1946851,1560,317.9617839791652,398.6181999784094
12545,CR_09140C_A,883,CR,1947500,1949866,2366,44.29687767780865,55.53353432483224
12547,CR_09150W_A,115,CR,1950586,1951170,584,23.37287548549263,29.301802995787256
12549,CR_09160C_A,7472,CR,1951279,1952634,1355,654.522710518331,820.5535314549082
12551,CR_09170C_A,1050,CR,1953918,1955363,1445,86.2479148349877,108.1261657711253
12553,CR_09180W_A,1295,CR,1957742,1958539,797,192.85841767681376,241.78023642631592
12555,CR_09190C_A,383,CR,1958669,1959574,905,50.23163877579733,62.97374854358614
12557,CR_09200C_A,221,CR,1959810,1961258,1448,18.115522469731086,22.71083294408051
12559,CR_09210W_A,742,CR,1961676,1963181,1505,58.518684896013575,73.36294489994799
12561,CR_09220C_A,94,CR,1963272,1964552,1280,8.716558238122307,10.927661530276747
12563,CR_09230C_A,764,CR,1964921,1966741,1820,49.825208278142185,62.464220035587076
12565,CR_09240C_A,1071,CR,1967127,1967570,443,286.95440558755837,359.74527252835566
12567,CR_09270C_A,4348,CR,1968719,1970188,1469,351.313542870207,440.4301999265923
12569,CR_09290W_A,361,CR,1972214,1973233,1019,42.0494355195076,52.71599022728039
12571,CR_09300C_A,1894,CR,1973390,1974295,905,248.4039786980683,311.41587399883065
12573,CR_09310W_A,376,CR,1974738,1976477,1739,25.663472213448077,32.17344855377628
12575,CR_09320C_A,1006,CR,1976705,1977280,575,207.66212233238355,260.3391526236219
12577,CR_09330C_A,4490,CR,1977674,1980379,2705,197.01814412292646,246.99514825503016
12579,CR_09340W_A,1538,CR,1981012,1981515,503,362.923844378349,454.9856519386662
12581,CR_09350C_A,1,CR,1982021,1982734,713,0.1664706297155643,0.20869873711250392
12583,CR_09360W_A,114,CR,1983094,1984680,1586,8.531567291639659,10.69574448296251
12585,CR_09370W_A,2123,CR,1985044,1988631,3587,70.24990959850014,88.06999433188182
12587,CR_09380W_A,1302,CR,1989010,1989912,902,171.3292835934933,214.78987120698702
12589,CR_09390C_A,16,CR,1990348,1992162,1814,1.0469112148815642,1.312478055666728
12591,CR_09410W_A,267,CR,2000249,2002363,2114,14.991097563662107,18.793844504656803
12593,CR_09420C_A,478,CR,2002832,2005762,2930,19.36365911122196,24.275580679269936
12595,CR_09430C_A,2,CR,2006281,2006613,332,0.7150214396819118,0.8963987925374416
12597,CR_09440C_A,580,CR,2006760,2007807,1047,65.75192379424495,82.4310179040161
12599,CR_09450C_A,2,CR,2008897,2008968,71,3.3434805348506296,4.191611255245501
12601,CR_09460C_A,375,CR,2015134,2015427,293,151.91155160477476,190.4465011449001
12603,CR_09470W_A,941,CR,2017154,2021266,4112,27.162120381068267,34.052254325657486
12605,CR_09480W_A,647,CR,2021791,2023167,1376,55.81012548307899,69.96731331112376
12607,CR_09490W_A,223,CR,2023612,2026119,2507,10.557903332327488,13.23609513448385
12609,CR_09500C_A,174,CR,2026459,2027463,1004,20.57039767308002,25.788429007620977
12611,CR_09510C_A,325,CR,2027819,2028619,800,48.219258338548926,60.45089357174371
12613,CR_09520C_A,812,CR,2028990,2031764,2774,34.74375266676433,43.557096627147374
12615,CR_09530C_A,1098,CR,2032341,2034509,2168,60.11325081547173,75.36199959327232
12617,CR_09550C_A,470,CR,2035681,2036295,614,90.85663310094913,113.90396383350355
12619,CR_09560C_A,66,CR,2037364,2038728,1364,5.743236725186969,7.2001064303813855
12621,CR_09570W_A,77,CR,2039079,2039942,863,10.590271195844956,13.276673657257913
12623,CR_09580C_A,209,CR,2040062,2041437,1375,18.041420966053998,22.617934333304724
12625,CR_09590W_A,267,CR,2042657,2043526,869,36.4685618522229,45.719433006725524
12627,CR_09600C_A,315,CR,2043667,2044170,503,74.33095642339397,93.18626811487637
12629,CR_09610C_A,1006,CR,2044932,2046140,1208,98.84579498437131,123.91971254849551
12631,CR_09620C_A,127,CR,2047539,2048129,590,25.5492915108035,32.03030397334634
12633,CR_09630W_A,3,CR,2049080,2049173,93,3.8288244834579794,4.80007095358759
12635,CR_09640C_A,490,CR,2049605,2049799,194,299.79300981302424,375.84060713915204
12637,CR_09650W_A,1902,CR,2050217,2052358,2141,105.44378757293292,132.19139820898246
12639,CR_09660W_A,135,CR,2052941,2054116,1175,13.637132309167356,17.096422928309842
12641,CR_09670C_A,494,CR,2054141,2055052,911,64.362917826208,80.6896669409883
12643,CR_09680C_A,398,CR,2055720,2057090,1370,34.48177845029529,43.22866819369612
12645,CR_09690C_A,1477,CR,2059146,2061044,1898,92.36585175136486,115.79602147097734
12647,CR_09700W_A,98,CR,2063617,2065386,1769,6.575448717210481,8.243423152628093
12649,CR_09710W_A,296,CR,2066448,2067626,1178,29.824527555356887,37.39002637531386
12651,CR_09720W_A,38,CR,2067865,2068431,566,7.968825515041518,9.990253680788305
12653,CR_09730C_A,981,CR,2068472,2069818,1346,86.50696981162007,108.4509344498902
12655,CR_09740W_A,600,CR,2069945,2071549,1604,44.39908690294166,55.66167065880871
12657,CR_09750C_A,670,CR,2071617,2072705,1088,73.09254092042484,91.63370745038073
12659,CR_09760W_A,280,CR,2073298,2073834,536,62.004097978386675,77.73249230809755
12661,CR_09770C_A,428,CR,2073883,2076060,2177,23.335251835792594,29.254635467248573
12663,CR_09780C_A,48,CR,2077962,2079998,2036,2.798276439776755,3.508106865883268
12665,CR_09790W_A,2097,CR,2090643,2092316,1673,148.7748913306353,186.5141736281342
12667,CR_09800C_A,2051,CR,2092517,2095135,2618,92.98719995521076,116.57498521774352
12669,CR_09810W_A,79,CR,2095754,2096467,713,13.151179747529582,16.487200231887808
12671,CR_09820C_A,38,CR,2096565,2097002,437,10.321179042364987,12.939321700975242
12673,CR_09830W_A,331,CR,2096976,2098658,1682,23.357650430893177,29.282715847064363
12675,CR_09840C_A,38,CR,2098780,2099424,644,7.003657207319098,8.780254011376057
12677,CR_09850C_A,17,CR,2100198,2100560,362,5.574006913763412,6.987948598178619
12679,CR_09860W_A,1622,CR,2100701,2103163,2462,78.19697509229655,98.03296819183232
12681,CR_09880W_A,4558,CR,2106063,2108726,2663,203.1563056190933,254.69035884341693
12683,CR_09890C_A,878,CR,2112885,2113910,1025,101.67116564952126,127.4617865509727
12685,CR_09900C_A,289,CR,2114184,2116310,2126,16.134731207572923,20.227580279017502
12687,CR_09910W_A,270,CR,2118630,2120327,1697,18.88465582000194,23.67507005393525
12689,CR_09920W_A,2086,CR,2122776,2124491,1715,144.3701248089176,180.9920631397639
12691,CR_09930W_A,467,CR,2125325,2126614,1289,43.00224363616847,53.91049433288405
12693,CR_09940W_A,84,CR,2126919,2127764,845,11.799123023579384,14.792171317327911
12695,CR_09950C_A,3632,CR,2127986,2129536,1550,278.1258104783876,348.6771540686025
12697,CR_09960C_A,1916,CR,2129808,2132219,2411,94.32470303586484,118.25176870978369
12699,CR_09970W_A,2592,CR,2133546,2134433,887,346.84746887803334,434.83123028485915
12701,CR_09980W_A,1326,CR,2135208,2139131,3923,40.119209588841116,50.296129650311364
12703,CR_09990W_A,1102,CR,2139765,2144084,4319,30.28485806989847,37.96712755648512
12705,CR_10000C_A,63,CR,2144187,2144645,458,16.326843266797887,20.46842483047285
12707,CR_10010C_A,2213,CR,2144900,2146207,1307,200.97080798673892,251.95047255468205
12709,CR_10020C_A,533,CR,2146647,2147423,776,81.5253439950724,102.20563449243267
12711,CR_10030W_A,928,CR,2147924,2149489,1565,70.38186756557134,88.23542568230529
12713,CR_10040W_A,96,CR,2149779,2150093,314,36.288476633028495,45.49366610788748
12715,CR_10060W_A,630,CR,2150598,2152013,1415,52.84589552080165,66.2511559883856
12717,CR_10070C_A,4930,CR,2152028,2154073,2045,286.1414404923633,358.7260850057659
12719,CR_10100C_A,4691,CR,2155482,2157044,1562,356.46061793146146,446.8829181444692
12721,CR_10110W_A,408,CR,2161683,2163386,1703,28.436272499575175,35.64961680621012
12723,CR_10120C_A,31,CR,2163621,2164442,821,4.48172999829856,5.618597060167691
12725,CR_10130W_A,118,CR,2164549,2165283,734,19.081525831729273,23.92187949349238
12727,CR_10140W_A,3378,CR,2165844,2168006,2162,185.45182343143046,232.4948335419913
12729,CR_10160W_A,3008,CR,2172466,2174556,2090,170.82785905908597,214.16125180867732
12731,CR_10170C_A,270,CR,2174773,2176227,1454,22.04075717093761,27.631770207378352
12733,CR_10180W_A,73,CR,2176706,2177347,641,13.517363191989716,16.94627233692467
12735,CR_10190C_A,125,CR,2177405,2178733,1328,11.172209995029872,14.006231133397524
12737,CR_10200W_A,47,CR,2179388,2180371,983,5.675073522276985,7.114652471390761
12739,CR_10210W_A,6,CR,2180905,2181852,947,0.7520183251564775,0.9427805674417019
12741,CR_10230W_A,3012,CR,2182766,2184085,1319,271.0424561557532,339.7969864127221
12743,CR_10240W_A,1016,CR,2184322,2186232,1910,63.13751619423692,79.15342133727472
12745,CR_10250C_A,3365,CR,2186349,2187698,1349,296.07399999400974,371.17820720792395
12747,CR_10260W_A,198,CR,2188415,2189230,815,28.83598120179764,36.1507184210069
12749,CR_10270C_A,867,CR,2189291,2190331,1040,98.9493419633655,124.04952598035928
12751,CR_10280W_A,342,CR,2190995,2191321,326,124.51900973503527,156.10537499980254
12753,CR_10290C_A,1112,CR,2191398,2195222,3824,34.51549100255321,43.27093250838688
12755,CR_10300W_A,1958,CR,2195626,2196444,818,284.11001038744797,356.1793480939603
12757,CR_10310W_A,21,CR,2197472,2197963,491,5.076506596193777,6.364248861070307
12759,CR_10320W_A,2,CR,2199524,2199919,395,0.6009800455047967,0.7534288585377991
12761,CR_10330W_A,52,CR,2201576,2201950,374,16.502847773621024,20.689075874821373
12763,CR_10340W_A,6755,CR,2206795,2209563,2768,289.65859499946464,363.1354255910438
12765,CR_10350C_A,988,CR,2210175,2210486,311,377.0714992905177,472.7221002137643
12767,CR_10360C_A,1638,CR,2211476,2213536,2060,94.37866486457733,118.31941887440323
12769,CR_10370W_A,3124,CR,2214108,2214965,857,432.670569750297,542.4248208042434
12771,CR_10380C_A,262,CR,2215084,2216109,1025,30.339231663068983,38.035293936622836
12773,CR_10390W_A,166,CR,2216407,2217153,746,26.41170347436295,33.111481403702065
12775,CR_10400W_A,605,CR,2217315,2217947,632,113.62278985325062,142.44514356730258
12777,CR_10410C_A,568,CR,2217987,2218817,830,81.2264355478652,101.83090283225336
12779,CR_10420W_A,995,CR,2219749,2221599,1850,63.8378871309521,80.0314532775185
12781,CR_10430C_A,92,CR,2221721,2222299,578,18.892400392425877,23.68477916891316
12783,CR_10440W_A,379,CR,2222852,2225545,2693,16.70436645233858,20.94171319483869
12785,CR_10450C_A,302,CR,2225562,2226548,986,36.35441664719433,45.57633292848581
12787,CR_10460W_A,23,CR,2226852,2226936,84,32.499426865542134,40.743459403666094
12789,CR_10470C_A,1133,CR,2227306,2228901,1595,84.31335569435399,105.70087279175982
12791,CR_10480W_A,882,CR,2229306,2229704,398,263.03446991635195,329.7576382235977
12793,CR_10490W_A,1885,CR,2230203,2230832,629,355.70327295845317,445.93345973432565
12795,CR_10500C_A,292,CR,2230879,2231769,890,38.94215643175464,48.82049693469085
12797,CR_10510W_A,624,CR,2231968,2235234,3266,22.677520149421664,28.430058948621664
12799,CR_10520C_A,67,CR,2235243,2235953,710,11.20065979174961,14.04189770507243
12801,CR_10530W_A,273,CR,2236119,2237606,1487,21.791083795228566,27.318762932220427
12803,CR_10540C_A,641,CR,2237629,2239323,1694,44.91297007720987,56.3059090429392
12805,CR_10550W_A,2108,CR,2240734,2242575,1841,135.90767101847476,170.38296397340673
12807,CR_10570C_A,471,CR,2244004,2245206,1202,46.50970572626452,58.307683854685855
12809,CR_10580W_A,958,CR,2245713,2246984,1271,89.46375256470108,112.15775545211977
12811,CR_10590W_A,795,CR,2247055,2249460,2405,39.23550078786773,49.188253077407964
12813,CR_10600C_A,1090,CR,2249443,2250489,1046,123.68640468073148,155.061565508341
12815,CR_10610C_A,161,CR,2250555,2250956,401,47.6550199424907,59.74352650712135
12817,CR_10620C_A,1610,CR,2251020,2253017,1997,95.69185276383963,119.96571922561674
12819,CR_10630W_A,160,CR,2253074,2254015,941,20.181689094528778,25.30111788501004
12821,CR_10640W_A,397,CR,2254171,2255601,1430,32.95198805448766,41.310820437624095
12823,CR_10650W_A,645,CR,2255688,2256839,1151,66.51376676519749,83.38611530580701
12825,CR_10660W_A,1135,CR,2257148,2258155,1007,133.78072437981032,167.71648113404106
12827,CR_10670W_A,2514,CR,2258666,2259775,1109,269.0672743857657,337.3207661829533
12829,CR_10680W_A,8269,CR,2260358,2265544,5186,189.2551174826716,237.26289783488028
12831,CR_10690W_A,144,CR,2265597,2266343,746,22.911357230772676,28.723212783934315
12833,CR_10700W_A,622,CR,2266418,2267389,971,76.03233129766916,95.3192256715509
12835,CR_10710C_A,419,CR,2267386,2268957,1571,31.65665258792851,39.68690109239287
12837,CR_10720W_A,323,CR,2269081,2270994,1913,20.040783874994638,25.12446965931654
12839,CR_10730C_A,792,CR,2270978,2271985,1007,93.35183586679275,117.0321172318595
12841,CR_10740W_A,277,CR,2272097,2272774,677,48.56442516906007,60.88361784114718
12843,CR_10750C_A,379,CR,2272778,2273182,404,111.34866053501929,139.59414265767472
12845,CR_10760C_A,192,CR,2273274,2273660,386,59.03928322679247,74.01560185428326
12847,CR_10770W_A,542,CR,2274183,2275754,1571,40.94965561493378,51.33723243932443
12849,CR_10780C_A,274,CR,2275766,2276572,806,40.349919556441776,50.585363126269215
12851,CR_10790W_A,246,CR,2276745,2278457,1712,17.05526606942205,21.381624469660608
12853,CR_10800C_A,1914,CR,2278465,2281236,2771,81.98465243648349,102.78145433423532
12855,CR_10810C_A,738,CR,2281329,2282324,995,88.03602666588105,110.3678625891225
12857,CR_10820W_A,309,CR,2282415,2282765,350,104.7894563629828,131.37108475547294
12859,CR_10830C_A,1041,CR,2282796,2283272,476,259.5798212304043,325.42665912442254
12861,CR_10840C_A,2374,CR,2283372,2284454,1082,260.4237606613739,326.4846781500232
12863,CR_10850C_A,6131,CR,2284743,2285228,485,1500.4334229907363,1881.0438876490946
12865,CR_10860C_A,470,CR,2285377,2286198,821,67.94880965162334,85.18518123480047
