,A22,read_count,chromosome,start,end,length,rpkm,tpm
0,C1_00010W_A,6,C1,4059,4397,338,1.9847467081599754,2.4764988566084827
2,C1_00020C_A,4,C1,4409,4720,311,1.438037271935845,1.7943335767066817
4,C1_00030C_A,15,C1,8597,8908,311,5.392639769759419,6.7287509126500575
6,C1_00040W_A,643,C1,10718,11485,767,93.73162561304653,116.95510701915427
8,C1_00050C_A,21,C1,11648,11995,347,6.76644194741571,8.442934142270417
10,C1_00060W_A,7438,C1,12163,13701,1538,540.7174418258927,674.6886748443234
12,C1_00070W_A,3047,C1,13778,14917,1139,299.1019678489969,373.2091749249464
14,C1_00080C_A,815,C1,14910,15761,851,107.07759022656256,133.60774383665074
16,C1_00090W_A,104,C1,15595,16116,521,22.318559272309486,27.848332631958215
18,C1_00100C_A,515,C1,16600,17328,728,79.09451911387521,98.69142764877256
20,C1_00110W_A,4083,C1,17338,18960,1622,281.4485854483155,351.181889956634
22,C1_00120C_A,735,C1,18948,19628,680,120.85064331082908,150.79328699687386
24,C1_00130C_A,1089,C1,19615,21714,2099,58.007744785845645,72.38007401446431
26,C1_00140W_A,1850,C1,22270,25326,3056,67.68445225853145,84.45433764383094
28,C1_00150C_A,1285,C1,25381,27249,1868,76.91247660199163,95.96874985642062
30,C1_00160C_A,4783,C1,28286,29488,1202,444.9041465243562,555.1361317986036
32,C1_00170W_A,264,C1,29804,31543,1739,16.97363602286093,21.179120756458513
34,C1_00180W_A,14453,C1,31842,32444,602,2684.306182305152,3349.385170377101
36,C1_00190C_A,641,C1,32680,33318,638,112.33313800849633,140.16543606977027
38,C1_00200C_A,186,C1,34099,34446,347,59.93134296282484,74.78027383153797
40,C1_00210C_A,2518,C1,34525,35679,1154,243.9610293714074,304.406203477437
42,C1_00220W_A,17653,C1,37851,39485,1634,1207.916765609143,1507.1971030915774
44,C1_00230C_A,931,C1,40484,41770,1286,80.9429917872427,100.9978884395858
46,C1_00240C_A,1,C1,42100,42172,72,1.5528805262918324,1.9376310498464517
48,C1_00270W_A,26,C1,42605,43504,899,3.2335843662050174,4.034755645508962
50,C1_00280C_A,1,C1,43549,43679,130,0.8600569068693226,1.0731495045303425
52,C1_00290W_A,146,C1,43803,45764,1961,8.324263178164072,10.386730033649108
54,C1_00310W_A,268,C1,46803,48359,1556,19.257315318333678,24.028617440769363
56,C1_00320W_A,379,C1,48513,49298,785,53.98089656235864,67.35551094039486
58,C1_00330C_A,357,C1,49295,49843,548,72.83803110913371,90.88479654243284
60,C1_00340W_A,650,C1,49997,50743,746,97.4193145180399,121.55647873031359
62,C1_00350C_A,1330,C1,50806,51681,875,169.94724479737815,212.05434209519566
64,C1_00360W_A,556,C1,53099,54442,1343,46.288096223763695,57.75669857591448
66,C1_00370W_A,77,C1,54558,54842,284,30.313977597753237,37.824741339256086
68,C1_00380C_A,827,C1,54837,57074,2237,41.33425036098385,51.575459647768035
70,C1_00390W_A,8133,C1,59349,62552,3203,283.89933408175654,354.239850029624
72,C1_00400W_A,3252,C1,63202,64350,1148,316.72269856104083,395.1957182362784
74,C1_00410C_A,1154,C1,64696,66324,1628,79.25413830991141,98.89059500592259
76,C1_00420W_A,1085,C1,67843,68814,971,124.93411608024508,155.88850423687418
78,C1_00430W_A,903,C1,69226,70902,1676,60.23990471204642,75.1652865971461
80,C1_00440W_A,2837,C1,71068,72581,1513,209.64810827658619,261.59171762447824
82,C1_00450C_A,841,C1,72741,73283,542,173.48712477495027,216.4712828972368
84,C1_00460W_A,1357,C1,73580,73900,320,474.1332466900538,591.6072002943678
86,C1_00470C_A,532,C1,74056,75381,1325,44.89172504081687,56.014354515712064
88,C1_00480C_A,1978,C1,75573,77828,2255,98.07318538021183,122.37235636138902
90,C1_00490C_A,1510,C1,78008,78367,359,470.2762418341171,586.7945619479282
92,C1_00500C_A,3223,C1,78641,79669,1028,350.540120047838,437.3919366762336
94,C1_00510W_A,627,C1,80124,81053,929,75.46096714630623,94.15760615098839
96,C1_00520W_A,411,C1,81233,81901,668,68.79167744614958,85.83589525008412
98,C1_00530C_A,927,C1,82117,84558,2441,42.46024491881282,52.9804370302956
100,C1_00540C_A,1391,C1,85080,87248,2168,71.73620409095001,89.50997458681819
102,C1_00550W_A,569,C1,87900,89810,1910,33.30806774927947,41.560664319429016
104,C1_00560W_A,736,C1,90099,91271,1172,70.2135194959529,87.61002098418358
106,C1_00570C_A,910,C1,91310,93694,2384,42.678159430637955,53.25234328269274
108,C1_00580W_A,190,C1,93970,94899,929,22.866959741304917,28.53260792454193
110,C1_00590W_A,15293,C1,95214,96494,1280,1335.8363562326808,1666.8107800482253
112,C1_00600W_A,1026,C1,96816,101423,4607,24.90001958719997,31.069390257056018
114,C1_00610W_A,3332,C1,101751,103523,1772,210.23828994329335,262.3281260622817
116,C1_00620W_A,798,C1,103868,104809,941,94.81647557770833,118.30874558977442
118,C1_00630W_A,527,C1,105179,106924,1745,33.766474893763494,42.13264902886748
120,C1_00640C_A,5723,C1,107125,111027,3902,163.9860938343689,204.61622241812645
122,C1_00650C_A,1321,C1,111571,112251,680,217.20231267157175,271.01759472499367
124,C1_00660C_A,757,C1,112788,113801,1013,83.55202389438308,104.2533492012152
126,C1_00670C_A,530,C1,114127,115878,1751,33.842330601539885,42.227299178835295
128,C1_00680W_A,247,C1,117319,119442,2123,13.008208798668843,16.23119669828982
130,C1_00690W_A,182,C1,119767,122808,3041,6.691531212274967,8.349463096740514
132,C1_00700W_A,219,C1,123066,123431,365,67.08443873580718,83.70566135336671
134,C1_00710C_A,2373,C1,123869,125597,1728,153.54106203710492,191.5832700535679
136,C1_00720W_A,2,C1,126521,126612,91,2.4573054481980647,3.0661414415152644
138,C1_00730C_A,1316,C1,126791,128620,1829,80.4475317808659,100.37967044015909
140,C1_00740C_A,951,C1,129260,130681,1421,74.8267666405731,93.36627251589461
142,C1_00750C_A,1927,C1,131413,133938,2525,85.32786365934022,106.4691811405529
144,C1_00760W_A,506,C1,134254,134913,659,85.84907941405773,107.11953627921993
146,C1_00770C_A,171,C1,135654,136436,782,24.44893227583765,30.506538984283264
148,C1_00780C_A,189,C1,138574,140931,2357,8.965463810682758,11.186798186809721
150,C1_00790W_A,223,C1,150607,151707,1100,22.666408845583334,28.28236739666784
152,C1_00800C_A,1880,C1,154633,155286,653,321.89572440867147,401.6504424306519
154,C1_00810W_A,140,C1,155443,156324,881,17.76735040297579,22.169490331954858
156,C1_00820W_A,34,C1,156643,157689,1046,3.6342748837116696,4.534723527747719
158,C1_00830W_A,237,C1,158725,160524,1799,14.729490439490734,18.378952881923205
160,C1_00840C_A,535,C1,160942,162672,1730,34.57627622702971,43.14309135265047
162,C1_00850W_A,161,C1,167077,167823,746,24.130014826776037,30.108604731662286
164,C1_00860W_A,177,C1,168533,169534,1001,19.77013928777534,24.668501597645534
166,C1_00870W_A,1142,C1,170158,172254,2096,60.91796201995213,76.01134324550316
168,C1_00880W_A,165,C1,174459,176084,1625,11.35275117067506,14.16557345980052
170,C1_00890W_A,292,C1,176325,178475,2150,15.185004737097438,18.947327996265955
172,C1_00900W_A,511,C1,178690,179307,617,92.59899566179759,115.54185022034139
174,C1_00910W_A,180,C1,179823,180829,1006,20.005299821811285,24.96192684494037
176,C1_00920W_A,465,C1,181403,185239,3836,13.553295104340602,16.911336691569137
178,C1_00930C_A,3192,C1,185507,190145,4638,76.94894654473785,96.01425579989454
180,C1_00940W_A,194,C1,190698,191156,458,47.359465483066195,59.09351638483676
182,C1_00950C_A,1024,C1,191444,193405,1961,58.3838732495891,72.84939420860744
184,C1_00960C_A,1076,C1,194676,197798,3122,38.53451637824499,48.08204762770797
186,C1_00970W_A,107,C1,198221,198746,525,22.78741252295672,28.43335163431821
188,C1_00980W_A,412,C1,198951,199220,269,171.24404435658337,213.67244409905254
190,C1_00990C_A,1552,C1,199316,202249,2933,59.16300086258252,73.82156291648205
192,C1_01000C_A,410,C1,202532,203623,1091,42.01744558765802,52.4279272149104
194,C1_01010W_A,1161,C1,203945,204415,470,276.1880616038018,344.61798876332887
196,C1_01020W_A,2,C1,204985,205057,72,3.1057610525836647,3.8752620996929035
198,C1_01030W_A,1368,C1,205265,206284,1019,150.1006087513644,187.2903904668068
200,C1_01040W_A,399,C1,206477,206920,443,100.70237417451867,125.65296794579876
202,C1_01050C_A,629,C1,206917,207855,938,74.97532332058051,93.55163644503848
204,C1_01060W_A,4727,C1,208285,208740,455,1161.5682853632252,1449.3650594042651
206,C1_01070C_A,416,C1,209078,210502,1424,32.66283533953158,40.75556545295008
208,C1_01080W_A,273,C1,210872,212377,1505,20.281341943383563,25.30636273473877
210,C1_01090C_A,829,C1,212439,212747,308,300.9361456276198,375.49779903647726
212,C1_01100W_A,3699,C1,213635,220399,6764,61.143637611805325,76.292933507319
214,C1_01110C_A,823,C1,220539,222068,1529,60.18148362717386,75.09239077155091
216,C1_01130W_A,2687,C1,224667,226874,2207,136.12436707681155,169.85131555391658
218,C1_01140C_A,1359,C1,227677,229779,2102,72.2865146225515,90.1966331899979
220,C1_01150C_A,591,C1,232865,234934,2069,31.93725092062352,39.85020610588023
222,C1_01160C_A,485,C1,235077,235889,812,66.78151228831379,83.32768012393852
224,C1_01170C_A,550,C1,236084,238300,2216,27.75003106550387,34.62553681133551
226,C1_01180C_A,106,C1,239091,240914,1823,6.5011432675037115,8.111903550426835
228,C1_01190C_A,480,C1,241113,242504,1391,38.581992083857465,48.14128618453873
230,C1_01200W_A,529,C1,242741,244663,1922,30.773212011135964,38.39775828644727
232,C1_01210W_A,459,C1,245206,246453,1247,41.154447179544896,51.35110740603491
234,C1_01220C_A,444,C1,246661,247413,752,66.01394237300173,82.36993271474915
236,C1_01240W_A,351,C1,248816,249865,1049,37.4112456248305,46.680468914889914
238,C1_01250W_A,1590,C1,250103,251977,1874,94.8632671557572,118.36713051569998
240,C1_01260C_A,106,C1,252036,252488,452,26.22031897490988,32.71681454077017
242,C1_01270W_A,469,C1,253158,254441,1283,40.87113765535667,50.99760350055727
244,C1_01280C_A,26,C1,254618,254965,347,8.377499553943258,10.453156557096708
246,C1_01290C_A,649,C1,255170,257443,2273,31.923889675567423,39.83353440265068
248,C1_01300W_A,820,C1,257921,258904,983,93.26761573984719,116.37613141702391
250,C1_01310W_A,17,C1,258992,259345,353,5.384492249805108,6.718584716748037
252,C1_01320W_A,3895,C1,259647,261173,1526,285.37995726951607,356.08732085120505
254,C1_01330C_A,534,C1,261359,261838,479,124.64540808949558,155.5282643100133
256,C1_01340C_A,105,C1,262217,263083,866,13.556324224903296,16.915116324294658
258,C1_01350C_A,13379,C1,263479,264672,1193,1253.8735762033589,1564.5404348235445
260,C1_01360C_A,1301,C1,265483,267465,1982,73.39123343027676,91.57506342140103
262,C1_01370C_A,3732,C1,269372,270012,640,651.9768889636259,813.5143962780327
264,C1_01380C_A,806,C1,270319,271974,1655,54.451216133998564,67.94235956778807
266,C1_01390C_A,1850,C1,272374,274197,1823,113.46334948001761,141.5756751725438
268,C1_01400C_A,1416,C1,275477,276952,1475,107.33510197729147,133.92905816538672
270,C1_01420C_A,2055,C1,278222,279262,1040,220.92711795205727,275.6652789762317
272,C1_01440C_A,14,C1,280421,280819,398,3.9329235439752943,4.907367081018149
274,C1_01450W_A,1973,C1,282437,284137,1700,129.762350613478,161.91300965705145
276,C1_01460W_A,954,C1,284639,287617,2978,35.817413562771456,44.691739943536966
278,C1_01470W_A,2399,C1,288033,289328,1295,207.12428381879198,258.44257604469334
280,C1_01480C_A,9531,C1,289699,290448,749,1422.745406299462,1775.2529113461017
282,C1_01490W_A,2945,C1,291847,292449,602,546.9647621178077,682.4838667930924
284,C1_01500W_A,3,C1,296046,296504,458,0.7323628682948381,0.9138172636830426
286,C1_01510W_A,1292,C1,299614,301767,2153,67.09482493161703,83.71862089220451
288,C1_01520C_A,1885,C1,305308,306012,704,299.3706605516016,373.5444404618755
290,C1_01530C_A,2914,C1,306618,308486,1868,174.4147523877071,217.6287448105912
292,C1_01540W_A,666,C1,309122,310972,1850,40.250663241484304,50.22339681202003
294,C1_01550W_A,882,C1,311200,312759,1559,63.25473055909976,78.9270828668692
296,C1_01560W_A,2240,C1,313161,317798,4637,54.01090603414853,67.39295572983302
298,C1_01570C_A,287,C1,317950,318471,521,61.5906395303156,76.85068716703853
300,C1_01580W_A,1007,C1,318929,319459,530,212.4340559967227,265.0679276189946
302,C1_01590C_A,5002,C1,319665,323369,3704,150.98828408770135,188.3980013001891
304,C1_01600W_A,1172,C1,323650,324531,881,148.7381048020545,185.5903047789364
306,C1_01610C_A,121,C1,324887,325940,1053,12.847763670517043,16.03099877137919
308,C1_01620C_A,202,C1,326428,327426,998,22.630355084557532,28.237380750467725
310,C1_01630W_A,816,C1,331354,332037,683,133.57955590146085,166.6759874679044
312,C1_01640W_A,839,C1,332721,334077,1356,69.17876610046979,86.31889119404457
314,C1_01650W_A,874,C1,334643,336025,1382,70.70887536793954,88.22810904829052
316,C1_01660C_A,3,C1,336119,336200,81,4.14101473677822,5.16701613292387
318,C1_01670C_A,291,C1,336700,341496,4796,6.783976811273243,8.464813543866315
320,C1_01680C_A,571,C1,341928,342440,512,124.69145350958951,155.5857182056393
322,C1_01690C_A,2888,C1,342930,343901,971,332.5435274099058,414.9364057475507
324,C1_01700W_A,1038,C1,345562,348762,3200,36.26752469154575,45.25337316916388
326,C1_01710W_A,723,C1,351098,353101,2003,40.357837581950896,50.357125277487214
328,C1_01720C_A,70,C1,353541,353627,86,91.00602154082367,113.55419175844321
330,C1_01730W_A,1,C1,354206,354278,72,1.5528805262918324,1.9376310498464517
332,C1_01740W_A,613,C1,357079,359466,2387,28.713001637375918,35.82709845664976
334,C1_01750W_A,687,C1,361029,362930,1901,40.40593495660137,50.4171395316175
336,C1_01760W_A,547,C1,364172,366307,2135,28.6457361346499,35.74316686986072
338,C1_01770W_A,159,C1,366730,367860,1130,15.73219138494593,19.6300887244621
340,C1_01780C_A,2359,C1,367933,369807,1874,140.74367749712658,175.6151326330417
342,C1_01790W_A,1164,C1,372225,375440,3215,40.48019009252438,50.50979254293356
344,C1_01800W_A,222,C1,375835,376554,719,34.52189475973387,43.07523602329023
346,C1_01810C_A,1303,C1,376645,378174,1529,95.28125536598729,118.88868186552956
348,C1_01820C_A,420,C1,378463,379650,1187,39.5611685889343,49.36306903736874
350,C1_01830C_A,1030,C1,380212,380784,572,201.3315031989551,251.21454310596653
352,C1_01840C_A,297,C1,381538,382092,554,59.94006710148836,74.79115951248468
354,C1_01850C_A,466,C1,382760,383590,830,62.773792070052494,78.32698431861222
356,C1_01860W_A,943,C1,383753,384670,917,114.97750950175602,143.4649921050978
358,C1_01870C_A,2567,C1,384790,386280,1490,192.6238861686991,240.34947728645673
360,C1_01880C_A,542,C1,386597,388924,2327,26.041946565540382,32.49424756734333
362,C1_01890C_A,2022,C1,389271,390800,1529,147.85778844975158,184.4918762333851
364,C1_01900C_A,498,C1,391247,392764,1517,36.70407656606457,45.79808762247486
366,C1_01910W_A,789,C1,393296,394360,1064,82.90980915186694,103.45201567638836
368,C1_01920W_A,3206,C1,395587,399411,3824,93.73810607871242,116.96319312190275
370,C1_01930W_A,2310,C1,400591,401977,1386,186.3456631550199,232.5157259815742
372,C1_01940C_A,394,C1,402263,402769,506,87.05951535542827,108.62987672340739
374,C1_01950C_A,244,C1,403144,403689,545,50.05689006586223,62.45927024532562
376,C1_01970W_A,6,C1,405749,406027,278,2.4131093070434235,3.010995012711033
378,C1_01980W_A,6032,C1,406673,408310,1637,411.9866976729677,514.0628683399592
380,C1_01990W_A,16,C1,411340,412368,1028,1.740192963315361,2.1713530830964127
382,C1_02000W_A,319,C1,412817,413818,1001,35.630928998871944,44.459050901971324
384,C1_02010C_A,264,C1,414090,416273,2183,13.521371069058706,16.8715029754839
386,C1_02020W_A,109,C1,416452,417075,623,19.561807978071112,24.408552936107466
388,C1_02030C_A,167,C1,417078,417521,443,42.14861274973588,52.591593100121294
390,C1_02040C_A,4184,C1,418019,420493,2474,189.0873697592409,235.93673342932252
392,C1_02050C_A,1142,C1,421264,423846,2582,49.45160665910908,61.704018374351136
394,C1_02060W_A,419,C1,425985,426615,630,74.36079320186033,92.78484684407579
396,C1_02070W_A,10,C1,427843,428838,995,1.1236924411357985,1.4021048802908997
398,C1_02080W_A,208,C1,429371,430510,1139,20.417856682832735,25.476701143547373
400,C1_02090C_A,255,C1,430507,431994,1487,19.173427345472795,23.923944905972327
402,C1_02100W_A,157,C1,432225,433841,1616,10.862476156684949,13.553825116005129
404,C1_02110C_A,2027,C1,434412,436049,1637,138.44446886324693,172.7462589729936
406,C1_02120C_A,3990,C1,442448,444235,1787,249.64270710303174,311.4956060435863
408,C1_02130C_A,4795,C1,449253,450800,1547,346.55234188558,432.416123884285
410,C1_02140C_A,20,C1,451280,451624,344,6.500430110058834,8.111013697031657
412,C1_02150W_A,5172,C1,452164,454191,2027,285.2826156401864,355.96586130538776
414,C1_02160W_A,151,C1,454396,454902,506,33.36544877834942,41.632262399072374
416,C1_02170C_A,288,C1,454861,455823,962,33.47248502410338,41.765818554694405
418,C1_02180W_A,865,C1,456751,457911,1160,83.37361998056494,104.03074291761811
420,C1_02190W_A,169,C1,458366,459304,938,20.144403245116223,25.135495324660578
422,C1_02200C_A,75,C1,459294,460130,836,10.030567992794134,12.515798647333538
424,C1_02210W_A,932,C1,461070,462782,1712,60.86711146979389,75.94789367342072
426,C1_02220C_A,387,C1,462849,463859,1010,42.84105245999567,53.45559561675398
428,C1_02230W_A,974,C1,465637,467649,2012,54.12545007345608,67.53587985269978
430,C1_02240W_A,1749,C1,469116,471743,2627,74.43895657208904,92.88237641608829
432,C1_02250W_A,1183,C1,474919,475644,725,182.43882994128708,227.64091351961565
434,C1_02260C_A,534,C1,475896,477035,1139,52.4189205222725,65.40653082045336
436,C1_02270C_A,344,C1,477305,478183,878,43.80608755717097,54.65973330591903
438,C1_02280C_A,221,C1,478626,481568,2942,8.398856197945493,10.479804644852731
440,C1_02290C_A,280,C1,482379,483590,1211,25.85142147815305,32.25651689917792
442,C1_02300W_A,65,C1,483698,484063,365,19.91090647409802,24.84414606378464
444,C1_02310C_A,88,C1,484174,484539,365,26.956304149548085,33.635151594046896
446,C1_02320C_A,1528,C1,484846,486477,1631,104.74659962018532,130.69921372158626
448,C1_02330C_A,666,C1,487350,488196,846,88.01858983066899,109.82657695299886
450,C1_02340C_A,27,C1,488645,488749,104,29.026920606839642,36.21879577789906
452,C1_02350W_A,460,C1,489332,490138,806,63.81067373546588,79.62076969096088
454,C1_02360C_A,163,C1,490252,492177,1925,9.467327717694,11.813006753765173
456,C1_02370C_A,427,C1,492588,496217,3629,13.155623835854533,16.415136124684295
458,C1_02380C_A,56,C1,498351,498953,602,10.400688176094134,12.977621915250653
460,C1_02390W_A,383,C1,499217,501709,2492,17.183881778901917,21.441458198461376
462,C1_02400C_A,120,C1,502050,503384,1334,10.057636991875139,12.549574415797107
464,C1_02410C_A,256,C1,504151,505224,1073,26.6753903640364,33.284637009105126
466,C1_02420C_A,11162,C1,505969,511662,5693,219.21555863021243,273.52965396869814
468,C1_02430C_A,2337,C1,515594,517525,1931,135.31532308439614,168.841818214067
470,C1_02440C_A,594,C1,518168,519169,1001,66.34724710134775,82.78581892091213
472,C1_02450C_A,179,C1,520056,520586,530,37.76136645820592,47.11733768003975
474,C1_02460W_A,10743,C1,521288,521950,662,1814.4212621822167,2263.9726080544274
476,C1_02470W_A,26,C1,522615,523085,470,6.185090096209172,7.717543245345866
478,C1_02480W_A,205,C1,523976,524734,758,30.238148506685288,37.73012440070399
480,C1_02490C_A,564,C1,524841,526862,2021,31.202064528282403,38.932865745751954
482,C1_02500W_A,100,C1,527100,527726,626,17.860606692174432,22.28585233050232
484,C1_02510W_A,157,C1,528029,528760,731,24.01335358304087,29.963038833740473
486,C1_02520W_A,407,C1,530172,531908,1736,26.212909529064436,32.707569288421894
488,C1_02530C_A,8829,C1,532403,534163,1760,560.8792704530696,699.8459129629496
490,C1_02540C_A,1,C1,536532,536604,72,1.5528805262918324,1.9376310498464517
492,C1_02560W_A,5,C1,536928,537227,299,1.8696889279767883,2.3329337055007446
494,C1_02570C_A,289,C1,537385,539079,1694,19.074579687768864,23.80060618961332
496,C1_02580W_A,388,C1,540001,541512,1511,28.71030468728566,35.823733294844786
498,C1_02590C_A,7938,C1,541722,542600,878,1010.8509390372766,1261.3051249487946
500,C1_02600W_A,912,C1,544056,544805,749,136.1393149244685,169.8699669654438
502,C1_02610W_A,1474,C1,545022,549395,4373,37.686737821701264,47.024218627510685
504,C1_02620C_A,1780,C1,549494,550573,1079,184.4459390635415,230.14531542939875
506,C1_02630C_A,585,C1,550937,552376,1439,45.453320199730356,56.71509368973769
508,C1_02640C_A,1676,C1,552858,553373,515,363.8625220751224,454.01517290693397
510,C1_02650W_A,1601,C1,553758,554360,602,297.3482458915484,371.0209408270767
512,C1_02660C_A,806,C1,554577,555404,827,108.96827412547476,135.96687434666174
514,C1_02670C_A,37,C1,555675,558101,2426,1.7052241228530265,2.127720163557686
516,C1_02680C_A,219,C1,558921,561449,2528,9.685846573801273,12.085667086225811
518,C1_02690C_A,5,C1,562357,562659,302,1.851115859155827,2.309758867366631
520,C1_02700C_A,403,C1,564255,564428,173,260.45307139239196,324.9844077592176
522,C1_02710W_A,4017,C1,565683,567173,1490,301.42974317867714,376.1136931280471
524,C1_02720W_A,442,C1,567442,568635,1193,41.424031742423544,51.68748577561901
526,C1_02730W_A,162,C1,574220,575107,887,20.420291385194965,25.47973908163361
528,C1_02740C_A,151,C1,575478,576398,920,18.35099682809218,22.897744319489803
530,C1_02750C_A,1236,C1,576658,579045,2387,57.89440460651981,72.23865202678485
532,C1_02760W_A,1703,C1,579750,580802,1052,180.9961963990488,225.84084487449857
534,C1_02770W_A,236,C1,581212,581508,296,89.14373615794196,111.23049594253683
536,C1_02780W_A,1061,C1,581844,582602,758,156.50085641752727,195.27639994705822
538,C1_02790W_A,3341,C1,582899,583951,1052,355.0841410271416,443.0618101736346
540,C1_02800W_A,44,C1,584332,584934,602,8.17196928121682,10.196702933411228
542,C1_02810W_A,2208,C1,585914,588472,2558,96.50927855659515,120.42096707599276
544,C1_02820W_A,5862,C1,588902,593116,4214,155.53274002108117,194.0684175183656
546,C1_02830W_A,604,C1,593697,595466,1769,38.175052757139184,47.633521252528254
548,C1_02840W_A,733,C1,598018,599733,1715,47.78706860383542,59.627064890201936
550,C1_02850W_A,1689,C1,600683,602722,2039,92.61534823016046,115.56225439417717
552,C1_02860C_A,695,C1,603130,603732,602,129.07996932831114,161.06155769820003
554,C1_02870W_A,291,C1,604676,605542,866,37.57038428044628,46.87903667018805
556,C1_02880C_A,2166,C1,605725,606483,758,319.49185202673334,398.65097293621875
558,C1_02890C_A,274,C1,607149,607523,374,81.91237171840983,102.20744746355828
560,C1_02900C_A,543,C1,607807,609984,2177,27.887651380755848,34.79725471970458
562,C1_02910C_A,311,C1,610205,611635,1430,24.316154366941756,30.34086326444877
564,C1_02920W_A,913,C1,611934,613046,1112,91.79869988877688,114.54326860854887
566,C1_02930C_A,842,C1,613106,614473,1367,68.8674681974514,85.93046434959128
568,C1_02940C_A,535,C1,614701,615219,518,115.47675265011851,144.08793057931527
570,C1_02950W_A,79,C1,615467,615844,377,23.429136428509135,29.23407270961967
572,C1_02960C_A,1560,C1,615939,617726,1787,97.60466743877932,121.78775574636454
574,C1_02970W_A,2055,C1,618379,619644,1265,181.63178076690875,226.6339052452814
576,C1_02980W_A,802,C1,620103,621131,1028,87.22717228618247,108.83907329020768
578,C1_02990C_A,2204,C1,622222,623538,1316,187.25190346215678,233.64650154865785
580,C1_03000W_A,349,C1,628046,629806,1760,22.1708987867393,27.66408694348956
582,C1_03010W_A,2565,C1,630193,630513,320,896.2061737361739,1118.2553196426334
584,C1_03020C_A,16415,C1,631014,631622,608,3018.615849364788,3766.525304592967
586,C1_03030W_A,8651,C1,632083,632838,755,1281.1202638045647,1598.537916927098
588,C1_03040W_A,236,C1,633766,634524,758,34.81074657354989,43.435655407639715
590,C1_03050W_A,1007,C1,635104,638259,3155,35.6862281072149,44.52805123235092
592,C1_03060C_A,517,C1,638337,638966,629,91.89892640808772,114.66832782111975
594,C1_03070C_A,1384,C1,639143,641560,2417,64.0221095092795,79.88459199631741
596,C1_03080C_A,383,C1,641962,642642,680,62.97387263679938,78.5766379861261
598,C1_03090W_A,16338,C1,643226,643996,770,2372.3496971117265,2960.13656967815
600,C1_03100W_A,4740,C1,645104,649550,4446,119.20086954855526,148.73475589104746
602,C1_03110W_A,6816,C1,650064,650956,892,854.34890587306,1066.0272566975848
604,C1_03120W_A,699,C1,651902,653134,1232,63.43617786299947,79.15348658820795
606,C1_03130C_A,2162,C1,653447,655201,1754,137.81504803004094,171.96088924931473
608,C1_03140W_A,207,C1,655798,656274,476,48.622124713977875,60.66901925821747
610,C1_03150C_A,897,C1,656446,657201,755,132.83607405302214,165.74829632222946
612,C1_03160C_A,2171,C1,657572,658543,971,249.98337881125536,311.9206845145196
614,C1_03170C_A,118,C1,658804,660771,1967,6.707307041878703,8.369147635737393
616,C1_03180W_A,114,C1,660929,661792,863,14.769459281348045,18.428824631679806
618,C1_03190C_A,7003,C1,662177,664336,2159,362.6619765839568,452.5171734272248
620,C1_03200C_A,1266,C1,668763,671960,3197,44.275309894448895,55.24521284191547
622,C1_03210C_A,2534,C1,672483,673838,1355,209.09221126265112,260.8980884002844
624,C1_03220C_A,9248,C1,675074,675868,794,1302.2604731921595,1624.9159449956662
626,C1_03230C_A,1508,C1,677396,679090,1694,99.53102480676625,124.19139838732488
628,C1_03240W_A,429,C1,679785,680210,425,112.85970281435795,140.8224655709581
630,C1_03250C_A,446,C1,680242,681462,1220,40.87385201662568,51.000990387433816
632,C1_03260W_A,444,C1,681644,683680,2036,24.38235985486115,30.423472201125424
634,C1_03270W_A,329,C1,683901,685105,1204,30.552021517276522,38.12176437604879
636,C1_03280W_A,2933,C1,685412,686344,932,351.8574013092318,439.0355950454659
638,C1_03290W_A,924,C1,686628,688511,1883,54.86459673560438,68.45816170163819
640,C1_03300C_A,1718,C1,688617,690020,1403,136.91027054896261,170.8319389464053
642,C1_03310W_A,650,C1,690480,691616,1136,63.97430337188183,79.82494113804043
644,C1_03320C_A,539,C1,691821,693329,1508,39.962989034703874,49.864446805332285
646,C1_03330C_A,666,C1,694143,695732,1589,46.86200566189173,58.47280308510827
648,C1_03340C_A,800,C1,696019,696900,881,101.5277165884331,126.68280189688491
650,C1_03350C_A,3394,C1,697530,699398,1868,203.14470473708914,253.47699378419574
652,C1_03360W_A,2551,C1,701716,705948,4232,67.39618904184157,84.09465269078389
654,C1_03370W_A,9503,C1,706488,708377,1889,562.4699323331353,701.8306862899628
656,C1_03380W_A,2618,C1,709461,712127,2666,109.79436147183245,136.997637798896
658,C1_03390W_A,1380,C1,712967,714244,1277,120.82553570270672,150.76195858476385
660,C1_03400W_A,704,C1,715541,717490,1949,40.38604828972828,50.392325630896316
662,C1_03410W_A,97,C1,717686,718510,824,13.16179319857058,16.422834043844198
664,C1_03420W_A,1,C1,719205,719309,104,1.0750711335866532,1.3414368806629278
666,C1_03430W_A,308,C1,719613,720668,1055,32.64140147018737,40.72882100606152
668,C1_03440C_A,1120,C1,721115,722551,1436,87.20354153215416,108.80958764597342
670,C1_03450C_A,1272,C1,723114,726743,3629,39.18958669603505,48.89942189835696
672,C1_03460C_A,739,C1,727114,730086,2972,27.801368453208557,34.689593842607664
674,C1_03470C_A,62,C1,731029,732438,1409,4.9198429165129465,6.138811218250219
676,C1_03480C_A,473,C1,732768,735644,2876,18.388351600624013,22.944354323216537
678,C1_03490W_A,655,C1,736791,737672,881,83.12581795677961,103.72154405307452
680,C1_03500W_A,1981,C1,738229,738852,623,355.5224000418245,443.6086547378797
682,C1_03510C_A,3281,C1,739135,739680,545,673.1010504348113,839.8724003070218
684,C1_03520W_A,2879,C1,740588,742033,1445,222.76366680552346,277.9568616336133
686,C1_03530W_A,520,C1,742220,743984,1764,32.95909688456135,41.125230445720604
688,C1_03540C_A,221,C1,744051,744458,407,60.71114234485416,75.75328074977085
690,C1_03550C_A,2532,C1,744891,746333,1442,196.3220051769114,244.9638633226127
692,C1_03560C_A,1921,C1,746720,747754,1034,207.7195467625493,259.185324725689
694,C1_03570C_A,1,C1,748226,748341,115,0.9722382425479299,1.2131255268603869
696,C1_03580W_A,1,C1,749095,749193,98,1.1408918152348158,1.423565669274944
698,C1_03600W_A,809,C1,749583,750410,827,109.37386323512294,136.47295452413073
700,C1_03610C_A,141,C1,750533,751084,551,28.611330495307953,35.70023669335967
702,C1_03620C_A,704,C1,751389,752110,721,109.17116243644995,136.22003142110532
704,C1_03630W_A,475,C1,752775,756314,3539,15.006644249556562,18.72477589848789
706,C1_03640C_A,309,C1,756361,757074,713,48.455099507630706,60.46061093546123
708,C1_03650C_A,1262,C1,757289,757795,506,278.8556050217017,347.94645793132014
710,C1_03660W_A,141,C1,758284,758523,239,65.96168662307399,82.30472978259905
712,C1_03670C_A,1006,C1,758553,759638,1085,103.66658274688483,129.35160571656976
714,C1_03680W_A,824,C1,761416,764853,3437,26.805148636555675,33.44654493025612
716,C1_03690W_A,781,C1,765465,766517,1052,83.00530204794899,103.57116843627914
718,C1_03700C_A,2,C1,766633,766720,87,2.570285009034757,3.207113461814816
720,C1_03710C_A,1296,C1,767067,770930,3863,37.51032556804128,46.80409746913593
722,C1_03720C_A,399,C1,773999,775771,1772,25.175593543629667,31.41324198644969
724,C1_03730C_A,1074,C1,776730,778577,1847,65.01415556962363,81.12243303872573
726,C1_03740W_A,568,C1,781112,783955,2843,22.337883223085047,27.872444394836606
728,C1_03750W_A,332,C1,784461,785012,551,67.3685228683847,84.06013178861993
730,C1_03760C_A,1326,C1,785087,786874,1787,82.96396732296243,103.51959238440985
732,C1_03770W_A,5423,C1,788296,790142,1846,328.4569440811505,409.83730725831316
734,C1_03780C_A,2812,C1,790364,793585,3221,97.61018406555407,121.79463920400869
736,C1_03790C_A,5202,C1,795543,796823,1280,454.3922529995689,566.9750655731948
738,C1_03800W_A,205,C1,797157,798089,932,24.592828935694687,30.68608830014337
740,C1_03810C_A,425,C1,798181,799359,1178,40.33798311080652,50.33235154949187
742,C1_03820W_A,2014,C1,801727,802836,1109,203.0478803936213,253.35617968993168
744,C1_03830C_A,482,C1,803002,803994,992,54.325771960112654,67.7858346309186
746,C1_03840W_A,34,C1,804198,804467,269,14.131790068261735,17.633162862543173
748,C1_03860C_A,1348,C1,806466,811433,4967,30.343541848153837,37.861630596717774
750,C1_03870C_A,1603,C1,813869,815560,1691,105.98891710378365,132.24933486048377
752,C1_03880C_A,2,C1,820902,821264,362,0.6177204303481323,0.7707703623698592
754,C1_03890W_A,6,C1,823543,824613,1070,0.6269573713626838,0.7822959004987542
756,C1_03900W_A,45,C1,825308,825823,515,9.769578456670947,12.190144857286414
758,C1_03910C_A,456,C1,825919,827970,2051,24.8582025544678,31.017212398127107
760,C1_03920C_A,122,C1,828496,830040,1544,8.834522372375297,11.023413951976186
762,C1_03930W_A,495,C1,830273,831781,1508,36.70070421554437,45.79387971918271
764,C1_03940W_A,459,C1,832111,832620,509,100.82435291334477,125.80516883168079
766,C1_03950C_A,50,C1,833227,833766,539,10.371743774861962,12.941506084317675
768,C1_03960C_A,466,C1,834229,836838,2609,19.97019832048431,24.918128395725617
770,C1_03970W_A,15,C1,837444,837761,317,5.290570878218231,6.601392851211886
772,C1_03980W_A,41,C1,838231,838758,527,8.698488261126165,10.853675254547865
774,C1_03990W_A,201,C1,839278,840204,926,24.2692083979432,30.282285694792492
776,C1_04000C_A,535,C1,840359,841801,1442,41.48194027237267,51.75974205276374
778,C1_04010C_A,4032,C1,842768,843802,1034,435.9839732153038,544.0058455460584
780,C1_04020C_A,9003,C1,844770,845783,1013,993.6841098033431,1239.8849443309648
782,C1_04030W_A,1090,C1,846649,848745,2096,58.14411436230106,72.55023129386905
784,C1_04040C_A,1147,C1,848808,850970,2162,59.31687575545083,74.0135627291949
786,C1_04050C_A,2,C1,851796,852227,431,0.5188278324501714,0.6473755711783968
788,C1_04060W_A,97,C1,853943,855709,1766,6.141176441462151,7.662749293390497
790,C1_04070C_A,65,C1,855857,857047,1190,6.10712677566872,7.620263288471759
792,C1_04080W_A,93,C1,857251,857895,644,16.14609938517098,20.146548928217143
794,C1_04090C_A,218,C1,857906,859393,1487,16.391400632600273,20.45262740981164
796,C1_04100C_A,9814,C1,859621,860469,848,1293.9596732570983,1614.558491591865
798,C1_04110W_A,88,C1,862034,862951,917,10.729608521903,13.388037439288023
800,C1_04120C_A,436,C1,863013,864074,1061,45.94535860636495,57.32904233438247
802,C1_04130W_A,1236,C1,864122,866671,2549,54.21496421960094,67.64757253351723
804,C1_04140W_A,818,C1,867380,868414,1034,88.45111361362068,110.36626529183424
806,C1_04150C_A,55,C1,868503,869087,584,10.529806308417221,13.13873109142457
808,C1_04160C_A,63,C1,869423,870325,902,7.809164154389969,9.744007142021623
810,C1_04170C_A,1571,C1,870671,871066,395,444.6820812403082,554.8590463550173
812,C1_04180W_A,2345,C1,871931,872323,392,668.8478266814108,834.5653736124358
814,C1_04190C_A,525,C1,872592,873764,1172,50.084371923064225,62.493561163989646
816,C1_04200C_A,330,C1,874582,875391,809,45.607467620140845,56.90743355296871
818,C1_04210C_A,1792,C1,876392,877791,1399,143.21576627896883,178.69972021114265
820,C1_04220C_A,274,C1,878742,879311,569,53.840469284156896,67.18029059994868
822,C1_04230W_A,1381,C1,879636,880616,980,157.55715968392803,196.59441892686976
824,C1_04240C_A,2232,C1,880940,881257,317,787.2369466788729,982.2872562603286
826,C1_04250C_A,12,C1,881368,881877,509,2.6359307951201245,3.289024021743289
828,C1_04260W_A,1950,C1,882165,882575,410,531.7668924179836,663.5204863376629
830,C1_04270C_A,41,C1,882919,884154,1235,3.711824545436024,4.631487335341477
832,C1_04280C_A,53,C1,884550,885734,1184,5.004891966494623,6.244932505248361
834,C1_04290C_A,13417,C1,886010,889117,3107,482.81939411990385,602.445477082996
836,C1_04300C_A,15464,C1,890373,892310,1937,892.6120810622286,1113.7707340977995
838,C1_04310C_A,48,C1,892910,893674,764,7.0245485587232634,8.76499071763002
840,C1_04320W_A,561,C1,895092,895877,785,79.90312129678944,99.70037371388264
842,C1_04330W_A,14809,C1,897942,899552,1610,1028.4197238494496,1283.2268519482482
844,C1_04340C_A,813,C1,899992,900945,953,95.38238666004062,119.01487002498625
846,C1_04350C_A,385,C1,901560,903929,2369,18.170472008784127,22.67249164277908
848,C1_04360C_A,1095,C1,905274,905525,251,487.7653414057692,608.6168604378257
850,C1_04370C_A,1152,C1,905958,906560,602,213.95701390822222,266.96822225658485
852,C1_04380W_A,663,C1,907132,908076,944,78.52574661341836,97.98173283418454
854,C1_04390C_A,2647,C1,908570,910795,2225,133.01311560575397,165.96920269839825
856,C1_04400C_A,7777,C1,911109,914328,3219,270.12306101707173,337.05028908829496
858,C1_04410C_A,566,C1,914539,915072,533,118.72980714342357,148.1469803815058
860,C1_04420C_A,1156,C1,915265,916104,839,154.0516709944241,192.22039039430257
862,C1_04430C_A,268,C1,916437,917263,826,36.27649229458499,45.26456263660669
864,C1_04440W_A,1,C1,916801,917169,368,0.3038244507962281,0.37910172714387097
866,C1_04450C_A,2450,C1,917491,918323,832,329.24053466091266,410.8150447030217
868,C1_04460C_A,1696,C1,918745,919554,809,234.39474267805718,292.46971910859077
870,C1_04470C_A,2390,C1,920167,920688,521,512.8976602001892,639.976105676732
872,C1_04480C_A,4754,C1,921715,925908,4193,126.76660376422103,158.17501950628244
874,C1_04490W_A,3844,C1,926875,927996,1121,383.39664362242456,478.3891796644984
876,C1_04500W_A,9088,C1,929091,930743,1652,615.0760484574411,767.4707933609731
878,C1_04510W_A,509,C1,931183,932622,1439,39.54827347292778,49.3469789539769
880,C1_04520C_A,954,C1,932754,933831,1077,99.03830788294653,123.57660311221268
882,C1_04530C_A,718,C1,934147,935706,1559,51.493079978949694,64.2512987510341
884,C1_04540C_A,684,C1,936078,938918,2840,26.928260619302876,33.600159839027484
886,C1_04550W_A,128,C1,939165,939467,302,47.38856599438917,59.129827004585756
888,C1_04560W_A,293,C1,940013,941746,1733,18.903385794952396,23.5869963228856
890,C1_04570C_A,684,C1,941946,943343,1397,54.74320698555488,68.30669573574663
892,C1_04580C_A,973,C1,943640,944467,827,131.5460678958895,164.1386708924341
894,C1_04590W_A,326,C1,946251,946439,188,193.8787857080952,241.91529788295696
896,C1_04600C_A,2549,C1,947537,948574,1037,274.82840619989145,342.92145739269006
898,C1_04610W_A,34090,C1,949329,951471,2142,1779.4183913038178,2220.2972265299336
900,C1_04620W_A,1634,C1,952320,954050,1730,105.60305673825522,131.7678715331418
902,C1_04630C_A,1265,C1,954196,957687,3491,40.514568414397054,50.55268863363357
904,C1_04640W_A,1004,C1,958785,960746,1961,57.24356322518307,71.42655447797057
906,C1_04650W_A,72,C1,961930,964107,2177,3.6978101278350306,4.614000625817181
908,C1_04660W_A,1145,C1,965166,970607,5441,23.52866579443093,29.358262038107235
910,C1_04670W_A,792,C1,970917,972158,1241,71.35492274880376,89.0342248077712
912,C1_04680W_A,5580,C1,973480,974406,926,673.7422032861845,840.672408840508
914,C1_04690C_A,164,C1,974965,976872,1907,9.615318958811724,11.997665147659623
916,C1_04700C_A,1327,C1,977199,979934,2735,54.24805009288003,67.68885595119905
918,C1_04710C_A,160,C1,980592,981179,587,30.47561101002029,38.02642196632219
920,C1_04720W_A,91,C1,982170,982391,221,46.03834030888727,57.4450617130948
922,C1_04730C_A,1173,C1,982545,983831,1286,101.98295313258402,127.2508304399937
924,C1_04740W_A,696,C1,984729,985775,1046,74.395744678333,92.82845809742386
926,C1_04750W_A,300,C1,986263,987447,1184,28.32957716883749,35.34867455800959
928,C1_04760C_A,435,C1,987525,990488,2963,16.414518421687546,20.48147299398949
930,C1_04770C_A,3406,C1,991622,992782,1160,328.2896527789644,409.62856691029737
932,C1_04780C_A,735,C1,994377,997034,2657,30.929031784480156,38.59218485429966
934,C1_04790W_A,722,C1,997297,997971,674,119.76994255008105,149.44482566056072
936,C1_04800C_A,90,C1,998118,1000229,2111,4.766776793164887,5.947820560400287
938,C1_04810W_A,1160,C1,1001617,1003743,2126,61.004977213496645,76.11991781899137
940,C1_04820C_A,258,C1,1003914,1004285,371,77.75285352128594,97.01734334756789
942,C1_04830W_A,3944,C1,1004469,1007279,2810,156.9282481459214,195.80968468426943
944,C1_04840C_A,262,C1,1007444,1007815,371,78.95832411851518,98.52148820566971
946,C1_04850C_A,67,C1,1008208,1008380,172,43.55288173739419,54.343791770112105
948,C1_04860W_A,1529,C1,1008955,1011525,2570,66.51887602272969,82.99997160136036
950,C1_04870W_A,183,C1,1012991,1014757,1766,11.585930812243028,14.456527017427431
952,C1_04880C_A,325,C1,1015097,1015459,362,100.3795699315715,125.2501838851021
954,C1_04890W_A,4816,C1,1015786,1016976,1190,452.49111617877776,564.602892265846
956,C1_04900W_A,1422,C1,1017681,1019972,2291,69.39769524393846,86.59206346900005
958,C1_04910C_A,302,C1,1020126,1021085,959,35.209420400093435,43.93310693207638
960,C1_04930C_A,42,C1,1021667,1022368,701,6.698874053504284,8.358625242133622
962,C1_04940C_A,11,C1,1023215,1023751,536,2.294554807505842,2.8630667751462493
964,C1_04950C_A,1201,C1,1028271,1032458,4187,32.07085857881714,40.01691715842426
966,C1_04960C_A,501,C1,1033844,1035829,1985,28.219398662165737,35.21119759700816
968,C1_04970W_A,5210,C1,1036804,1040895,4091,142.3897685217776,177.66906854519698
970,C1_04980C_A,828,C1,1041964,1043523,1559,59.38199195344059,74.09481248726495
972,C1_04990C_A,741,C1,1044362,1045495,1133,73.12381450902194,91.24138726514377
974,C1_05000W_A,804,C1,1048309,1050273,1964,45.770441907322606,57.11078727775529
976,C1_05010C_A,157,C1,1050452,1051426,974,18.022342370844843,22.487660562078325
978,C1_05020C_A,366,C1,1051994,1053736,1742,23.49110656075911,29.311396914783984
980,C1_05030C_A,189,C1,1054104,1054799,695,30.405177268747135,37.938537160159015
982,C1_05050C_A,1133,C1,1055313,1057673,2360,53.67702619185701,66.97635191621785
984,C1_05060W_A,861,C1,1058030,1059178,1148,83.85554841975897,104.63207669170838
986,C1_05070C_A,593,C1,1059228,1061885,2657,24.953627004349297,31.136279753196877
988,C1_05080W_A,350,C1,1064009,1065736,1727,22.659287355271676,28.273481445356442
990,C1_05090W_A,568,C1,1066117,1067232,1115,56.95659372487066,71.068483779839
992,C1_05100W_A,258,C1,1067544,1068347,803,35.923173918302716,44.82370408710795
994,C1_05110C_A,6873,C1,1068523,1069635,1112,691.0541778045603,862.273696765122
996,C1_05120W_A,798,C1,1070515,1071795,1280,69.70492462392464,86.9754137499826
998,C1_05130W_A,8,C1,1072175,1072615,440,2.0328617798729445,2.536535192526264
1000,C1_05140W_A,165,C1,1082624,1083892,1268,14.549069915100135,18.153830340832684
1002,C1_05150C_A,3,C1,1084950,1085183,233,1.4395802303821281,1.796258827325466
1004,C1_05160C_A,2578,C1,1092614,1093810,1196,241.00290281620804,300.7151546390459
1006,C1_05170C_A,2913,C1,1094679,1095959,1280,254.44917973620608,317.49295771140265
1008,C1_05180C_A,177,C1,1097142,1097528,386,51.26919540689926,63.97194326228803
1010,C1_05190C_A,268,C1,1098256,1098588,332,90.25416456423856,112.61605041517207
1012,C1_05200C_A,818,C1,1099257,1100150,893,102.41707892103447,127.7925177063344
1014,C1_05210C_A,2224,C1,1101241,1102398,1157,214.91759110981727,268.166797536571
1016,C1_05220C_A,121,C1,1102611,1103048,437,30.958112460078823,38.628470723712326
1018,C1_05230W_A,180,C1,1103297,1103884,587,34.285062386272834,42.77972471211246
1020,C1_05240C_A,2128,C1,1104007,1105341,1334,178.3554293225858,222.54578630680203
1022,C1_05250W_A,1,C1,1104248,1104862,614,0.18209673923943312,0.22721406447710832
1024,C1_05260C_A,624,C1,1105631,1107547,1916,36.41326528457174,45.43522328157692
1026,C1_05270C_A,1609,C1,1108146,1108865,719,250.20598499284594,312.1984448715045
1028,C1_05280W_A,321,C1,1109135,1110883,1748,20.532136569597732,25.619295665933173
1030,C1_05290W_A,6343,C1,1111172,1113130,1958,362.2034345430924,451.9450203987105
1032,C1_05300C_A,1864,C1,1113320,1115428,2108,98.86574462645838,123.36128460047087
1034,C1_05310W_A,1,C1,1116052,1116144,92,1.2152978031849124,1.5164069085754839
1036,C1_05320C_A,296,C1,1116245,1117987,1742,18.998271972635784,23.70539204037174
1038,C1_05330C_A,596,C1,1118242,1119618,1376,48.4282043199383,60.42705204288585
1040,C1_05340C_A,2204,C1,1119919,1122246,2327,105.89750965027861,132.13527977569132
1042,C1_05350W_A,277,C1,1123169,1123828,659,46.99643280176679,58.64053665878244
1044,C1_05360C_A,650,C1,1123871,1125682,1811,40.12965689147308,50.07240923954386
1046,C1_05370C_A,440,C1,1125926,1128109,2183,22.535618448431176,28.1191716258065
1048,C1_05380C_A,1065,C1,1128387,1133384,4997,23.829273315200666,29.733349790319373
1050,C1_05390C_A,682,C1,1133457,1135511,2054,37.12397534714418,46.322022917069205
1052,C1_05400C_A,141,C1,1135748,1136341,593,26.58489562042948,33.17172077241345
1054,C1_05410C_A,577,C1,1136528,1137082,554,116.44922127124168,145.3013435646588
1056,C1_05420W_A,131,C1,1137313,1137870,557,26.29581530338342,32.81101626957223
1058,C1_05430W_A,640,C1,1138277,1140532,2255,31.732476563870353,39.594695688214856
1060,C1_05440C_A,557,C1,1141075,1142832,1757,35.44491782948643,44.22695254584069
1062,C1_05450W_A,1,C1,1142087,1142581,494,0.22633076496561122,0.2824077643500901
1064,C1_05460W_A,1827,C1,1143981,1148279,4298,47.52724894149205,59.30287082852527
1066,C1_05470W_A,1462,C1,1149114,1150163,1049,155.8268977307755,194.4354574175757
1068,C1_05480C_A,198,C1,1150297,1151418,1121,19.748318271914687,24.64127408261464
1070,C1_05490C_A,811,C1,1151708,1152454,746,121.54932934481592,151.66508346197585
1072,C1_05500W_A,1669,C1,1152769,1155042,2273,82.09702907322347,102.43785657630812
1074,C1_05510C_A,82,C1,1155542,1155790,248,36.9685751097862,46.12811983182842
1076,C1_05520W_A,239,C1,1158880,1160955,2075,12.878056913942098,16.06879764132903
1078,C1_05530C_A,518,C1,1161281,1162890,1609,35.99517222410204,44.913541103215195
1080,C1_05540C_A,1996,C1,1163603,1164622,1019,219.00644376295568,273.2687276109257
1082,C1_05550C_A,2,C1,1166517,1166614,97,2.3053071730517924,2.8764832080194744
1084,C1_05560W_A,1620,C1,1166877,1167580,703,257.6500491986904,321.48689282231874
1086,C1_05570W_A,1,C1,1167998,1168103,105,1.0648323608858279,1.3286612913232811
1088,C1_05580W_A,1,C1,1168190,1168292,102,1.096150959735411,1.3677395645974955
1090,C1_05590W_A,1,C1,1168844,1168916,72,1.5528805262918324,1.9376310498464517
1092,C1_05600W_A,420,C1,1169206,1173921,4715,9.959513704149526,12.427139543447867
1094,C1_05610W_A,267,C1,1174224,1175690,1466,20.363284609436693,25.40860798243396
1096,C1_05620C_A,143,C1,1175776,1177029,1253,12.760141978212856,15.921667429544346
1098,C1_05630C_A,3903,C1,1177543,1180872,3329,131.08569359460068,163.564231632217
1100,C1_05640C_A,515,C1,1181156,1182355,1199,48.02402828598929,59.922735052799354
1102,C1_05650W_A,276,C1,1182507,1183265,758,40.7108731114397,50.79763090046001
1104,C1_05660C_A,1582,C1,1183318,1187598,4280,41.32694006232358,51.56633810787622
1106,C1_05670W_A,1110,C1,1188181,1189434,1253,99.0472559147991,123.58776815940018
1108,C1_05680C_A,318,C1,1189532,1189963,431,82.49362535957727,102.9327158173651
1110,C1_05690C_A,44,C1,1190242,1190988,746,6.594538213528855,8.228438560205843
1112,C1_05700W_A,954,C1,1191581,1192072,491,217.23881382878494,271.0631396168087
1114,C1_05710C_A,137,C1,1192511,1194184,1673,9.155776157407434,11.424263404474237
1116,C1_05720W_A,11537,C1,1195171,1196708,1537,839.246551393415,1047.1830568572886
1118,C1_05730W_A,1,C1,1195918,1195999,81,1.38033824559274,1.7223387109746235
1120,C1_05740C_A,114,C1,1196996,1198138,1142,11.161158808934644,13.926511083309697
1122,C1_05750C_A,1058,C1,1198353,1203407,5054,23.405664220579077,29.204784893767968
1124,C1_05760C_A,11,C1,1204128,1204523,395,3.1136237387927377,3.8850728898187077
1126,C1_05770C_A,1270,C1,1206048,1207700,1652,85.95362913082639,107.24998982927332
1128,C1_05780W_A,782,C1,1208498,1210402,1904,45.92089556320134,57.2985181883165
1130,C1_05790W_A,203,C1,1210686,1210895,209,108.59761613531782,135.50438002179777
1132,C1_05800C_A,120,C1,1211015,1211707,692,19.38856610861479,24.19238767438344
1134,C1_05810W_A,344,C1,1211852,1212328,476,80.8019850319246,100.82194504747251
1136,C1_05820C_A,286,C1,1212362,1213378,1016,31.473342320276984,39.27135686854147
1138,C1_05830W_A,3,C1,1213935,1214855,920,0.36458934095547374,0.4549220725726451
1140,C1_05840W_A,476,C1,1215414,1216451,1037,51.321428541054665,64.03711797525321
1142,C1_05850W_A,1097,C1,1216759,1217970,1211,101.28217629119248,126.37642513713635
1144,C1_05860W_A,200,C1,1218269,1219270,1001,22.339140438164225,27.87401310468422
1146,C1_05870W_A,82,C1,1219787,1220767,980,9.355312884925489,11.673238488054542
1148,C1_05880W_A,175,C1,1221543,1222529,986,19.844112202106583,24.760802462540862
1150,C1_05890W_A,1,C1,1223689,1224744,1055,0.10597857620190705,0.1322364318378621
1152,C1_05900W_A,637,C1,1226686,1229604,2918,24.40757794991385,30.454938475036894
1154,C1_05910W_A,1549,C1,1231376,1232920,1544,112.16946848204373,139.96121484927139
1156,C1_05920W_A,54,C1,1236305,1238380,2075,2.9096864993844074,3.630606998459279
1158,C1_05930C_A,498,C1,1238529,1241924,3395,16.400613888282756,20.46412339419569
1160,C1_05940W_A,830,C1,1244647,1247667,3020,30.728523261986727,38.34199719828607
1162,C1_05950C_A,140,C1,1248213,1249460,1247,12.552554695286023,15.662647139095615
1164,C1_05960W_A,245,C1,1251550,1252941,1391,19.69289179280225,24.572114823358305
1166,C1_05970W_A,46,C1,1254843,1256615,1772,2.902449380969836,3.621576770367634
1168,C1_05980W_A,227,C1,1257107,1259197,2090,12.143674316609431,15.152460229038471
1170,C1_05990C_A,237,C1,1259288,1260358,1070,24.76481616882601,30.90068806970079
1172,C1_06000W_A,912,C1,1261683,1263329,1646,61.94917793343068,77.29805908694858
1174,C1_06010W_A,756,C1,1263838,1264770,932,90.69355451407408,113.16430612150434
1176,C1_06020W_A,537,C1,1265500,1267533,2033,29.53299196682116,36.85025426033606
1178,C1_06030C_A,24,C1,1267647,1268351,704,3.811615837261771,4.756003485986745
1180,C1_06040W_A,145,C1,1268617,1271166,2549,6.360169750681339,7.936001632168283
1182,C1_06050C_A,642,C1,1271299,1271640,341,210.49955849652102,262.6541280003002
1184,C1_06060C_A,266,C1,1272151,1272585,434,68.52711483765249,85.50578310290146
1186,C1_06070W_A,459,C1,1272827,1273369,542,94.68560079869462,118.14544453012091
1188,C1_06080C_A,111,C1,1273457,1274497,1040,11.93328958281185,14.889949375358501
1190,C1_06090C_A,610,C1,1274861,1277509,2648,25.75623591946272,32.13774762434145
1192,C1_06100C_A,4914,C1,1278575,1280680,2105,261.0078637749457,325.6766586622676
1194,C1_06110C_A,710,C1,1281140,1282936,1796,44.20002923387443,55.15128021611949
1196,C1_06120C_A,76,C1,1283082,1283711,629,13.509319936198581,16.856465985309672
1198,C1_06130C_A,2414,C1,1284280,1285402,1122,240.55531061829848,300.1566644489412
1200,C1_06140C_A,5,C1,1286026,1286367,341,1.6394046611878583,2.0455928971986
1202,C1_06150W_A,8,C1,1288905,1289630,725,1.2337368043366834,1.539414461671112
1204,C1_06160W_A,16,C1,1289661,1291016,1355,1.3202349566702516,1.6473438888731453
1206,C1_06180W_A,27,C1,1292811,1293806,995,3.033969591066656,3.785683176785429
1208,C1_06190C_A,1,C1,1293014,1293619,605,0.18480561635208584,0.23059410841147854
1210,C1_06200W_A,741,C1,1294855,1296609,1754,47.234482234162975,58.93756657434884
1212,C1_06210W_A,135,C1,1297212,1298261,1049,14.388940624934806,17.954026505726894
1214,C1_06220C_A,12,C1,1298404,1299762,1358,0.9879887884507683,1.232778517722632
1216,C1_06230C_A,3201,C1,1300699,1302570,1871,191.28566576992583,238.67969177990986
1218,C1_06250W_A,187,C1,1306250,1308475,2225,9.396846474603702,11.7250626764641
1220,C1_06260W_A,2,C1,1309503,1310432,929,0.24070483938215703,0.3003432413109677
1222,C1_06270W_A,156,C1,1310816,1313557,2741,6.363354276289626,7.9399751739786
1224,C1_06280C_A,33,C1,1314438,1316969,2531,1.4577811657326727,1.8189693300810623
1226,C1_06290C_A,1,C1,1324455,1324766,311,0.35950931798396124,0.4485833941766704
1228,C1_06300W_A,3,C1,1334325,1334415,90,3.726913263100398,4.650314519631484
1230,C1_06310W_A,1,C1,1334422,1334490,68,1.6442264396031168,2.051609346896243
1232,C1_06320W_A,386,C1,1337607,1340003,2396,18.01237712299775,22.47522626766802
1234,C1_06330W_A,5,C1,1340304,1340657,353,1.5836741911191494,1.9760543284553047
1236,C1_06340W_A,101,C1,1344841,1348191,3350,3.370909608117674,4.206105371487581
1238,C1_06350W_A,342,C1,1350783,1353404,2621,14.58913776398706,18.20382562816445
1240,C1_06360W_A,264,C1,1353982,1355679,1697,17.393726012819773,21.70329463493303
1242,C1_06370C_A,10,C1,1356733,1357260,527,2.121582502713699,2.647237866962894
1244,C1_06380C_A,104,C1,1359377,1359700,323,35.99990520394193,44.919446753096686
1246,C1_06390W_A,86,C1,1359948,1360724,776,12.391026055153388,15.461097243104675
1248,C1_06400C_A,762,C1,1361000,1363132,2132,39.96118067283073,49.862190393422004
1250,C1_06410W_A,184,C1,1364407,1366992,2585,7.958437606311102,9.930265434570906
1252,C1_06420C_A,558,C1,1367104,1369278,2174,28.697574988178783,35.807849612985756
1254,C1_06430C_A,10,C1,1370780,1372147,1367,0.8179034227725819,1.0205518331305377
1256,C1_06440C_A,673,C1,1372798,1375413,2615,28.77490584397592,35.90434040204958
1258,C1_06450C_A,6838,C1,1375843,1376671,828,923.3562642420479,1152.132271204351
1260,C1_06460C_A,3782,C1,1377036,1377428,392,1078.7132113045184,1345.9813402994596
1262,C1_06470W_A,3154,C1,1377812,1378198,386,913.5765102449732,1139.929429656816
1264,C1_06480C_A,736,C1,1378615,1379223,608,135.3457974494355,168.8798430813539
1266,C1_06490C_A,3,C1,1380091,1380163,72,4.658641578875498,5.812893149539354
1268,C1_06500W_A,204,C1,1380391,1381107,716,31.85573906448944,39.7484984080233
1270,C1_06510C_A,528,C1,1381134,1382531,1397,42.25791416428798,52.72797565566407
1272,C1_06520C_A,727,C1,1382826,1389647,6821,11.91672456651806,14.86928011628246
1274,C1_06530C_A,1778,C1,1390212,1394330,4118,48.27429661334998,60.23501128633884
1276,C1_06540C_A,398,C1,1395028,1396152,1124,39.59016402261455,49.399248544839786
1278,C1_06550W_A,6481,C1,1398176,1404556,6380,113.5773896151427,141.7179705410579
1280,C1_06560W_A,281,C1,1404816,1406129,1313,23.928315923790066,29.856931759705564
1282,C1_06570W_A,605,C1,1407257,1408294,1037,65.22996694818922,81.39171507358864
1284,C1_06580W_A,11966,C1,1408972,1409409,437,3061.5270553496134,3820.068435371419
1286,C1_06590C_A,1368,C1,1409768,1410970,1202,127.24835300968414,158.77612968858247
1288,C1_06600W_A,4047,C1,1411658,1412701,1043,433.8298554870751,541.3180113408039
1290,C1_06610C_A,135,C1,1413016,1415442,2426,6.2217636914907715,7.763303299467234
1292,C1_06620C_A,14,C1,1417195,1417896,701,2.2329580178347603,2.786208414044541
1294,C1_06630W_A,594,C1,1418523,1421138,2615,25.3971680108792,31.68971500567229
1296,C1_06640C_A,305,C1,1421365,1421508,143,238.47032417740309,297.55508989250404
1298,C1_06650W_A,197,C1,1421838,1422404,566,38.915295733080136,48.5571710442086
1300,C1_06660W_A,1295,C1,1422905,1424605,1700,85.17092957144145,106.27336416922537
1302,C1_06670W_A,1444,C1,1425323,1427644,2321,69.56048365252445,86.7951852608513
1304,C1_06680W_A,564,C1,1427895,1430957,3062,20.594177796100173,25.696708580066854
1306,C1_06690W_A,469,C1,1431951,1432876,925,56.68937255332174,70.73505436888105
1308,C1_06700W_A,688,C1,1433430,1435013,1583,48.59348689222503,60.63328596664171
1310,C1_06710W_A,295,C1,1435371,1436402,1031,31.991447505759968,39.91783074562428
1312,C1_06720C_A,367,C1,1436436,1437638,1202,34.137533300112636,42.59564297932
1314,C1_06730W_A,511,C1,1440080,1440790,710,80.4698314413086,100.40749519147978
1316,C1_06740C_A,591,C1,1441424,1442053,629,105.05273792491265,131.08120259628967
1318,C1_06750W_A,126,C1,1442282,1442668,386,36.49671537440286,45.539349440950794
1320,C1_06760C_A,853,C1,1442821,1444427,1606,59.38462665176787,74.09809997345559
1322,C1_06770W_A,979,C1,1444436,1445959,1523,71.87094060227098,89.67809418356971
1324,C1_06780W_A,1076,C1,1447122,1449623,2501,48.10266298795716,60.02085273638716
1326,C1_06790C_A,991,C1,1449873,1450304,431,257.07919097905994,320.77459551889564
1328,C1_06800W_A,366,C1,1450584,1451759,1175,34.826815003270106,43.45570504302442
1330,C1_06810W_A,9660,C1,1453350,1454807,1457,741.2899544588164,924.9561755588223
1332,C1_06820W_A,1114,C1,1455538,1456530,992,125.5579044887251,156.66684601419777
1334,C1_06830W_A,2,C1,1456981,1457044,63,3.5494412029527598,4.428870971077604
1336,C1_06840C_A,327,C1,1457212,1457505,293,124.78163519117717,155.6982438142828
1338,C1_06850W_A,1597,C1,1459268,1461322,2054,86.9310683715385,108.46960498322512
1340,C1_06860W_A,28,C1,1462710,1464203,1493,2.0968567588776517,2.616385932009676
1342,C1_06870C_A,24,C1,1464434,1464637,203,13.218608617893038,16.49372637504763
1344,C1_06880C_A,52,C1,1465177,1468227,3050,1.9062244886677446,2.3785215247951195
1346,C1_06890C_A,6376,C1,1468465,1469275,810,880.103665389931,1098.16316211742
1348,C1_06900C_A,3437,C1,1469637,1470274,637,603.2684875326248,752.7377238919973
1350,C1_06910C_A,1011,C1,1470485,1473181,2696,41.92777420987948,52.31603834585419
1352,C1_06920C_A,595,C1,1473495,1474850,1355,49.09623745117499,61.2606008674701
1354,C1_06930W_A,6127,C1,1475649,1479446,3797,180.4171521965984,225.1183333825291
1356,C1_06940C_A,1402,C1,1479745,1482981,3236,48.44065879048292,60.442592303986466
1358,C1_06950C_A,4,C1,1483972,1484082,110,4.065723559745889,5.073070385052528
1360,C1_06960W_A,2170,C1,1484762,1485664,902,268.9823208734323,335.6269126696337
1362,C1_06970C_A,1162,C1,1485816,1487471,1655,78.50162921551654,97.95163997241903
1364,C1_06980C_A,1062,C1,1487707,1489140,1433,82.86075126474438,103.39080292774534
1366,C1_06990C_A,8,C1,1489602,1489717,115,7.777905940383439,9.705004214883095
1368,C1_07000W_A,1758,C1,1490452,1492731,2279,86.24721610176172,107.61631758023891
1370,C1_07010W_A,245,C1,1493064,1494020,956,28.653569543711225,35.7529411289659
1372,C1_07020C_A,808,C1,1494130,1497066,2936,30.76988334385343,38.393604889600525
1374,C1_07030C_A,1152,C1,1497905,1498981,1076,119.70457469586411,149.36326189448332
1376,C1_07040C_A,18,C1,1502167,1503120,953,2.111787158524885,2.635015572508921
1378,C1_07050C_A,498,C1,1504795,1506954,2159,25.789756438499282,32.1795733780891
1380,C1_07060C_A,108,C1,1507743,1508261,518,23.311194927500562,29.086909350590744
1382,C1_07070C_A,760,C1,1509898,1511547,1649,51.53039563292242,64.29785994396472
1384,C1_07080W_A,277,C1,1513268,1513834,566,54.71846151301115,68.27581918398874
1386,C1_07090C_A,1513,C1,1514079,1516313,2234,75.72273635278742,94.48423278696198
1388,C1_07100C_A,172,C1,1516783,1517724,941,20.43663383379177,25.50013062837243
1390,C1_07110W_A,2128,C1,1518188,1521970,3782,62.9101382116154,78.497112356762
1392,C1_07120W_A,1449,C1,1526934,1528757,1823,88.86940183597055,110.8881909864951
1394,C1_07130C_A,951,C1,1528942,1530747,1805,58.90794204778635,73.50330927705609
1396,C1_07140C_A,1841,C1,1531432,1534566,3134,65.67881924729899,81.95177757474374
1398,C1_07150W_A,41,C1,1534761,1535003,242,18.942575676088797,23.63589611217655
1400,C1_07160C_A,26,C1,1535148,1535354,206,14.111613326302479,17.607987016080376
1402,C1_07170C_A,653,C1,1536685,1538385,1700,42.94719460243341,53.58803614092986
1404,C1_07180W_A,1031,C1,1540676,1541422,746,154.52202041246022,192.80727626300506
1406,C1_07190W_A,1517,C1,1542214,1544679,2465,68.8080416242187,85.85631391011312
1408,C1_07200W_A,336,C1,1545381,1546280,899,41.78785950172639,52.141457572731206
1410,C1_07210C_A,1024,C1,1546391,1548133,1742,65.72375168911839,82.00784273425899
1412,C1_07220W_A,1363,C1,1549757,1551385,1628,93.6077907421224,116.8005901153141
1414,C1_07230W_A,922,C1,1551710,1552636,926,111.32442857165984,138.90680303780437
1416,C1_07240W_A,1005,C1,1553508,1554062,554,202.82749978786464,253.08119633012498
1418,C1_07250C_A,586,C1,1554222,1555904,1682,38.953112464509516,48.604357464400415
1420,C1_07260C_A,683,C1,1556089,1557885,1796,42.51918305174118,53.053978010717756
1422,C1_07270W_A,801,C1,1558121,1560640,2519,35.55288833358578,44.3616744369768
1424,C1_07280C_A,65,C1,1560696,1560905,209,34.772635708353,43.38810197742293
1426,C1_07290W_A,37,C1,1560957,1561400,443,9.338315399642083,11.652029609008908
1428,C1_07310C_A,3,C1,1569972,1570092,120,2.7951849473252985,3.487735889723613
1430,C1_07320W_A,4,C1,1570830,1570893,63,7.0988824059055196,8.857741942155208
1432,C1_07330W_A,318,C1,1578886,1580409,1523,23.34520848980814,29.129350306818356
1434,C1_07340W_A,3175,C1,1581153,1584276,3123,113.6690644605549,141.8323592682993
1436,C1_07350C_A,93,C1,1584338,1584853,515,20.190462143786622,25.19296603839192
1438,C1_07360W_A,828,C1,1585929,1589840,3911,23.670806815498306,29.535620728112008
1440,C1_07370C_A,334,C1,1590522,1592492,1970,18.956178119931973,23.652868774978412
1442,C1_07380C_A,978,C1,1595184,1598036,2852,38.34068553273691,47.840192147962036
1444,C1_07390W_A,1230,C1,1600375,1602015,1640,83.85554841975896,104.63207669170838
1446,C1_07400C_A,314,C1,1602167,1603606,1439,24.39716673968433,30.44194772406433
1448,C1_07410C_A,849,C1,1604432,1604926,494,192.15481945580393,239.7641919332265
1450,C1_07420C_A,322,C1,1605356,1606747,1391,25.882086356254383,32.294779482128064
1452,C1_07430W_A,43,C1,1609045,1610016,971,4.9513059829037225,6.178069753166441
1454,C1_07440W_A,1033,C1,1611003,1614224,3221,35.85751071824941,44.74177179862766
1456,C1_07450W_A,7,C1,1615492,1615589,97,8.068575105681274,10.06769122806816
1458,C1_07460C_A,239,C1,1615681,1616832,1151,23.21630590480439,28.96851008319526
1460,C1_07470C_A,273,C1,1617098,1619065,1967,15.517752732482085,19.362519530138204
1462,C1_07480C_A,46,C1,1619304,1621175,1871,2.7488724228105554,3.429948710364216
1464,C1_07490C_A,355,C1,1621424,1623418,1994,19.905529715155087,24.83743712842292
1466,C1_07500C_A,1046,C1,1623838,1624812,974,120.07242114588347,149.82224807601224
1468,C1_07510W_A,148,C1,1625174,1626007,833,19.864939841735616,24.786790476787264
1470,C1_07520C_A,816,C1,1626202,1629063,2861,31.889142495874783,39.7901780638164
1472,C1_07530W_A,15,C1,1630610,1630705,95,17.653799667317678,22.027805619307028
1474,C1_07540C_A,3493,C1,1631817,1634681,2864,136.36286342188922,170.14890311179582
1476,C1_07550W_A,744,C1,1635159,1636253,1094,76.03720661096973,94.87661798736262
1478,C1_07560W_A,261,C1,1636861,1637820,959,30.429333524584063,37.96867850752296
1480,C1_07570C_A,136,C1,1637846,1639054,1208,12.587587842259623,15.706360298093092
1482,C1_07580C_A,37,C1,1639501,1640733,1232,3.3578520471115603,4.189812594797846
1484,C1_07590C_A,446,C1,1641986,1645111,3125,15.957151827290666,19.91078664725416
1486,C1_07600W_A,408,C1,1645623,1646147,524,87.0561418708948,108.62566740513238
1488,C1_07610C_A,40,C1,1646303,1647247,944,4.737601605636099,5.911416762243411
1490,C1_07620C_A,9,C1,1647560,1648828,1268,0.7935856317327348,0.9902089276817829
1492,C1_07630W_A,549,C1,1649647,1650174,527,116.47487939898208,145.33335889626287
1494,C1_07640C_A,521,C1,1651145,1653661,2516,23.152485811708754,28.888877560349798
1496,C1_07650W_A,70,C1,1658863,1659375,512,15.286167680685226,19.073555646926007
1498,C1_07660W_A,51,C1,1660186,1662414,2228,2.5593255352529667,3.1934386063896634
1500,C1_07670W_A,24,C1,1666415,1667008,593,4.525088616243316,5.646250344240587
1502,C1_07680W_A,345,C1,1668121,1669215,1094,35.2591885494416,43.99520592155928
1504,C1_07690C_A,318,C1,1669743,1672880,3137,11.333998256288746,14.142174216539484
1506,C1_07700C_A,588,C1,1674155,1675270,1115,58.962107588422434,73.57089518053756
1508,C1_07710C_A,2224,C1,1677049,1678674,1625,153.0213248701899,190.9347598460385
1510,C1_07770W_A,64,C1,1691292,1692819,1527,4.686099191324665,5.847153816432514
1512,C1_07780W_A,978,C1,1696626,1699202,2576,42.44861612553016,52.96592702095796
1514,C1_07790C_A,322,C1,1699242,1700171,929,38.75347914052728,48.3552618510658
1516,C1_07800W_A,515,C1,1700387,1702474,2087,27.590229954432754,34.426142466845434
1518,C1_07810C_A,189,C1,1702555,1704825,2270,9.309074097700114,11.615543315555293
1520,C1_07820W_A,288,C1,1705110,1706270,1160,27.759078097575383,34.63682538760002
1522,C1_07830C_A,125,C1,1706353,1707135,782,17.872026517425184,22.30010159669829
1524,C1_07840W_A,774,C1,1707470,1708372,902,95.94115961107678,119.71208774483708
1526,C1_07850C_A,116,C1,1708433,1709872,1439,9.01296605669867,11.246069859845424
1528,C1_07860W_A,55,C1,1710121,1711374,1253,4.907746914697252,6.1237182421324405
1530,C1_07870C_A,4022,C1,1711666,1713528,1862,241.50878320391735,301.34637483283285
1532,C1_07880C_A,1061,C1,1714644,1716962,2318,51.17672526509304,63.85656219148841
1534,C1_07890C_A,2661,C1,1718492,1720900,2408,123.55460373476113,154.16719605572314
1536,C1_07900W_A,98,C1,1722824,1723399,575,19.055869553939427,23.777260326463587
1538,C1_07910C_A,1172,C1,1723764,1724978,1214,107.93926715865733,134.68291475308317
1540,C1_07920W_A,197,C1,1725659,1725850,191,115.31967217237359,143.8919309477595
1542,C1_07930C_A,92,C1,1726172,1727575,1403,7.331632648722095,9.148159710750459
1544,C1_07940W_A,15,C1,1729104,1729195,91,18.429790861485486,22.99606081136448
1546,C1_07950C_A,202,C1,1729610,1730410,800,28.23136796798552,35.22613248620849
1548,C1_07960W_A,222,C1,1730691,1731389,698,35.560519100642765,44.37119584634052
1550,C1_07970C_A,1421,C1,1731592,1735263,3671,43.27930057367747,54.00242657910383
1552,C1_07980C_A,954,C1,1737039,1737770,731,145.91553705873244,182.0684015757224
1554,C1_07990C_A,4224,C1,1741763,1743058,1295,364.69069397689765,455.0485373959086
1556,C1_08000W_A,539,C1,1747219,1749510,2291,26.304752276007612,32.82216751743391
1558,C1_08010W_A,954,C1,1750206,1750925,719,148.3508450485861,185.10709534332833
1560,C1_08020W_A,731,C1,1751228,1753102,1874,43.61323791877894,54.419102142752635
1562,C1_08030W_A,1949,C1,1753563,1753943,380,573.4542591933691,715.5365525338233
1564,C1_08040W_A,83,C1,1754691,1754915,224,41.42863404071425,51.6932283655464
1566,C1_08050W_A,1221,C1,1755407,1755907,500,273.03366565473516,340.6820417082025
1568,C1_08060W_A,954,C1,1756486,1756893,407,262.07434297280935,327.00737482027785
1570,C1_08070W_A,2730,C1,1757979,1762451,4472,68.25451615561775,85.16564381883241
1572,C1_08080C_A,1212,C1,1762963,1763349,386,351.0636431252085,438.0451708129553
1574,C1_08090C_A,11609,C1,1763704,1766757,3053,425.14644026858036,530.4831437117775
1576,C1_08100W_A,1408,C1,1767333,1768439,1106,142.33708520195373,177.60333210599805
1578,C1_08110W_A,2562,C1,1768990,1772265,3275,87.46581783264018,109.13684701645064
1580,C1_08120W_A,692,C1,1772645,1774756,2111,36.65121712077891,45.73213141996665
1582,C1_08130C_A,501,C1,1774766,1777369,2603,21.51959521490549,26.851412689228273
1584,C1_08140W_A,225,C1,1777560,1778540,980,25.670065842783355,32.03022755868624
1586,C1_08150C_A,24,C1,1778537,1779175,638,4.205920923875057,5.248003846606063
1588,C1_08160W_A,508,C1,1779285,1780343,1058,53.684459479820475,66.98562691794311
1590,C1_08170C_A,834,C1,1780648,1782873,2225,41.908930266414366,52.29252551963134
1592,C1_08180C_A,6264,C1,1785337,1789293,3956,177.0378009104719,220.90169477481
1594,C1_08190C_A,590,C1,1790347,1793517,3170,20.809578787658378,25.96547854810008
1596,C1_08200W_A,285,C1,1794134,1795096,962,33.12381330510229,41.33075794474968
1598,C1_08210C_A,4898,C1,1795204,1800024,4820,113.61672922821008,141.76705716071584
1600,C1_08220W_A,1328,C1,1801629,1803992,2363,62.835473720660126,78.40394856627944
1602,C1_08230C_A,1106,C1,1804089,1806353,2264,54.61969172688658,68.15257763311511
1604,C1_08240C_A,175,C1,1806847,1807839,992,19.724087329916422,24.611039544420652
1606,C1_08260C_A,393,C1,1808933,1809601,668,65.77890325142768,82.07665896175926
1608,C1_08270C_A,1378,C1,1810097,1813534,3437,44.82705682181277,55.93366373045258
1610,C1_08290C_A,1834,C1,1816300,1819245,2945,69.6281044943239,86.87956022754643
1612,C1_08300W_A,1955,C1,1820165,1822153,1988,109.95144008090462,137.193635098786
1614,C1_08310W_A,2319,C1,1823757,1825340,1583,163.79112805678756,204.37295080907285
1616,C1_08320W_A,15371,C1,1826586,1828619,2033,845.3475223873521,1054.795639172487
1618,C1_08330C_A,1849,C1,1829194,1830240,1046,197.64041941126106,246.60893537663327
1620,C1_08340C_A,365,C1,1831872,1832345,473,86.27843600623544,107.65527270605655
1622,C1_08350C_A,82,C1,1832850,1833041,191,48.00108181794229,59.89410323713848
1624,C1_08360C_A,18735,C1,1834255,1835715,1460,1434.7339722777938,1790.2118327115586
1626,C1_08370W_A,5265,C1,1839237,1841123,1886,312.12404554968606,389.45767676341086
1628,C1_08380W_A,6243,C1,1842502,1843878,1376,507.27731471371624,632.9632313821079
1630,C1_08390C_A,917,C1,1844112,1845788,1676,61.17385672308589,76.33063987772202
1632,C1_08400C_A,3501,C1,1846393,1849392,2999,130.52274092145208,162.86179859849773
1634,C1_08410C_A,1217,C1,1850368,1851303,935,145.52898741796315,181.58607819438018
1636,C1_08420W_A,1509,C1,1851770,1854430,2660,63.42758023329136,79.14275876079597
1638,C1_08430W_A,652,C1,1854820,1855782,962,75.77798692956736,94.55317256132206
1640,C1_08440C_A,99,C1,1855865,1856236,371,29.835397281423674,37.22758523802023
1642,C1_08450C_A,1305,C1,1856784,1857359,575,253.75418130500972,316.62576251056106
1644,C1_08460C_A,5446,C1,1858136,1860274,2138,284.8003222288789,355.36407213161453
1646,C1_08470W_A,1172,C1,1861221,1861655,434,301.93149845762673,376.7397661526336
1648,C1_08480C_A,342,C1,1861721,1862316,595,64.26576483934468,80.18861675868743
1650,C1_08490W_A,1666,C1,1862511,1863896,1385,134.49178692401293,167.81423804417443
1652,C1_08500C_A,27889,C1,1864127,1865449,1322,2358.6963085009156,2943.1003397428694
1654,C1_08510W_A,209,C1,1866411,1867046,635,36.79960025140078,45.9172788001408
1656,C1_08520C_A,948,C1,1867125,1867568,443,239.26278375299168,298.54389376595805
1658,C1_08530W_A,174,C1,1867837,1868310,473,41.12999415091772,51.32059575576394
1660,C1_08540C_A,3527,C1,1868417,1870555,2138,184.44559979824749,230.1448921058032
1662,C1_08550C_A,1586,C1,1871363,1872100,737,240.6058793192903,300.2197623393025
1664,C1_08560W_A,2373,C1,1872858,1874522,1664,159.4464875000705,198.95185736332047
1666,C1_08570C_A,212,C1,1874780,1875544,764,31.025089467694414,38.71204233619926
1668,C1_08580C_A,815,C1,1877922,1879172,1250,72.8984234262438,90.96015200399182
1670,C1_08590C_A,13182,C1,1880547,1882037,1490,989.1577980038144,1234.2371677405815
1672,C1_08600C_A,3032,C1,1882757,1884955,2198,154.2311330353104,192.44431697255678
1674,C1_08610C_A,4255,C1,1885503,1886144,641,742.1848331275597,926.0727744632744
1676,C1_08620W_A,342,C1,1886878,1887366,488,78.35682393321738,97.77095690864553
1678,C1_08630W_A,1136,C1,1887736,1889073,1337,94.99865669892414,118.53606494318697
1680,C1_08640W_A,607,C1,1889477,1890301,824,82.36297393332313,102.76969344962296
1682,C1_08650C_A,570,C1,1890487,1891423,936,68.08783846048804,84.95766910865211
1684,C1_08660C_A,244,C1,1891687,1892457,770,35.42987673492846,44.20818478402917
1686,C1_08670W_A,1099,C1,1892915,1895104,2189,56.13354512764739,70.04151197453176
1688,C1_08680C_A,623,C1,1895260,1895835,575,121.14088502147207,151.15544064680424
1690,C1_08690W_A,664,C1,1896172,1896639,467,158.9724029999142,198.36031098727867
1692,C1_08700W_A,2860,C1,1897121,1901266,4145,77.145755844153,96.25982769225122
1694,C1_08710W_A,331,C1,1901480,1902264,784,47.20439885534051,58.900029566250815
1696,C1_08730W_A,548,C1,1902971,1904146,1175,52.14506727265579,65.06482612999285
1698,C1_08740C_A,7627,C1,1904314,1907100,2786,306.08579459081193,381.9233543563818
1700,C1_08750W_A,248,C1,1907474,1908382,908,30.537703389280797,38.103898707112606
1702,C1_08760W_A,175,C1,1908828,1909877,1049,18.652330439730306,23.273738062979305
1704,C1_08770W_A,304,C1,1910142,1911194,1052,32.309362128779114,40.314513706310954
1706,C1_08780W_A,1984,C1,1912020,1913675,1655,134.0337627913811,167.24273124378604
1708,C1_08790W_A,2333,C1,1914832,1916589,1757,148.4613883235042,185.24502744963434
1710,C1_08800W_A,279,C1,1916963,1918639,1676,18.612329362858194,23.22382609147704
1712,C1_08810C_A,2794,C1,1918866,1920872,2006,155.72775160173248,194.31174627891875
1714,C1_08820C_A,118,C1,1921091,1921723,632,20.87543188508767,26.04764778401179
1716,C1_08830C_A,26,C1,1921987,1922570,583,4.986264743084581,6.221690094875741
1718,C1_08840W_A,87,C1,1922753,1923817,1064,9.14214625628951,11.407256481426854
1720,C1_08850C_A,237,C1,1923990,1926056,2066,12.825921249101564,16.003744547231292
1722,C1_08860C_A,491,C1,1926303,1928510,2207,24.874233060928347,31.037214714169348
1724,C1_08870C_A,800,C1,1928994,1930622,1628,54.94221026683634,68.55500520341253
1726,C1_08880W_A,770,C1,1931304,1932899,1595,53.975985189729904,67.34938269811114
1728,C1_08890C_A,35,C1,1932950,1933345,395,9.906984623431438,12.361595558514072
1730,C1_08900W_A,67,C1,1933791,1935467,1676,4.469627481403222,5.577047842756135
1732,C1_08910C_A,187,C1,1936147,1938249,2102,9.946709517599066,12.411162918712
1734,C1_08920W_A,875,C1,1938480,1939367,887,110.29478371633084,137.6220475088235
1736,C1_08930C_A,385,C1,1939545,1939769,224,192.16896512861427,239.78184241849837
1738,C1_08940C_A,2323,C1,1940406,1942679,2273,114.26686551054411,142.57827491118263
1740,C1_08950W_A,1392,C1,1948142,1951585,3443,45.20357184637602,56.40346626192587
1742,C1_08960W_A,14,C1,1952350,1952526,176,8.89377028694413,11.097341467302405
1744,C1_08970W_A,62,C1,1952884,1952999,115,60.27877103797166,75.213782665344
1746,C1_08980C_A,928,C1,1953260,1954783,1523,68.12689773126401,85.00640592681583
1748,C1_08990C_A,1419,C1,1956445,1959255,2810,56.4607464804925,70.44978259811825
1750,C1_09000W_A,235,C1,1960295,1961950,1655,15.87597492740653,19.809496896315384
1752,C1_09010W_A,763,C1,1962465,1964288,1823,46.795965217974825,58.390400084676166
1754,C1_09020W_A,647,C1,1964983,1965726,743,97.3612199687466,121.48399034461251
1756,C1_09030C_A,1845,C1,1966282,1966779,497,415.0596561621872,517.8972005263635
1758,C1_09040C_A,207,C1,1967483,1968947,1464,15.808832898807015,19.72571937630568
1760,C1_09050W_A,757,C1,1969726,1971693,1967,43.02907992120491,53.69020983265429
1762,C1_09060C_A,137,C1,1972141,1972821,680,22.525902222562703,28.107048052478525
1764,C1_09070W_A,464,C1,1973678,1977250,3572,14.523693343325181,18.122166325103656
1766,C1_09080C_A,1667,C1,1978117,1978776,659,282.8269078720045,352.9017133941889
1768,C1_09090C_A,1566,C1,1980940,1984239,3299,53.073775416931404,66.22363629350927
1770,C1_09100W_A,265,C1,1985645,1986385,740,40.03913573195698,49.95946004198689
1772,C1_09110W_A,147,C1,1986752,1988347,1595,10.30450626349389,12.857609424184854
1774,C1_09120W_A,1107,C1,1991466,1993010,1544,80.16242841163486,100.02392823637409
1776,C1_09130W_A,2615,C1,1996613,1998733,2120,137.91337051425765,172.0835726722122
1778,C1_09140C_A,408,C1,1999453,2000619,1166,39.12300029189441,48.816337667486586
1780,C1_09150W_A,1692,C1,2004765,2005862,1097,172.4504259206711,215.17772563035015
1782,C1_09160W_A,258,C1,2007208,2008347,1139,25.325995308513683,31.6009081492078
1784,C1_09170W_A,1523,C1,2010260,2012542,2282,74.61992418538878,93.10818159595202
1786,C1_09180W_A,575,C1,2014803,2017433,2630,24.444583189536836,30.50111234359053
1788,C1_09190C_A,4953,C1,2017549,2019336,1787,309.8948191181243,386.67612449470744
1790,C1_09200W_A,481,C1,2020180,2022249,2069,25.99292333810476,32.433078065868685
1792,C1_09210C_A,5332,C1,2022447,2024309,1862,320.17027151747567,399.49748150389473
1794,C1_09220W_A,1357,C1,2025818,2027191,1373,110.50447118777656,137.8836883424601
1796,C1_09230C_A,338,C1,2027229,2028242,1013,37.305923482564694,46.54905155879886
1798,C1_09240C_A,123,C1,2028519,2029943,1424,9.657521025871116,12.050323439213606
1800,C1_09250W_A,559,C1,2030997,2034590,3593,17.395027949399857,21.704919146735314
1802,C1_09260C_A,379,C1,2034691,2035818,1127,37.599825910782194,46.915772926539454
1804,C1_09270W_A,101,C1,2036746,2038410,1664,6.78638653076575,8.467820309184733
1806,C1_09280W_A,391,C1,2038862,2041054,2192,19.94374661321518,24.885122862808988
1808,C1_09290C_A,2290,C1,2041212,2043785,2573,99.50988774776422,124.16502429019936
1810,C1_09300C_A,67,C1,2044586,2045479,893,8.388684948299888,10.467113308465041
1812,C1_09310C_A,274,C1,2045895,2048825,2930,10.45570888146255,13.046274863949076
1814,C1_09320C_A,1075,C1,2050005,2051678,1673,71.842769118343,89.64294277233432
1816,C1_09330W_A,94,C1,2054912,2055511,599,17.54573522861957,21.892966519800975
1818,C1_09340C_A,934,C1,2055982,2059482,3500,29.8366027520209,37.229089382878335
1820,C1_09350W_A,835,C1,2060785,2061315,530,176.1493910201226,219.79316739012955
1822,C1_09360C_A,1478,C1,2061654,2064530,2876,57.45873925099849,71.69504374146732
1824,C1_09370W_A,829,C1,2065803,2067635,1832,50.5940681513684,63.12954263277019
1826,C1_09380W_A,703,C1,2067844,2070201,2357,33.347730470423166,41.610154102260495
1828,C1_09390W_A,227,C1,2070405,2071802,1397,18.167701733510174,22.66903498832527
1830,C1_09400C_A,618,C1,2072063,2073337,1274,54.23624167808586,67.67412181630118
1832,C1_09410W_A,15,C1,2074852,2075229,377,4.448570207944773,5.550773299294875
1834,C1_09420W_A,48,C1,2075333,2076733,1400,3.833396499188981,4.783180648763811
1836,C1_09430W_A,718,C1,2077583,2080183,2600,30.876042956608682,38.52606721263929
1838,C1_09440W_A,344,C1,2080806,2081780,974,39.48844443038615,49.27232632710155
1840,C1_09450C_A,1259,C1,2082040,2086968,4928,28.564430589955776,35.641716600341134
1842,C1_09460W_A,846,C1,2087338,2088633,1295,73.04174410616842,91.13898263185101
1844,C1_09470C_A,905,C1,2088739,2089725,986,102.62240881660831,128.04872130628274
1846,C1_09480W_A,112,C1,2089906,2090313,407,30.767637749428346,38.39080291391102
1848,C1_09490C_A,3568,C1,2090366,2091958,1592,250.58341437328306,312.66938830487055
1850,C1_09500W_A,4,C1,2092602,2092937,335,1.3350137061852172,1.6657843055396362
1852,C1_09510W_A,850,C1,2093170,2094570,1400,67.88306300647155,84.70215732185916
1854,C1_09520C_A,425,C1,2094630,2095979,1349,35.2247176460564,43.952194310823884
1856,C1_09530W_A,250,C1,2096586,2097506,920,30.382445079622812,37.910172714387095
1858,C1_09540W_A,1273,C1,2102573,2104153,1580,90.08279589734444,112.4022224713458
1860,C1_09550W_A,108,C1,2104221,2104577,356,33.91909823720587,42.32308720114047
1862,C1_09560C_A,2,C1,2105679,2105747,68,3.2884528792062335,4.103218693792486
1864,C1_09570W_A,746,C1,2106955,2108577,1622,51.42313121343213,64.16401908098187
1866,C1_09580C_A,57,C1,2108735,2110141,1406,4.532732347013998,5.655787929281534
1868,C1_09590C_A,2,C1,2111646,2113043,1397,0.16006785668290902,0.19972718051387905
1870,C1_09600C_A,231,C1,2114091,2115482,1391,18.567583690356408,23.16799397630926
1872,C1_09610W_A,613,C1,2117863,2118681,818,83.78720648950649,104.54680197557822
1874,C1_09620C_A,330,C1,2118745,2119209,464,79.51819246701281,99.22007272489589
1876,C1_09630W_A,6923,C1,2120305,2121618,1313,589.5221748768635,735.5855465211447
1878,C1_09640W_A,4264,C1,2122166,2123452,1286,370.7206412253522,462.5724987179311
1880,C1_09650W_A,940,C1,2124235,2125830,1595,65.89276114070924,82.21872693016165
1882,C1_09660W_A,2054,C1,2126282,2128567,2285,100.50433053490002,125.40585588607966
1884,C1_09670C_A,236,C1,2128602,2128934,332,79.47754789985186,99.16935782828587
1886,C1_09680W_A,5523,C1,2129681,2131222,1541,400.7217771337476,500.0068869290983
1888,C1_09690W_A,16363,C1,2132251,2133906,1655,1105.440756328311,1379.3310541038666
1890,C1_09700W_A,11,C1,2134158,2134862,704,1.7469905920783118,2.179834931077258
1892,C1_09710C_A,1013,C1,2134881,2136464,1583,71.54825904334876,89.27546320379076
1894,C1_09720W_A,1963,C1,2136910,2138244,1334,164.52617845875744,205.29012148508102
1896,C1_09730W_A,490,C1,2138426,2139259,833,65.76905758412468,82.06437387584971
1898,C1_09740C_A,51,C1,2139280,2139498,218,26.156776571300963,32.63752850934023
1900,C1_09750W_A,520,C1,2139718,2140614,896,64.88822199148015,80.96529744001245
1902,C1_09760C_A,1104,C1,2140691,2141770,1079,114.39793074502798,142.74181361463832
1904,C1_09770W_A,257,C1,2142201,2142542,341,84.26539958505593,105.14347491600803
1906,C1_09780C_A,1416,C1,2142636,2144831,2195,72.12723253599313,89.99788646648994
1908,C1_09790C_A,593,C1,2145394,2146539,1145,57.90549078651186,72.25248498187257
1910,C1_09800C_A,371,C1,2146924,2147445,521,79.6171681733348,99.34357121592785
1912,C1_09810W_A,298,C1,2148118,2149359,1241,26.848190630231713,33.500251253429056
1914,C1_09820C_A,1,C1,2148315,2148767,452,0.24736149976330074,0.3086491937808507
1916,C1_09830W_A,1134,C1,2149689,2153891,4202,30.17362903633402,37.64961921891077
1918,C1_09840C_A,495,C1,2153952,2154935,983,56.30179242832239,70.25144518466686
1920,C1_09850C_A,1267,C1,2155954,2157804,1850,76.5729584488898,95.54511075199606
1922,C1_09860C_A,1334,C1,2158652,2159836,1184,125.97218647743068,157.1837728679493
1924,C1_09870W_A,307,C1,2161357,2163096,1739,19.738281284160244,24.62875027360895
1926,C1_09880C_A,168,C1,2163426,2163878,452,41.556731960234536,51.85306455518291
1928,C1_09890C_A,2,C1,2164157,2164251,94,2.3788808062342968,2.968285863594564
1930,C1_09900W_A,21,C1,2166008,2167423,1415,1.659332406892757,2.070458054676915
1932,C1_09910C_A,674,C1,2167566,2168384,818,92.12492198030569,114.95031734345794
1934,C1_09920W_A,883,C1,2169696,2172581,2885,34.22042715408303,42.69907508666828
1936,C1_09930W_A,110,C1,2172939,2173751,812,15.146322374669106,18.89906147140874
1938,C1_09940W_A,56,C1,2173813,2174097,284,22.046529162002354,27.508902792186237
1940,C1_09950C_A,386,C1,2174079,2174675,596,72.4121738031923,90.35342640492044
1942,C1_09960W_A,566,C1,2174942,2175366,424,149.25232831944518,186.23193524373255
1944,C1_09970C_A,670,C1,2175531,2178041,2510,29.84500262482789,37.239570456013084
1946,C1_09980C_A,542,C1,2178865,2179779,914,66.30154229541846,82.72879003195615
1948,C1_09990W_A,729,C1,2180946,2182802,1856,43.915729021554796,54.79654016397659
1950,C1_10000C_A,782,C1,2183212,2185005,1793,48.763739627627075,60.845721489433686
1952,C1_10010C_A,2461,C1,2189027,2192563,3536,77.81617822813983,97.09635774445489
1954,C1_10020W_A,1664,C1,2195272,2196825,1553,119.79878306115383,149.4808118609167
1956,C1_10030W_A,1299,C1,2196988,2198682,1694,85.73660558619984,106.97919529518235
1958,C1_10040W_A,2434,C1,2199783,2201525,1742,156.22227696417397,194.9287980617055
1960,C1_10050W_A,108,C1,2202127,2202978,851,14.189422999348167,17.705075256881326
1962,C1_10060C_A,249,C1,2203460,2203972,512,54.37508217843745,67.84736222977965
1964,C1_10070C_A,889,C1,2205458,2207278,1820,54.613613586201986,68.14499353767674
1966,C1_10080W_A,242,C1,2208542,2209030,488,55.445471905960844,69.18295781255036
1968,C1_10090C_A,2061,C1,2209373,2211919,2546,90.50865948841226,112.93360045122336
1970,C1_10100C_A,599,C1,2212261,2212744,483,138.65969221100238,173.01480728318376
1972,C1_10110W_A,368,C1,2213970,2216138,2168,18.97837750213487,23.68056840255147
1974,C1_10120C_A,1623,C1,2216358,2217212,854,212.4864248013564,265.1332716169285
1976,C1_10130W_A,7,C1,2217638,2217738,100,7.826517852510835,9.765660491226116
1978,C1_10140C_A,1457,C1,2217841,2220072,2231,73.01809893774919,91.10947900183422
1980,C1_10150W_A,20,C1,2230403,2232760,2357,0.9487263291727784,1.1837881679163726
1982,C1_10160W_A,7619,C1,2236246,2237169,923,922.9258554137141,1151.5952218333348
1984,C1_10170W_A,7,C1,2239042,2239758,716,1.093089085546206,1.3639190630204072
1986,C1_10180C_A,793,C1,2240080,2242266,2186,40.55959127591879,50.60886661575161
1988,C1_10190W_A,455,C1,2245299,2246132,833,61.071267756687206,76.20263288471757
1990,C1_10200C_A,350,C1,2246376,2248130,1754,22.310484186176843,27.83825681649406
1992,C1_10210C_A,1088,C1,2249405,2252335,2930,41.51755935412867,51.80418632108247
1994,C1_10220C_A,893,C1,2255500,2256717,1217,82.04108982617886,102.36805750281631
1996,C1_10230C_A,1222,C1,2259255,2263580,4325,31.59043704630303,39.41746365079542
1998,C1_10240C_A,286,C1,2263977,2264711,734,43.56528037793108,54.35926236844432
2000,C1_10250C_A,548,C1,2264987,2265808,821,74.6290548664684,93.11957454657929
2002,C1_10260C_A,748,C1,2266205,2266927,722,115.83370308029494,144.53332108106719
2004,C1_10270C_A,1415,C1,2267309,2268271,962,164.45682746217452,205.20358769059922
2006,C1_10280C_A,1703,C1,2268532,2269221,689,276.3541344148031,344.825208719844
2008,C1_10290W_A,1042,C1,2271400,2274240,2840,41.02229176215438,51.18620840974655
2010,C1_10300W_A,2050,C1,2276260,2278746,2486,92.19837718450302,115.04197222740797
2012,C1_10310W_A,110,C1,2279973,2281007,1034,11.894404031171483,14.84142931797282
2014,C1_10320W_A,73,C1,2282222,2283286,1064,7.670996284013039,9.57160601315127
2016,C1_10330C_A,133,C1,2283308,2284648,1340,11.097301432664619,13.846832039798223
2018,C1_10340W_A,232,C1,2285484,2287037,1553,16.702714946026255,20.841074730608582
2020,C1_10350C_A,4219,C1,2287135,2289441,2306,204.56002242437873,255.24297864256587
2022,C1_10360C_A,998,C1,2292855,2294669,1814,61.51255959053248,76.75326169667399
2024,C1_10370W_A,5,C1,2295437,2295772,335,1.6687671327315214,2.082230381924545
2026,C1_10380C_A,2568,C1,2296797,2298995,2198,130.62847943096207,162.99373548335282
2028,C1_10390C_A,5394,C1,2299892,2300570,678,889.5119531488297,1109.902500835939
2030,C1_10400C_A,292,C1,2301144,2301896,752,43.41457471377592,54.1712170106008
2032,C1_10410W_A,186,C1,2304069,2305031,962,21.617646578066758,26.97375781657347
2034,C1_10420C_A,947,C1,2305152,2307086,1934,54.74746939228661,68.31201422064657
2036,C1_10430W_A,102,C1,2308995,2310503,1508,7.562569353506114,9.436314608801286
2038,C1_10440W_A,1261,C1,2311138,2313651,2513,56.10391115920734,70.00453572529209
2040,C1_10450W_A,2919,C1,2315103,2316224,1121,291.1380860389847,363.27211639975826
2042,C1_10460W_A,689,C1,2316584,2317816,1232,62.52865028269906,78.02110480583018
2044,C1_10470W_A,1887,C1,2318202,2319212,1010,208.89164339021144,260.6478266894439
2046,C1_10480W_A,1209,C1,2319689,2321215,1526,88.58135259020408,110.52877301902615
2048,C1_10490W_A,2107,C1,2321499,2323370,1871,125.91030858395307,157.10656375516095
2050,C1_10500W_A,132,C1,2323932,2324456,524,28.165222369995377,35.14359827813106
2052,C1_10510W_A,132,C1,2325501,2326049,548,26.931708981528427,33.60446258711802
2054,C1_10520W_A,172,C1,2327281,2329134,1853,10.378236609604995,12.949607620776286
2056,C1_10530W_A,224,C1,2330114,2330713,599,41.81111373628493,52.170473408887425
2058,C1_10540C_A,408,C1,2330849,2332411,1562,29.204493175639488,36.44036473770125
2060,C1_10550C_A,195,C1,2332801,2335641,2840,7.67691640462582,9.578992936564852
2062,C1_10560C_A,86,C1,2337547,2339439,1892,5.082154449682362,6.341337981315659
2064,C1_10570C_A,8,C1,2340437,2342245,1808,0.4947229995266015,0.6172983875617014
2066,C1_10580C_A,190,C1,2344169,2344501,332,63.98616144479598,79.83973723463693
2068,C1_10590W_A,1,C1,2346741,2346828,87,1.2851425045173785,1.603556730907408
2070,C1_10600C_A,9,C1,2348535,2348957,422,2.3845179645429093,2.9753197163518967
2072,C1_10610W_A,834,C1,2349806,2351599,1793,52.00634123969435,64.89172854499705
2074,C1_10620W_A,5360,C1,2352465,2353904,1439,416.4611902060765,519.6459866273402
2076,C1_10630C_A,200,C1,2354068,2356800,2732,8.185021807687551,10.21298942818042
2078,C1_10640C_A,655,C1,2357212,2359116,1904,38.463154212144346,47.993004364894254
2080,C1_10650W_A,173,C1,2360939,2362294,1355,14.275040468997098,17.811905798440886
2082,C1_10660W_A,1342,C1,2362524,2363240,716,209.5607932575727,261.4827689390552
2084,C1_10670C_A,3745,C1,2364210,2369207,4997,83.79401743232533,104.55530043638126
2086,C1_10680C_A,4643,C1,2369620,2373397,3777,137.44287752641102,171.49650766202524
2088,C1_10690W_A,291,C1,2373907,2374881,974,33.40446898035572,41.68095046856556
2090,C1_10700C_A,679,C1,2374926,2375831,905,83.88643444127636,104.67061520982688
2092,C1_10710C_A,858,C1,2376074,2377636,1562,61.41533123700656,76.63194349251881
2094,C1_10720C_A,1396,C1,2378686,2380479,1793,87.05138173934449,108.61972787627805
2096,C1_10730W_A,727,C1,2381413,2383287,1874,43.37458819008521,54.12132319805905
2098,C1_10740C_A,12075,C1,2383419,2384576,1157,1166.87496072439,1455.9865468768412
2100,C1_10750C_A,285,C1,2386240,2386703,463,68.82312829267474,85.87513853747124
2102,C1_10760W_A,487,C1,2386721,2388169,1448,37.603731197442556,46.920645809265174
2104,C1_10770W_A,332,C1,2388397,2389050,653,56.84541516153134,70.92975898243428
2106,C1_10780C_A,993,C1,2389133,2389591,458,242.4121094055914,302.4735142790871
2108,C1_10790W_A,15492,C1,2390629,2393109,2480,698.4355678058633,871.4839419935196
2110,C1_10800C_A,253,C1,2393472,2395103,1631,17.343514204127544,21.640642062540138
2112,C1_10810W_A,11,C1,2396156,2396764,608,2.0228312118801504,2.52401939387893
2114,C1_10820C_A,560,C1,2396747,2398237,1490,42.02157236247429,52.433076462959015
2116,C1_10830W_A,113,C1,2398464,2399432,968,13.051896654866065,16.28570890656067
2118,C1_10840C_A,1225,C1,2399586,2401076,1490,91.92218954291252,114.69735476272282
2120,C1_10850W_A,59,C1,2403460,2404254,794,8.308106392553784,10.366570150815775
2122,C1_10860C_A,319,C1,2404309,2405646,1337,26.676559407532398,33.286095701475915
2124,C1_10870W_A,6452,C1,2406453,2407245,792,910.8350141486277,1136.5086848735732
2126,C1_10880W_A,997,C1,2407718,2409013,1295,86.0787457137706,107.4061060094036
2128,C1_10890C_A,591,C1,2409010,2409846,836,79.04087578321777,98.62449334098828
2130,C1_10900C_A,3,C1,2410214,2410321,107,3.134786856813419,3.9114795024937714
2132,C1_10910C_A,617,C1,2410846,2412303,1457,47.347401853114874,59.078463801220835
2134,C1_10920W_A,237,C1,2412526,2414079,1553,17.062687250897508,21.290235823940666
2136,C1_10930C_A,579,C1,2414144,2415460,1316,49.19185667177349,61.37991125075902
2138,C1_10940C_A,1250,C1,2415772,2416490,718,194.6507623485584,242.8785438526193
2140,C1_10950C_A,1032,C1,2416729,2418210,1481,77.91035423739928,97.21386733814364
2142,C1_10960W_A,222,C1,2418401,2419166,765,32.44606840816817,40.485091112085854
2144,C1_10970W_A,1679,C1,2419611,2421629,2018,93.0250847682691,116.07350959060348
2146,C1_10980W_A,13,C1,2423223,2423756,533,2.7270097047076085,3.4026691607059636
2148,C1_10990C_A,1283,C1,2424019,2425581,1562,91.83667829496434,114.59065676095761
2150,C1_11000C_A,557,C1,2426349,2426756,407,153.0140555931392,190.9256894915039
2152,C1_11010C_A,588,C1,2427065,2428255,1190,55.24600837066472,68.93407405571375
2154,C1_11020W_A,416,C1,2429970,2432009,2039,22.811121884989195,28.46293536292345
2156,C1_11030W_A,2575,C1,2432310,2433429,1119,257.28690757328485,321.0337771595461
2158,C1_11040W_A,5154,C1,2433984,2434175,191,3017.043605971641,3764.563513222094
2160,C1_11050W_A,106,C1,2434511,2435489,978,12.11818422971295,15.120654573034885
2162,C1_11060C_A,12462,C1,2435729,2436897,1168,1192.9313292317763,1488.4987896484815
2164,C1_11070W_A,1200,C1,2438057,2440174,2117,63.376890633733744,79.07951001735164
2166,C1_11080W_A,3763,C1,2441889,2442974,1085,387.77072651742304,483.84701024995223
2168,C1_11090C_A,1025,C1,2443283,2444914,1631,70.26522553055625,87.67453800040965
2170,C1_11100W_A,208,C1,2445467,2446003,536,43.38794545101956,54.13798993003817
2172,C1_11110C_A,152,C1,2446099,2446473,374,45.44043978539523,56.699021950587074
2174,C1_11120C_A,1334,C1,2446811,2447839,1028,145.08858831641822,181.03656330316338
2176,C1_11130W_A,52,C1,2448571,2449272,701,8.293844066243397,10.348774109308295
2178,C1_11140W_A,536,C1,2449578,2451047,1469,40.79561965327053,50.90337472816492
2180,C1_11150W_A,433,C1,2451373,2452068,695,69.65842199665349,86.91738936692514
2182,C1_11160C_A,144,C1,2452098,2452403,305,52.78775507079909,65.86674991740331
2184,C1_11170W_A,1338,C1,2452925,2454238,1313,113.93625162288652,142.1657462437226
2186,C1_11180C_A,2,C1,2454370,2454459,89,2.5125257953485827,3.135043496380776
2188,C1_11190W_A,368,C1,2454869,2455636,767,53.64422741151029,66.93542672324847
2190,C1_11200W_A,22632,C1,2456985,2464640,7655,330.5584623271909,412.45950963409433
2192,C1_11210C_A,1011,C1,2464977,2466881,1904,59.36831894424112,74.07775177543219
2194,C1_11220C_A,4980,C1,2468077,2469486,1409,395.1744794231366,493.0851591433241
2196,C1_11230W_A,247,C1,2469709,2470272,563,49.052268702618036,61.205738171348656
2198,C1_11240C_A,2097,C1,2470408,2471229,821,285.5787008302632,356.3353062484977
2200,C1_11250W_A,1011,C1,2472572,2473468,896,126.15767775651237,157.41522252279339
2202,C1_11260C_A,174,C1,2473804,2473941,137,142.003556448059,177.18716636844047
2204,C1_11270W_A,4852,C1,2475446,2476084,638,850.2970134434075,1060.9714443221924
2206,C1_11280W_A,779,C1,2476659,2477750,1091,79.83314661655024,99.61306170832975
2208,C1_11290W_A,283,C1,2477968,2479077,1109,28.531554196323157,35.600694564176095
2210,C1_11300C_A,534,C1,2479082,2480827,1745,34.21498594548331,42.69228573323574
2212,C1_11310C_A,1368,C1,2481346,2483355,2009,76.13365869469405,94.99696758868895
2214,C1_11320C_A,66,C1,2485116,2485428,312,23.651564938906375,29.511611374584415
2216,C1_11330C_A,1080,C1,2486989,2487297,308,392.05191468978217,489.18892998720804
2218,C1_11340W_A,101,C1,2487814,2489685,1871,6.035567710953612,7.53097434232143
2220,C1_11350C_A,864,C1,2489747,2491225,1478,65.35966967494068,81.55355368663604
2222,C1_11360W_A,5395,C1,2491976,2492601,625,965.1214586124793,1204.245448003769
2224,C1_11370C_A,500,C1,2492859,2495039,2180,25.643898599314667,31.997576969941402
2226,C1_11380W_A,458,C1,2495591,2496394,803,63.770595560397844,79.57076151897458
2228,C1_11390W_A,13,C1,2496926,2497660,734,1.9802400171786858,2.4708755622020147
2230,C1_11400C_A,2613,C1,2497783,2501832,4049,72.15429258939002,90.03165107283576
2232,C1_11410C_A,31,C1,2503463,2503804,341,10.164308899364723,12.682675962631318
2234,C1_11420W_A,808,C1,2504035,2505111,1076,83.95945864084914,104.76173230099178
2236,C1_11430W_A,387,C1,2506060,2508006,1946,22.235078614900118,27.7441683314088
2238,C1_11440C_A,1003,C1,2508110,2511814,3704,30.276139332259987,37.77752804959809
2240,C1_11450C_A,5406,C1,2513459,2514616,1157,522.4120942174785,651.8478900551719
2242,C1_11470C_A,111,C1,2517426,2518211,785,15.809708491878121,19.72681191130298
2244,C1_11480W_A,2486,C1,2522233,2523870,1637,169.7942523897542,211.8634434172975
2246,C1_11490C_A,15,C1,2524641,2526899,2258,0.7427417929119483,0.9267677297759821
2248,C1_11500C_A,499,C1,2528376,2529182,806,69.22070911738581,86.37122625171625
2250,C1_11510C_A,801,C1,2529466,2530416,950,94.2712902234764,117.62848200709952
2252,C1_11520C_A,541,C1,2531200,2531787,587,103.04565972763112,128.5768392736269
2254,C1_11530C_A,9,C1,2532303,2533463,1160,0.8674711905492307,1.0824007933625006
2256,C1_11540C_A,7434,C1,2534053,2538045,3992,208.21046992401074,259.7978818056647
2258,C1_11550W_A,1719,C1,2538443,2539003,560,343.20878031801345,428.2441424596351
2260,C1_11560C_A,294,C1,2539189,2540280,1091,30.129582933588917,37.59466000288697
2262,C1_11570W_A,101,C1,2540442,2541055,613,18.42177355170344,22.986057087248604
2264,C1_11580W_A,364,C1,2541281,2541658,377,107.95197037945981,134.69876539622229
2266,C1_11590W_A,4390,C1,2542175,2547307,5132,95.6419479248485,119.33874166708229
2268,C1_11600W_A,194,C1,2547617,2548264,647,33.524938471784104,41.83126816731876
2270,C1_11610C_A,665,C1,2548322,2549842,1520,48.91573657819272,61.035378070163226
2272,C1_11620W_A,116,C1,2550020,2550913,893,14.523693343325181,18.122166325103656
2274,C1_11630C_A,120,C1,2550972,2552126,1154,11.62641919164769,14.50704702831312
2276,C1_11640C_A,337,C1,2552572,2553426,854,44.12071790391689,55.05231825933758
2278,C1_11650W_A,4219,C1,2554159,2554632,473,997.2841685213898,1244.3769741009658
2280,C1_11660W_A,6962,C1,2555723,2557429,1706,456.27380078027505,569.3227963483188
2282,C1_11670W_A,1567,C1,2558239,2559036,797,219.8270922187575,274.29270460210296
2284,C1_11680C_A,109,C1,2559106,2559327,221,55.14482520515069,68.80782117282783
2286,C1_11690W_A,1300,C1,2560903,2562321,1418,102.50325617836073,127.90004673175449
2288,C1_11700C_A,3816,C1,2562559,2563638,1079,395.4189345317272,493.39018184190195
2290,C1_11710C_A,9,C1,2564631,2565422,791,1.272144855925547,1.5873387108729462
2292,C1_11720W_A,325,C1,2568085,2568453,368,98.74294650877412,123.20806132175807
2294,C1_11730W_A,2801,C1,2568686,2572051,3365,93.06761411540164,116.12657625100553
2296,C1_11740W_A,221,C1,2572482,2573666,1184,20.869455181043616,26.040190257733734
2298,C1_11750W_A,459,C1,2574666,2576585,1919,26.74288464455054,33.36885405697005
2300,C1_11760C_A,436,C1,2576806,2577432,626,77.87224517788053,97.16631616099009
2302,C1_11770C_A,4508,C1,2578004,2580928,2924,172.37611138908954,215.08499850716888
2304,C1_11780W_A,25,C1,2583710,2583821,111,25.18184637229999,31.421044051564078
2306,C1_11790W_A,194,C1,2584053,2584727,674,32.18195132232095,40.15553487278225
2308,C1_11800C_A,39,C1,2584789,2585226,437,9.97823459457086,12.450498828303973
2310,C1_11810W_A,625,C1,2585501,2587936,2435,28.697997405803886,35.80837669120752
2312,C1_11820W_A,2,C1,2588555,2588663,108,2.07050736838911,2.583508066461935
2314,C1_11830W_A,6,C1,2589041,2589134,93,7.213380509226577,9.000608747673839
2316,C1_11850W_A,4693,C1,2593187,2594629,1442,363.8780293425139,454.0345223432154
2318,C1_11860W_A,9597,C1,2595221,2598883,3662,293.0135438501463,365.6122483197981
2320,C1_11870W_A,3747,C1,2600115,2601776,1661,252.22294997297757,314.715144582646
2322,C1_11880W_A,512,C1,2602121,2602543,422,135.65257753844102,169.26263275246347
2324,C1_11890W_A,384,C1,2603042,2604070,1028,41.76463111956866,52.1124739943139
2326,C1_11900C_A,656,C1,2604245,2605468,1223,59.971915795434036,74.83089922023515
2328,C1_11910W_A,31,C1,2605723,2606970,1247,2.7794942539561913,3.468157580799743
2330,C1_11920W_A,1102,C1,2607298,2608521,1223,100.74550488806146,125.70678497057797
2332,C1_11930W_A,4349,C1,2610679,2613744,3065,158.6461251016995,197.95319261870134
2334,C1_11940C_A,276,C1,2613981,2615726,1745,17.684150039238567,22.065675772234204
2336,C1_11950W_A,145,C1,2616918,2617940,1022,15.863084828264904,19.793413072795452
2338,C1_11960C_A,81,C1,2618147,2618401,254,35.65511507611798,44.489229459466564
2340,C1_11970C_A,447,C1,2619019,2620410,1391,35.929480128092266,44.83157275935168
2342,C1_11980W_A,107,C1,2620858,2621370,512,23.36599916904742,29.155292203158325
2344,C1_11990W_A,143,C1,2623918,2624403,485,32.965892574640634,41.13370987467848
2346,C1_12000C_A,25,C1,2624649,2626028,1379,2.026965153970485,2.529177585006246
2348,C1_12010C_A,335,C1,2626511,2629225,2714,13.800839459896464,17.220214046535155
2350,C1_12020W_A,5,C1,2631951,2632376,425,1.3153811516824934,1.6412874775169946
2352,C1_12030W_A,3479,C1,2632863,2634254,1391,279.63906345779196,348.9240304916879
2354,C1_12040W_A,46,C1,2634434,2634865,431,11.933040146353942,14.889638137103127
2356,C1_12050W_A,4986,C1,2635306,2638164,2858,195.05657309116782,243.38490057609422
2358,C1_12060C_A,192,C1,2638267,2638986,719,29.85677384625632,37.254258182305065
2360,C1_12070C_A,219,C1,2639138,2641018,1880,13.024372414132776,16.251365103180238
2362,C1_12080W_A,670,C1,2641810,2643402,1592,47.05462097256156,58.71314186218142
2364,C1_12090C_A,26,C1,2643534,2644889,1355,2.1453818045891593,2.676933819418861
2366,C1_12100C_A,764,C1,2645318,2647321,2003,42.64645631066457,53.21278521715108
2368,C1_12110C_A,23,C1,2647733,2648113,380,6.767289872471776,8.443992154067693
2370,C1_12120W_A,288,C1,2648544,2650742,2198,14.649922926836872,18.279671269161067
2372,C1_12130C_A,851,C1,2650824,2653223,2399,39.66156548851737,49.48834084459849
2374,C1_12140W_A,429,C1,2653555,2654043,488,98.2897001969306,122.64251612224834
2376,C1_12150C_A,141,C1,2654122,2654799,677,23.28632659219303,29.055879494890956
2378,C1_12160W_A,697,C1,2655467,2655976,509,153.1036470165606,191.03747859625602
2380,C1_12170C_A,473,C1,2656050,2657330,1280,41.31632750265207,51.55309611997715
2382,C1_12180C_A,515,C1,2657594,2658760,1166,49.38319889785691,61.61866151655783
2384,C1_12190W_A,263,C1,2659187,2661355,2168,13.56335131266704,16.923884483345205
2386,C1_12200W_A,317,C1,2661669,2664584,2915,12.158814796598556,15.171352000581615
2388,C1_12210W_A,683,C1,2664810,2666372,1562,48.88889421314159,61.00188508786754
2390,C1_12220W_A,84,C1,2666903,2668348,1445,6.499530396548793,8.10989106537809
2392,C1_12230W_A,2303,C1,2669523,2672528,3005,85.68799911733996,106.9185458107618
2394,C1_12240C_A,532,C1,2672727,2674139,1412,42.12573348376937,52.56304513691111
2396,C1_12250C_A,2802,C1,2674414,2676231,1817,172.41845288729746,215.1378307761269
2398,C1_12260W_A,157,C1,2677427,2678068,641,27.384963290488106,34.170017765154896
2400,C1_12270W_A,116,C1,2678223,2679232,1009,12.853972403953803,16.038745815973797
2402,C1_12280C_A,33,C1,2679385,2680083,698,5.286023109555006,6.59571830148305
2404,C1_12290C_A,1114,C1,2680478,2682487,2009,61.99773083763828,77.35864173523353
2406,C1_12300W_A,16,C1,2683626,2683973,347,5.155384340888158,6.4327117274441274
2408,C1_12310C_A,173,C1,2685652,2686530,878,22.03038705636796,27.488761226523234
2410,C1_12320C_A,973,C1,2687249,2687452,203,535.9044243837469,668.6831567883893
2412,C1_12330W_A,22,C1,2687808,2689043,1235,1.9917107316973788,2.485188326280793
2414,C1_12340C_A,1748,C1,2689209,2690219,1010,193.5042886306781,241.44801327670794
2416,C1_12350W_A,1182,C1,2690712,2693726,3014,43.8474931352157,54.711397765803724
2418,C1_12360C_A,715,C1,2693848,2694471,623,128.31828169101692,160.11114999373243
2420,C1_12370W_A,62,C1,2695803,2696300,497,13.947804163715777,17.40359156240354
2422,C1_12380C_A,1316,C1,2696433,2697707,1274,115.49335606530906,144.1086477512174
2424,C1_12390C_A,5854,C1,2698188,2699014,826,792.3977085541064,988.7266778906553
2426,C1_12400C_A,641,C1,2699565,2699942,377,190.10223355283995,237.2030456565343
2428,C1_12410C_A,2298,C1,2700195,2703026,2831,90.75711775278752,113.24361815026298
2430,C1_12420C_A,17,C1,2703220,2703618,398,4.775692874827143,5.958945741236324
2432,C1_12430W_A,816,C1,2704534,2707485,2951,30.91658308393689,38.57665179280878
2434,C1_12440W_A,134,C1,2707766,2708623,857,17.482136893423103,21.813610698854806
2436,C1_12450C_A,1646,C1,2708975,2716906,7931,23.20451102406981,28.953792835632665
2438,C1_12460C_A,41,C1,2718577,2718870,293,15.645403800728632,19.521798154084383
2440,C1_12470W_A,128,C1,2719965,2720702,737,19.418381180875887,24.22958989875834
2442,C1_12480W_A,32,C1,2720860,2721362,502,7.1271648059290476,8.893031750689689
2444,C1_12490W_A,1567,C1,2723178,2727197,4019,43.59347909886781,54.39444776508486
2446,C1_12500C_A,2,C1,2727470,2727566,96,2.3293207894377486,2.906446574769677
2448,C1_12510W_A,401,C1,2729345,2733526,4181,10.723455287036066,13.380359643904987
2450,C1_12520W_A,125,C1,2734096,2736375,2279,6.13248123590456,7.651899714180809
2452,C1_12530C_A,203,C1,2736499,2737875,1376,16.49484140427429,20.58169725621783
2454,C1_12540W_A,88,C1,2738222,2738758,536,18.356438460046736,22.904534201169994
2456,C1_12550C_A,714,C1,2738857,2741595,2738,29.156494556468424,36.380473707270404
2458,C1_12560C_A,18,C1,2741867,2742981,1114,1.8065827307668,2.2541919574515275
2460,C1_12570C_A,412,C1,2743121,2744461,1340,34.37660293426935,42.89394586764563
2462,C1_12580W_A,301,C1,2744834,2746261,1427,23.583760873017937,29.427007787156484
2464,C1_12590W_A,291,C1,2746753,2747097,344,94.58125810135603,118.01524929181062
2466,C1_12600C_A,673,C1,2747573,2749495,1922,39.150040989592625,48.8500781224556
2468,C1_12610W_A,460,C1,2749614,2750276,662,77.69094113411707,96.94009119473485
2470,C1_12620W_A,4214,C1,2752402,2756802,4400,107.08099425480735,133.61199126632096
2472,C1_12630C_A,132,C1,2756957,2757631,674,21.896997806940025,27.32232269694462
2474,C1_12640W_A,36,C1,2758065,2758466,401,10.037571880669404,12.524537858359107
2476,C1_12650C_A,53,C1,2758614,2759110,496,11.947161468406518,14.907258238334798
2478,C1_12660W_A,129,C1,2759575,2761665,2090,6.901030779042364,8.610869469365475
2480,C1_12670C_A,180,C1,2761699,2764434,2735,7.358439349448685,9.181608192325417
2482,C1_12680W_A,1346,C1,2764631,2766184,1553,96.90454447134196,120.91416632499634
2484,C1_12690C_A,32,C1,2766270,2766920,650,5.504364203963664,6.868156828994191
2486,C1_12700W_A,286,C1,2767655,2769733,2078,15.388313665736966,19.20100990300199
2488,C1_12710C_A,498,C1,2770318,2771721,1403,39.6864462941696,49.519386260366616
2490,C1_12720C_A,5,C1,2772373,2772915,542,1.0314335598986342,1.286987413182145
2492,C1_12730W_A,159,C1,2774634,2775641,1007,17.653799667317674,22.027805619307028
2494,C1_12740W_A,950,C1,2776562,2779384,2822,37.63891849693882,46.964551314492304
2496,C1_12750C_A,188,C1,2779463,2781025,1562,13.4569723456378,16.791148457568227
2498,C1_12760W_A,495,C1,2781193,2782158,965,57.351981302633064,71.56183483577983
2500,C1_12770W_A,2870,C1,2782398,2785190,2792,114.93095700320355,143.4069054943663
2502,C1_12780W_A,874,C1,2785529,2786701,1172,83.37855440144406,104.036899918718
2504,C1_12790C_A,269,C1,2787011,2788024,1013,29.690217209496755,37.0464345246062
2506,C1_12800W_A,95,C1,2789387,2789872,485,21.900418143992027,27.326590476185004
2508,C1_12810W_A,566,C1,2790164,2791078,914,69.23740394687611,86.39205748724574
2510,C1_12820C_A,411,C1,2791182,2792130,948,48.473460478932395,60.4835211255867
2512,C1_12830C_A,600,C1,2792654,2796280,3626,18.500948355159174,23.084848690945037
2514,C1_12840W_A,73,C1,2797709,2798062,353,23.121643190339583,28.850393195447445
2516,C1_12850W_A,443,C1,2799737,2799970,233,212.57801401976093,265.2475535017271
2518,C1_12860C_A,205,C1,2800779,2802220,1441,15.90597957534174,19.846935666713133
2520,C1_12870C_A,47,C1,2802305,2802952,647,8.122021176153881,10.134379401360729
2522,C1_12880C_A,169,C1,2803586,2805145,1559,12.120237488081473,15.123216558391034
2524,C1_12890W_A,145,C1,2805473,2806783,1310,12.375628011058575,15.44188409190607
2526,C1_12900W_A,209,C1,2807779,2809950,2171,10.763586439262781,13.430433918972547
2528,C1_12910W_A,36,C1,2811809,2811973,164,24.54308734236848,30.624022446353674
2530,C1_12920C_A,222,C1,2812364,2813373,1009,24.59984373860124,30.694841130570545
2532,C1_12930C_A,63,C1,2813599,2815155,1556,4.526906212891872,5.648518278986828
2534,C1_12940C_A,3,C1,2815280,2815492,212,1.5821801588633766,1.9741901262586488
2536,C1_12950W_A,456,C1,2815725,2819678,3953,12.897590042806337,16.09317040945072
2538,C1_12960C_A,2099,C1,2819824,2825022,5198,45.14885113071029,56.33518763008744
2540,C1_12970C_A,1052,C1,2827148,2829403,2255,52.16025835186189,65.08378103750316
2542,C1_12980W_A,5,C1,2830700,2830795,95,5.884599889105892,7.342601873102343
2544,C1_12990W_A,8,C1,2830952,2831055,103,8.684069739263062,10.835684317587921
2546,C1_13000W_A,6,C1,2831214,2831305,91,7.371916344594195,9.198424324545792
2548,C1_13010W_A,1028,C1,2831895,2835419,3524,32.615778954034134,40.696850109374274
2550,C1_13020C_A,261,C1,2835573,2836151,578,50.487423616048645,62.99647523999052
2552,C1_13030C_A,2849,C1,2836350,2838695,2345,135.83764460434585,169.49355308865796
2554,C1_13040C_A,2,C1,2839166,2839269,103,2.1710174348157656,2.7089210793969802
2556,C1_13050W_A,4282,C1,2839748,2840497,749,639.1979676607172,797.569296651349
2558,C1_13060C_A,5878,C1,2840957,2843242,2285,287.6165797878005,358.8781017032017
2560,C1_13070C_A,801,C1,2843540,2844841,1301,68.83760623543627,85.89320361778982
2562,C1_13080W_A,10,C1,2848507,2849721,1214,0.92098350817967,1.1491716275860338
2564,C1_13090W_A,1,C1,2853410,2853805,395,0.2830567035266125,0.35318844452897347
2566,C1_13100W_A,9,C1,2854902,2855117,215,4.680309679242361,5.839929861862794
2568,C1_13110C_A,4122,C1,2856152,2859793,3641,126.57788907305556,157.9395477884178
2570,C1_13120C_A,647,C1,2861151,2866055,4904,14.751098376178367,18.405914524071594
2572,C1_13130C_A,927,C1,2866542,2868221,1679,61.730469235748714,77.02516187668348
2574,C1_13140C_A,3033,C1,2868818,2869627,809,419.1740887632945,523.0310483822852
2576,C1_13150W_A,11,C1,2871131,2871499,368,3.3420689587585093,4.170118998582581
2578,C1_13160W_A,1561,C1,2874071,2875447,1376,126.839642522523,158.2661547633302
2580,C1_13170C_A,1965,C1,2875520,2879164,3644,60.29131088358081,75.22942945452141
2582,C1_13180W_A,36,C1,2879441,2880202,761,5.28918045223184,6.5996579253639975
2584,C1_13190W_A,656,C1,2880525,2881034,509,144.09755013323345,179.7999798552998
2586,C1_13200C_A,177,C1,2881257,2882471,1214,16.30140809478016,20.3403378082728
2588,C1_13210C_A,17,C1,2882858,2883161,303,6.273022324030373,7.827262062746061
2590,C1_13220C_A,2464,C1,2883615,2886056,2441,112.86088832789079,140.8239448140759
2592,C1_13240W_A,701,C1,2887954,2889222,1268,61.81150309384966,77.1262731449922
2594,C1_13250W_A,1267,C1,2891491,2892429,938,151.0234255122027,188.44184956417132
2596,C1_13260W_A,707,C1,2893242,2893804,562,140.6545023316004,175.50386292061168
2598,C1_13270W_A,307,C1,2894167,2895063,896,38.30900798343155,47.800665988622725
2600,C1_13280C_A,926,C1,2895365,2895955,590,175.48076347276114,218.95887687349594
2602,C1_13290W_A,87,C1,2896606,2898192,1586,6.1331926965271375,7.652787450339327
2604,C1_13300C_A,3213,C1,2898258,2901239,2981,120.50894647106588,150.36692940197207
2606,C1_13310W_A,289,C1,2902523,2904391,1868,17.297825477023796,21.583633236191094
2608,C1_13320C_A,691,C1,2904794,2906515,1721,44.89187213484675,56.01453805459654
2610,C1_13330C_A,578,C1,2907207,2908241,1034,62.49968663651926,77.98496496171174
2612,C1_13350W_A,4243,C1,2911530,2913284,1754,270.46681257699527,337.47921049252653
2614,C1_13360C_A,83,C1,2913583,2914710,1127,8.234262666477367,10.274430482593075
2616,C1_13370W_A,113,C1,2914941,2916115,1174,10.761700137913415,13.428080256857521
2618,C1_13380W_A,128,C1,2916409,2917254,845,16.936505242965122,21.132790243059052
2620,C1_13390W_A,119,C1,2917513,2919603,2090,6.366067152760011,7.943360208174353
2622,C1_13400C_A,606,C1,2919985,2922180,2195,30.868010534471633,38.516044631845276
2624,C1_13410W_A,431,C1,2925344,2925812,468,102.96792412796611,128.4798434590493
2626,C1_13420C_A,1638,C1,2925999,2930585,4586,39.934696412724286,49.829144242191695
2628,C1_13430C_A,399,C1,2931984,2933711,1727,25.83158758500971,32.23176884770635
2630,C1_13440C_A,2,C1,2935419,2937365,1946,0.11490996700206776,0.14338071489100154
2632,C1_13450W_A,244,C1,2944587,2947346,2759,9.888004742984746,12.337913114788858
2634,C1_13460W_A,18,C1,2951046,2951402,356,5.653183039534313,7.053847866856745
2636,C1_13470W_A,413,C1,2952022,2954022,2000,23.088227664906967,28.808698449117042
2638,C1_13480W_A,11839,C1,2955558,2957528,1970,671.922732819984,838.4021360088904
2640,C1_13490C_A,188,C1,2957814,2959928,2114,9.943136614894156,12.406704773283618
2642,C1_13500C_A,27,C1,2960256,2960366,110,27.44363402828475,34.24322509910456
2644,C1_13510C_A,178,C1,2960894,2962522,1628,12.224641784371084,15.253488657759291
2646,C1_13520C_A,282,C1,2963189,2964004,815,38.686731540894925,48.27197648599061
2648,C1_13540W_A,191,C1,2966485,2968239,1754,12.175149941599363,15.1917344341439
2650,C1_13550C_A,979,C1,2968355,2969704,1349,81.14117311879815,101.2451723065802
2652,C1_13560W_A,234,C1,2969916,2971433,1517,17.24649380815082,21.51958334068096
2654,C1_13570W_A,900,C1,2976150,2978966,2816,35.7338984743291,44.58753268112574
2656,C1_13580W_A,1388,C1,2981409,2983799,2390,64.93249718640192,81.02054250939538
2658,C1_13590W_A,48,C1,2984915,2986141,1226,4.377451140998836,5.462033367266995
2660,C1_13600W_A,27,C1,2986247,2987143,896,3.3691961418653156,4.20396736707757
2662,C1_13610C_A,491,C1,2987589,2989826,2237,24.54064924696865,30.62098027455152
2664,C1_13620W_A,1404,C1,2993143,2996184,3041,51.62038363754974,64.4101438891411
2666,C1_13630W_A,2090,C1,2997002,2998684,1682,138.92833626420628,173.35001211705946
2668,C1_13640W_A,546,C1,2999684,3001459,1775,34.392585492723676,42.913888355810535
2670,C1_13650C_A,259,C1,3001541,3002887,1346,21.514202120572136,26.844683371126767
2672,C1_13660W_A,574,C1,3003281,3005827,2546,25.207166689155088,31.452637874333917
2674,C1_13670W_A,1450,C1,3006268,3008214,1946,83.30972607649913,103.95101829597614
2676,C1_13680C_A,996,C1,3008286,3008819,533,208.93089737605985,260.69680646639534
2678,C1_13690C_A,990,C1,3009398,3009805,407,271.96394082083987,339.3472757568921
2680,C1_13700W_A,16138,C1,3011259,3013047,1788,1009.1430577166817,1259.1740892250484
2682,C1_13710C_A,29,C1,3013321,3013620,299,10.844195782265373,13.531015491904316
2684,C1_13720W_A,1437,C1,3013880,3015796,1916,83.85554841975896,104.63207669170838
2686,C1_13730C_A,218,C1,3015898,3016878,980,24.871441572118982,31.03373159019378
2688,C1_13740W_A,778,C1,3017711,3019987,2276,38.21887326922816,47.68819898427014
2690,C1_13750C_A,123,C1,3020078,3020674,596,23.074345538322934,28.791376807785532
2692,C1_13760W_A,668,C1,3020866,3022500,1634,45.708287510729484,57.03323315386471
2694,C1_13770C_A,169,C1,3022624,3023331,707,26.72623796876806,33.34808290598532
2696,C1_13780W_A,4632,C1,3025935,3030620,4685,110.54255433093518,137.9312071820685
2698,C1_13790C_A,95,C1,3030836,3031201,365,29.100555615989407,36.31067501630063
2700,C1_13800C_A,216,C1,3031379,3033394,2015,11.985309153791851,14.954857611519609
2702,C1_13810W_A,2205,C1,3035056,3037140,2084,118.2990942198135,147.6095515708362
2704,C1_13820C_A,416,C1,3037435,3038457,1022,45.510643369366896,56.7866195743649
2706,C1_13830C_A,1879,C1,3038900,3040153,1253,167.6664809584752,209.20848321757921
2708,C1_13840W_A,809,C1,3041388,3043343,1955,46.267102248310316,57.730503013532534
2710,C1_13850C_A,87,C1,3043435,3044964,1529,6.3618336276599345,7.9380777607836315
2712,C1_13860C_A,11764,C1,3045790,3047977,2187,601.4184859686294,750.4293554039064
2714,C1_13870W_A,353,C1,3051419,3053002,1583,24.932414059528252,31.1098109683496
2716,C1_13880C_A,4990,C1,3053314,3056847,3533,157.91647763547402,197.0427635405698
2718,C1_13890C_A,3,C1,3060917,3060989,72,4.658641578875498,5.812893149539354
2720,C1_13900C_A,1335,C1,3061337,3063046,1709,87.33930730671207,108.97899152208363
2722,C1_13910C_A,431,C1,3063729,3065366,1637,29.437378431208394,36.73095097057733
2724,C1_13920W_A,1160,C1,3065854,3066933,1079,120.20072433354389,149.98234039219244
2726,C1_13930W_A,1431,C1,3067395,3069419,2024,79.04959801625498,98.63537664415988
2728,C1_13940W_A,5160,C1,3074020,3075138,1118,516.0341441215936,643.8897027182054
2730,C1_13950C_A,53,C1,3075627,3076121,494,11.995530543177395,14.967611510554775
2732,C1_13960W_A,831,C1,3076534,3078465,1931,48.115974960690274,60.03746295930238
2734,C1_13970C_A,762,C1,3078503,3080161,1658,51.385547161927086,64.11712299081768
2736,C1_13980C_A,315,C1,3080843,3082867,2024,17.400854909238518,21.712189827330793
2738,C1_13990W_A,105,C1,3083624,3084232,608,19.308843386128707,24.09291239611706
2740,C1_14000C_A,798,C1,3084235,3086670,2435,36.6416030877304,45.72013535933377
2742,C1_14010W_A,3,C1,3087546,3088738,1192,0.28139445778442607,0.3511143513144576
2744,C1_14020W_A,64,C1,3089131,3089538,407,17.581507285387627,21.93760166509201
2746,C1_14030W_A,634,C1,3089848,3090855,1007,70.3931382960969,87.83414316126198
2748,C1_14040W_A,488,C1,3091015,3093318,2303,23.691710886578303,29.561704110900966
2750,C1_14050C_A,772,C1,3093320,3096691,3371,25.60525398202469,31.949357542172994
2752,C1_14060W_A,4434,C1,3097094,3098602,1508,328.7493383671187,410.2021468178912
2754,C1_14080W_A,2068,C1,3099207,3104663,5456,42.37861049170614,52.87857639258381
2756,C1_14090W_A,3028,C1,3104890,3105271,381,888.5900283990557,1108.7521547593806
2758,C1_14100W_A,505,C1,3105687,3106352,665,84.90636982852787,105.94325559761953
2760,C1_14110C_A,13990,C1,3106574,3107665,1091,1433.7172287105748,1788.9431749673088
2762,C1_14120C_A,94,C1,3108041,3108856,815,12.895577180298309,16.09065882866354
2764,C1_14130W_A,445,C1,3113601,3114746,1145,43.453530185493726,54.219824311860535
2766,C1_14140C_A,18236,C1,3115346,3118555,3209,635.3754153870258,792.7996470551549
2768,C1_14150C_A,918,C1,3119756,3120121,365,281.20326374187664,350.8757859469892
2770,C1_14160W_A,547,C1,3120934,3122688,1754,34.86809957096781,43.50721851034928
2772,C1_14170W_A,2076,C1,3123050,3124726,1676,138.4917410655685,172.80524360539906
2774,C1_14180W_A,334,C1,3125262,3126833,1571,23.770637107744108,29.66018554214352
2776,C1_14190C_A,263,C1,3126893,3127267,374,78.62391883920358,98.10422876976581
2778,C1_14200W_A,495,C1,3127604,3128596,992,55.7909898760493,69.61408328278985
2780,C1_14210C_A,3875,C1,3128660,3131260,2600,166.63602570593127,207.92271650275384
2782,C1_14220C_A,1152,C1,3132914,3134062,1148,112.1969707079702,139.99553118333108
2784,C1_14230C_A,965,C1,3135405,3138674,3269,33.005242877563944,41.18280983277193
2786,C1_14240W_A,1306,C1,3139007,3140692,1685,86.65902768443537,108.13016194608993
2788,C1_14250C_A,1121,C1,3140868,3143546,2678,46.80212585439372,58.39808711546184
2790,C1_14260C_A,2290,C1,3144084,3144923,839,305.171562783072,380.7826072689903
2792,C1_14270W_A,146,C1,3145303,3146106,803,20.328617798729447,25.365351925262637
2794,C1_14280C_A,3468,C1,3146581,3147441,860,450.86983243368076,562.5799100261157
2796,C1_14290C_A,3056,C1,3147891,3150121,2230,153.2212591753563,191.1842310133697
2798,C1_14300C_A,2210,C1,3150921,3154691,3770,65.54226773038631,81.78139327627783
2800,C1_14310W_A,437,C1,3155030,3156043,1013,48.23280639609696,60.183241216553554
2802,C1_14320C_A,1289,C1,3156047,3156742,695,207.36652645193152,258.7448380923014
2804,C1_14330W_A,647,C1,3157023,3158294,1271,56.915331578897494,71.01699828957285
2806,C1_14340C_A,16748,C1,3158465,3160450,1985,943.3502770338357,1177.0801144804245
2808,C1_14350W_A,1299,C1,3162078,3162521,443,327.850586598245,409.0807151919615
2810,C1_14360C_A,1719,C1,3162712,3164187,1475,130.3029945614153,162.58760662874278
2812,C1_14370W_A,29,C1,3164722,3165045,323,10.038435104945345,12.525614959998116
2814,C1_14380C_A,651,C1,3165464,3167263,1799,40.459486397082145,50.483959181991594
2816,C1_14390W_A,270,C1,3167371,3167592,221,136.59727344395125,170.44139189599554
2818,C1_14400C_A,820,C1,3167604,3169514,1910,48.0010818179423,59.89410323713848
2820,C1_14410W_A,507,C1,3169513,3169746,233,243.28905893457966,303.56774181800375
2822,C1_14420W_A,2723,C1,3169830,3170801,971,313.54433003364727,391.22985902028415
2824,C1_14430C_A,643,C1,3170798,3171577,779,92.28774948036802,115.15348791231236
2826,C1_14440C_A,7332,C1,3171639,3172988,1349,607.688540660907,758.2529145575547
2828,C1_14450C_A,2487,C1,3173044,3174396,1352,205.66937763307743,256.627194016054
2830,C1_14460W_A,2209,C1,3174488,3175426,938,263.3076140145665,328.54620811937997
2832,C1_14470W_A,693,C1,3175481,3176209,728,106.43204222507867,132.80225118562987
2834,C1_14480W_A,329,C1,3176297,3176611,314,117.14851562675456,146.17389907249282
2836,C1_14490C_A,486,C1,3176578,3177333,755,71.97138460397856,89.80342476321462
2838,C1_14500C_A,2340,C1,3177391,3178053,662,395.2104396822476,493.1300291210425
2840,C1_14520W_A,5613,C1,3179521,3180582,1061,591.4938024255193,738.0456757405707
2842,C1_14530W_A,729,C1,3181102,3181422,320,254.71122832501783,317.81993295106423
2844,C1_14550C_A,194,C1,3182585,3182917,332,65.33323852784433,81.5205738079977
2846,C1_14560C_A,584,C1,3183132,3184109,977,66.83267182141145,83.39151523433326
2848,C1_14570C_A,351,C1,3184381,3185097,716,54.810609860959765,68.39079873145185
2850,C1_14580C_A,453,C1,3185175,3185702,527,96.10768737293057,119.9198753734191
2852,C1_14590C_A,277,C1,3186463,3186663,200,154.85324608182157,193.22056829068813
2854,C1_14630C_A,1730,C1,3187660,3188340,680,284.4511740513392,354.92841701305
2856,C2_00010W_A,37,C2,4248,4778,530,7.805422117059325,9.739337956209335
2858,C2_00030W_A,1762,C2,5665,7335,1670,117.96684735777669,147.1949853339642
2860,C2_00040C_A,1,C2,7396,7467,71,1.5747520830001682,1.964921628013303
2862,C2_00050C_A,4,C2,7510,8043,533,0.8390799091408025,1.0469751263710658
2864,C2_00060C_A,1568,C2,8144,9289,1145,153.1126636648408,191.0487292606681
2866,C2_00070C_A,2976,C2,9360,11063,1703,195.38392021703086,243.79335309025186
2868,C2_00080C_A,400,C2,11100,12443,1343,33.30078865018971,41.55158170929099
2870,C2_00090W_A,163,C2,12627,13253,626,29.112788908244326,36.32593929871878
2872,C2_00100C_A,3849,C2,13261,14415,1154,372.9173955720996,465.31353343314333
2874,C2_00110W_A,345,C2,14823,15446,623,61.91581424251865,77.25642901795483
2876,C2_00120C_A,1675,C2,15457,17610,2153,86.98438990747562,108.5361377665964
2878,C2_00130W_A,24,C2,18818,19147,329,8.156162764231874,10.176980103752793
2880,C2_00140W_A,3962,C2,19683,21197,1514,292.5897691229282,365.08347675257477
2882,C2_00150W_A,733,C2,21533,22759,1226,66.84732679900306,83.40980121263975
2884,C2_00160C_A,1051,C2,22785,23423,638,184.18428712469523,229.81883511595717
2886,C2_00170C_A,1156,C2,23503,24807,1304,99.1176011996333,123.67554259265326
2888,C2_00180C_A,727,C2,24905,25816,911,89.22500358750789,111.33189865330698
2890,C2_00190C_A,1099,C2,26026,27414,1388,88.52761547868886,110.46172169470464
2892,C2_00200W_A,507,C2,27574,28386,812,69.81077676324762,87.10749241822029
2894,C2_00210W_A,3795,C2,28553,28789,236,1797.9198093388998,2243.3826612713747
2896,C2_00220C_A,1681,C2,28893,30038,1145,164.14693088048304,204.81690936682594
2898,C2_00230W_A,574,C2,30161,31549,1388,46.237353307340676,57.693383305514516
2900,C2_00240C_A,252,C2,31623,32573,950,29.658383441093694,37.0067134404358
2902,C2_00250W_A,4109,C2,33340,33609,269,1707.8683938378665,2131.0195941820557
2904,C2_00260C_A,1904,C2,33671,34845,1174,181.32988550962074,226.257210699617
2906,C2_00270C_A,374,C2,34967,35674,707,59.145639055143526,73.79989944874859
2908,C2_00280C_A,196,C2,35745,36395,650,33.71423074927745,42.06746057758942
2910,C2_00290W_A,366,C2,36538,37167,629,65.05804074537738,81.17719145557025
2912,C2_00300C_A,378,C2,37264,38145,881,47.97184608803464,59.85762389627812
2914,C2_00310W_A,1,C2,37590,38036,446,0.25068923294397294,0.3128014250873195
2916,C2_00320W_A,330,C2,38515,39114,599,61.59673005791977,76.85828671845023
2918,C2_00330C_A,1491,C2,39143,41932,2789,59.77225896682712,74.58177427863617
2920,C2_00340C_A,3819,C2,42098,43573,1475,289.48640851078824,361.2112098401214
2922,C2_00350W_A,923,C2,44274,47528,3254,31.714268056315312,39.571975737122244
2924,C2_00360C_A,2092,C2,47572,49671,2099,111.43452901009098,139.04418258793325
2926,C2_00370W_A,399,C2,50247,53261,3014,14.801311134476366,18.468568281349985
2928,C2_00380C_A,3887,C2,53348,55222,1874,231.90787385813098,289.36668950599113
2930,C2_00390C_A,1065,C2,55482,56696,1214,98.08474362113488,122.3867783379126
2932,C2_00400C_A,1551,C2,57065,57796,731,237.22746119297062,296.00428809637884
2934,C2_00410C_A,2212,C2,59132,62923,3791,65.23818626730214,81.40197085801775
2936,C2_00420W_A,385,C2,63244,64164,920,46.78896542261913,58.38166598015612
2938,C2_00430C_A,601,C2,64196,64981,785,85.60031354611489,106.80913476300083
2940,C2_00440W_A,173,C2,65221,66279,1058,18.28230608269477,22.812034363787713
2942,C2_00450C_A,547,C2,66331,68124,1793,34.10967465001536,42.56088191140694
2944,C2_00460W_A,78,C2,69092,70399,1307,6.6725149469433305,8.325735253204034
2946,C2_00470W_A,949,C2,70659,74444,3785,28.03308338189388,34.97871978174593
2948,C2_00480C_A,224,C2,74565,74909,344,72.80481723265893,90.84335340675456
2950,C2_00490W_A,687,C2,75586,77595,2009,38.23378912518626,47.706810477653
2952,C2_00500W_A,531,C2,78116,80620,2504,23.70995538386156,29.584468968741827
2954,C2_00510W_A,315,C2,80938,81942,1004,35.079014279182026,43.770390647925815
2956,C2_00520W_A,2052,C2,82824,84179,1355,169.3201331929598,211.27185374798088
2958,C2_00530W_A,46,C2,84514,84822,308,16.69850747752776,20.835824795751453
2960,C2_00540W_A,711,C2,84801,86633,1832,43.39249994646916,54.14367287322028
2962,C2_00550W_A,186,C2,87920,89629,1709,12.168622591047525,15.183589830043113
2964,C2_00560W_A,3,C2,89853,90329,476,0.7046684741156215,0.8792611486698183
2966,C2_00570W_A,825,C2,90640,92419,1779,51.84997372778801,64.69661852775673
2968,C2_00580C_A,743,C2,92547,94091,1544,53.80368953012169,67.13439808457628
2970,C2_00590W_A,341,C2,95115,96695,1580,24.130583975643717,30.10931489609499
2972,C2_00600C_A,981,C2,96803,97516,713,153.83317999024504,191.94776481452254
2974,C2_00610C_A,1317,C2,97951,98402,451,326.4974346454473,407.3922986045231
2976,C2_00620C_A,288,C2,98606,99577,971,33.16223542037842,41.378699742138025
2978,C2_00630C_A,228,C2,99682,100710,1028,24.797749727243897,30.941781434123882
2980,C2_00640W_A,155,C2,101391,104714,3323,5.215211156610549,6.50736157577081
2982,C2_00650W_A,611,C2,105000,108470,3470,19.687123951766658,24.56491790917726
2984,C2_00660C_A,363,C2,108666,109364,698,58.14625420510507,72.55290131631355
2986,C2_00670C_A,4,C2,110755,111075,320,1.3975924736626493,1.7438679448618064
2988,C2_00680C_A,225,C2,111314,112000,686,36.67152263254765,45.75746794098034
2990,C2_00690W_A,119,C2,115251,116162,911,14.604918056277082,18.223515735548187
2992,C2_00700W_A,4729,C2,117031,119571,2540,208.1642459197061,259.74020507878686
2994,C2_00710W_A,1616,C2,119808,121157,1349,133.93680874359328,167.12175530892094
2996,C2_00720C_A,829,C2,121277,122833,1556,59.5683373093232,74.32732782984255
2998,C2_00730C_A,1348,C2,123700,126801,3101,48.60250640431477,60.644540204417034
3000,C2_00740C_A,2377,C2,127116,128738,1622,163.85091540794662,204.4475514148712
3002,C2_00750W_A,655,C2,130083,130937,854,85.75391758773166,107.0007966168134
3004,C2_00760C_A,5856,C2,131108,131473,365,1793.8195124971999,2238.2664515311208
3006,C2_00770W_A,368,C2,132166,132792,626,65.72703262720191,82.01193657624854
3008,C2_00780W_A,946,C2,133183,134364,1181,89.55952447653625,111.74930234304954
3010,C2_00790C_A,503,C2,134595,135632,1037,54.23251797510609,67.66947550746296
3012,C2_00800C_A,268,C2,136177,137634,1457,20.565808260348113,25.661310046559457
3014,C2_00810C_A,206,C2,137837,138739,902,25.534727234989425,31.861356686610385
3016,C2_00820W_A,480,C2,138889,140388,1499,35.80223548275232,44.67280125596622
3018,C2_00830C_A,805,C2,140471,142381,1910,47.1230132481019,58.798479397434726
3020,C2_00840W_A,770,C2,142772,144541,1769,48.666871892379426,60.72485325239529
3022,C2_00850W_A,1409,C2,144760,146100,1340,117.5646445009357,146.6931304065842
3024,C2_00860C_A,29,C2,146138,147394,1256,2.5815402379755943,3.2211573503816804
3026,C2_00870W_A,298,C2,148523,148981,458,72.74804491728723,90.77251485918224
3028,C2_00880W_A,619,C2,149617,150696,1079,64.14159341591696,80.03367991617854
3030,C2_00890W_A,254,C2,150838,151794,956,29.70614964939857,37.06631447656057
3032,C2_00900W_A,34,C2,152002,152691,689,5.51734619501075,6.884355312081442
3034,C2_00910W_A,42,C2,152901,153590,689,6.815545299719162,8.504203620806486
3036,C2_00920W_A,292,C2,153786,154454,668,48.87389249215493,60.9831664550476
3038,C2_00930C_A,562,C2,154508,155250,742,84.68430945535407,105.66617628165338
3040,C2_00940W_A,1513,C2,155804,156277,473,357.6418456916006,446.2532263130508
3042,C2_00950C_A,588,C2,156333,157421,1088,60.425321655414535,75.39664349843693
3044,C2_00960C_A,1153,C2,157848,158405,557,231.44332095268,288.7870363268457
3046,C2_00970C_A,1710,C2,158667,160769,2102,90.95654157804492,113.4924523582755
3048,C2_00980W_A,5,C2,161335,161679,344,1.6251075275147084,2.0277534242579143
3050,C2_00990W_A,7,C2,163138,163450,312,2.5084993117021908,3.1300193882134986
3052,C2_01000W_A,12975,C2,164439,166079,1640,884.5737729645306,1103.740809003997
3054,C2_01010W_A,7727,C2,167263,168915,1652,522.9635372392878,652.5359617407835
3056,C2_01020W_A,858,C2,170189,171841,1652,58.06945968051105,72.45707974292638
3058,C2_01030W_A,1710,C2,172317,172958,641,298.2693453932144,372.17025718735584
3060,C2_01040W_A,33,C2,173128,173500,372,9.918398200186544,12.375837028051528
3062,C2_01050W_A,93,C2,173661,173918,257,40.459486397082145,50.483959181991594
3064,C2_01060C_A,157,C2,173925,174374,449,39.09523712517345,48.78169574045499
3066,C2_01070W_A,894,C2,174572,175753,1181,84.63659078437992,105.60663456097916
3068,C2_01080C_A,3,C2,175896,176014,118,2.8425609633816595,3.546850057346047
3070,C2_01090C_A,286,C2,176492,176908,416,76.86758605144571,95.91273696739935
3072,C2_01110C_A,3145,C2,178287,179666,1379,254.992216369487,318.1705401937857
3074,C2_01120W_A,12938,C2,180775,182838,2063,701.1944323508427,874.9263585311509
3076,C2_01130W_A,924,C2,183377,185773,2396,43.11771104054384,53.80080070291516
3078,C2_01140C_A,9,C2,185863,186258,395,2.547510331739513,3.178696000760761
3080,C2_01150W_A,403,C2,186639,188039,1400,32.18455810777415,40.158787530246165
3082,C2_01160W_A,428,C2,188329,189579,1250,38.282853038567296,47.7680307456546
3084,C2_01170C_A,947,C2,189661,192597,2936,36.06321723592721,44.99844533471746
3086,C2_01180W_A,80,C2,193352,193537,185,48.349145034815976,60.328404579003035
3088,C2_01190C_A,146,C2,193702,194592,890,18.341438306044658,22.885817523579657
3090,C2_01200C_A,5572,C2,195354,198389,3035,205.2688043030849,256.12737235637525
3092,C2_01210C_A,1110,C2,201446,203062,1616,76.7983983052248,95.82640687111908
3094,C2_01220W_A,1052,C2,204898,207780,2882,40.81241588599881,50.92433249117614
3096,C2_01230W_A,108,C2,208012,208767,755,15.993641023106346,19.956316614047694
3098,C2_01240C_A,335,C2,208760,211288,2528,14.816249325221124,18.487207643313454
3100,C2_01250W_A,185,C2,211504,212085,581,35.601322909134616,44.42210943882054
3102,C2_01260W_A,207,C2,212467,214584,2117,10.93251363431907,13.641215477993157
3104,C2_01270W_A,523,C2,215536,216597,1061,55.11335447506621,68.76855307541751
3106,C2_01290C_A,1,C2,216899,217014,115,0.9722382425479299,1.2131255268603869
3108,C2_01300C_A,410,C2,219289,221418,2129,21.531720590011695,26.86654231633032
3110,C2_01310W_A,627,C2,223575,225620,2045,34.280312214630065,42.773797610889105
3112,C2_01320W_A,137,C2,225984,227225,1241,12.342960121952165,15.401122220536179
3114,C2_01330C_A,236,C2,227542,229101,1559,16.925302054362295,21.118811288640735
3116,C2_01340W_A,701,C2,230474,232207,1733,45.22618922273593,56.43168744826896
3118,C2_01350C_A,741,C2,232520,234412,1892,43.7892610141236,54.638737722731435
3120,C2_01360C_A,1672,C2,235005,236363,1358,137.65977119080705,171.76714013602003
3122,C2_01370C_A,1467,C2,237215,239071,1856,88.37362753720286,110.26958082380474
3124,C2_01380W_A,739,C2,241111,243219,2108,39.196236737635594,48.907719592139465
3126,C2_01390W_A,1646,C2,243991,245559,1568,117.36924549228168,146.44931822665984
3128,C2_01400C_A,362,C2,245788,248499,2711,14.92964885181495,18.628703682478022
3130,C2_01410C_A,1273,C2,248998,250476,1478,96.29960589837904,120.15934472579592
3132,C2_01420C_A,350,C2,254547,256163,1616,24.215711177323133,30.215533698100604
3134,C2_01430W_A,632,C2,256700,257266,566,124.84500966145504,155.77732030426313
3136,C2_01440C_A,208,C2,257408,257812,404,57.564204855808136,71.82664010519915
3138,C2_01450C_A,222,C2,258044,258733,689,36.02502515565842,44.95079056712001
3140,C2_01460C_A,17,C2,259015,260121,1106,1.718558557125862,2.144358413211625
3142,C2_01470W_A,1082,C2,260750,265747,4997,24.209646692063025,30.207966641432453
3144,C2_01480W_A,4082,C2,265919,268789,2870,159.02362306594938,198.42422162859634
3146,C2_01490C_A,500,C2,268951,270369,1418,39.42432929936952,49.19232566605942
3148,C2_01500W_A,25,C2,270227,270661,434,6.440518311809444,8.03625781042307
3150,C2_01510C_A,190,C2,270663,271475,812,26.161829556246634,32.6438334506151
3152,C2_01520W_A,274,C2,271716,272798,1082,28.31351850525441,35.32863710847578
3154,C2_01530C_A,1674,C2,272823,274967,2144,87.29738063101772,108.92667685442777
3156,C2_01540W_A,877,C2,275532,276701,1169,83.87945932606628,104.66191190034588
3158,C2_01550W_A,3291,C2,277093,279438,2345,156.9117895376982,195.78914819753365
3160,C2_01560W_A,1548,C2,280217,282055,1838,94.16640475428864,117.49760951669538
3162,C2_01570W_A,67,C2,282280,282825,545,13.745129649232661,17.150701255888592
3164,C2_01580W_A,370,C2,283127,283840,713,58.020669313344214,72.39620079650697
3166,C2_01590W_A,1818,C2,284195,284599,404,503.1332905185538,627.7924601502503
3168,C2_01600C_A,2065,C2,285006,286565,1559,148.09639297567008,184.7895987756064
3170,C2_01610C_A,8720,C2,287835,288194,359,2715.767436287087,3388.641443831744
3172,C2_01620W_A,2264,C2,289871,290344,473,535.1626825153891,667.7576367301699
3174,C2_01630W_A,389,C2,291098,292192,1094,39.75601259632692,49.60618870575815
3176,C2_01640W_A,3902,C2,292446,296219,3773,115.63012631288963,144.27930497430728
3178,C2_01650W_A,61,C2,296539,298170,1631,4.181637812062372,5.217704212707305
3180,C2_01660C_A,44,C2,298173,298751,578,8.51128980500437,10.620095442757023
3182,C2_01670C_A,2417,C2,299220,301475,2255,119.83968102324164,149.5318429350239
3184,C2_01680C_A,956,C2,301846,304188,2342,45.639569763330236,56.947489505991015
3186,C2_01690W_A,2105,C2,305456,305986,530,444.065231254321,554.0893621032608
3188,C2_01700C_A,4135,C2,306372,308888,2516,183.75341426375374,229.28120674097198
3190,C2_01710W_A,144,C2,309725,310045,320,50.31332905185538,62.77924601502503
3192,C2_01720C_A,314,C2,310184,310579,395,88.87980490735633,110.90117158209766
3194,C2_01730W_A,77,C2,310853,311611,758,11.357743585437888,14.17180282367906
3196,C2_01740C_A,317,C2,311792,312133,341,103.93825551931023,129.69058968239125
3198,C2_01750C_A,795,C2,314646,315143,497,178.84684371216196,223.15895632436798
3200,C2_01760C_A,54,C2,322580,323239,659,9.161759463160312,11.431729168138093
3202,C2_01770C_A,6,C2,323374,323492,118,5.685121926763319,7.093700114692094
3204,C2_01780W_A,1507,C2,327675,331904,4229,39.84245652039939,49.71405046879626
3206,C2_01800W_A,43,C2,332986,333273,287,16.751631043203883,20.90211055862235
3208,C2_01820C_A,166,C2,334153,335997,1844,10.065091133535782,12.55887543805032
3210,C2_01830W_A,67,C2,336552,338495,1943,3.855427513552136,4.810670192722225
3212,C2_01840C_A,730,C2,338553,340511,1958,41.685087059192405,52.01322164449923
3214,C2_01850W_A,1757,C2,341194,342629,1435,136.89588717632193,170.8139918674394
3216,C2_01860C_A,87,C2,342785,343582,797,12.204822605636185,15.228758966421797
3218,C2_01870C_A,166,C2,343945,345300,1355,13.697437675453862,17.091192847058885
3220,C2_01880C_A,168,C2,345450,346557,1107,16.968060384847345,21.17216366661489
3222,C2_01890W_A,808,C2,350675,354109,3434,26.30762303364987,32.825749550339886
3224,C2_01900C_A,470,C2,354235,355758,1523,34.50392449751518,43.052813346555425
3226,C2_01910W_A,82,C2,356072,356839,767,11.953333281912618,14.914959215506455
3228,C2_01920C_A,821,C2,357352,359910,2558,35.885017071994845,44.776093283238254
3230,C2_01930C_A,718,C2,360838,361875,1037,77.41341532033034,96.59380400468868
3232,C2_01940C_A,4,C2,364136,364561,425,1.0523049213459947,1.3130299820135956
3234,C2_01950C_A,138,C2,365021,366994,1973,7.820284292567486,9.757882468968242
3236,C2_01960C_A,47,C2,367186,367519,333,15.780623726641325,19.690520938980157
3238,C2_01970C_A,1734,C2,369820,372591,2771,69.96536555268233,87.30038300657877
3240,C2_01980C_A,436,C2,374511,376388,1877,25.971244262841346,32.406027659445826
3242,C2_01990C_A,2212,C2,377896,385770,7874,31.409444264585016,39.19162706664277
3244,C2_02000W_A,1021,C2,386830,387852,1022,111.69799730798943,139.37292929189076
3246,C2_02010C_A,294,C2,388066,389232,1166,28.191573739747433,35.17647861333592
3248,C2_02020W_A,1409,C2,389582,391966,2384,66.08079850304271,82.45335350034514
3250,C2_02030W_A,2797,C2,392597,393825,1228,254.66228982634726,317.758869171236
3252,C2_02040W_A,1033,C2,394268,397570,3302,34.97790491322875,43.64422984960015
3254,C2_02050C_A,475,C2,398041,401169,3128,16.978425191553924,21.18509651686338
3256,C2_02060C_A,410,C2,402391,404049,1658,27.648391517572314,34.498714470125
3258,C2_02070W_A,22,C2,405503,406978,1475,1.6676357651839069,2.0808187003096807
3260,C2_02080W_A,7,C2,407445,407548,103,7.59856102185518,9.481223777889433
3262,C2_02090W_A,700,C2,408135,409331,1196,65.4391124791876,81.65267969252604
3264,C2_02100W_A,2485,C2,410199,415271,5072,54.779452634884606,68.35192181358973
3266,C2_02110C_A,72,C2,415440,415994,554,14.530925357936573,18.131190184844773
3268,C2_02120W_A,435,C2,416496,417551,1055,46.10068064782957,57.52284784947001
3270,C2_02130C_A,41,C2,417791,418816,1025,4.472295915720477,5.58037742355778
3272,C2_02140C_A,11,C2,418909,419430,521,2.3606168461096573,2.945496720687888
3274,C2_02150C_A,631,C2,419670,422045,2375,29.70546024020654,37.065454255420626
3276,C2_02160W_A,173,C2,422849,423919,1070,18.07727087429072,22.556198464380746
3278,C2_02170W_A,326,C2,424993,426369,1376,26.48925269848975,33.052380815404
3280,C2_02180W_A,286,C2,427326,429101,1775,18.015163829521924,22.47870342447219
3282,C2_02190C_A,234,C2,429572,430366,794,32.95079484504382,41.11487144560833
3284,C2_02200W_A,489,C2,433118,434554,1436,38.07368911537802,47.50704317757233
3286,C2_02210C_A,231,C2,434764,436032,1268,20.36869788114019,25.415362477165758
3288,C2_02220C_A,53,C2,437551,438750,1199,4.942278639140644,6.166805743297798
3290,C2_02230C_A,16,C2,443447,446347,2900,0.6168684021683417,0.769707230835556
3292,C2_02240C_A,782,C2,448737,450545,1808,48.359173203725305,60.34091738415631
3294,C2_02250C_A,597,C2,451417,452715,1298,51.424511973904565,64.16574194653303
3296,C2_02260W_A,1306,C2,455522,456319,797,183.21262440184893,228.60642770283752
3298,C2_02270C_A,503,C2,456427,456894,467,120.42638359782659,150.26391028102591
3300,C2_02280W_A,934,C2,457206,458084,878,118.93862144883047,148.40753170851272
3302,C2_02290C_A,86,C2,458105,459010,905,10.624791401987876,13.257250232761576
3304,C2_02300W_A,203,C2,459062,459790,728,31.177062874012947,38.90166953922491
3306,C2_02310W_A,950,C2,460211,460957,746,142.38207506482755,177.65946891353525
3308,C2_02320C_A,1396,C2,461263,461838,575,271.4489173193821,338.70464709942
3310,C2_02330W_A,16,C2,461588,462091,503,3.5564977460997835,4.437675883544955
3312,C2_02340C_A,2590,C2,462350,463794,1444,200.54096990505602,250.22814278072457
3314,C2_02350C_A,1269,C2,464454,468125,3671,38.64984688810465,48.22595308155015
3316,C2_02360C_A,163,C2,468489,469331,842,21.6444250077921,27.00717102256289
3318,C2_02370C_A,2784,C2,469529,470626,1097,283.74821853613975,354.0512932357535
3320,C2_02380W_A,2025,C2,471161,472777,1616,140.10518609736954,174.8184449675821
3322,C2_02390W_A,302,C2,474604,475146,542,62.2985870178775,77.73403975620154
3324,C2_02400W_A,808,C2,476572,478212,1640,55.0855960350937,68.73391704626046
3326,C2_02410W_A,1063,C2,478612,479181,569,208.87744105495904,260.6301055027206
3328,C2_02420C_A,1758,C2,479261,481102,1841,106.76665154585278,133.2197652174712
3330,C2_02430W_A,1532,C2,481327,484155,2828,60.56892983454537,75.57583285794307
3332,C2_02440W_A,496,C2,484479,487583,3104,17.866130591151393,22.292744862150926
3334,C2_02450C_A,2895,C2,487815,491342,3527,91.77272948689242,114.51086363198024
3336,C2_02460W_A,4669,C2,491786,493972,2186,238.8054623799052,297.9732638448225
3338,C2_02470C_A,1,C2,494231,495081,850,0.13153811516824934,0.16412874775169944
3340,C2_02480W_A,1,C2,496117,496190,73,1.531608190315232,1.9110881587526645
3342,C2_02490C_A,1275,C2,496573,500625,4052,35.18125180493343,43.89795912534656
3344,C2_02500W_A,860,C2,501159,502925,1766,54.44754370780876,67.93777724036936
3346,C2_02510W_A,954,C2,503320,504282,962,110.87760664234241,138.34927396242523
3348,C2_02520W_A,358,C2,504703,506571,1868,21.42775612724747,26.736819026146755
3350,C2_02530W_A,9,C2,507675,509003,1328,0.7577308592146895,0.9454705725154372
3352,C2_02540W_A,2102,C2,509371,514539,5168,45.47584179007568,56.74319535757767
3354,C2_02550C_A,2158,C2,514896,517007,2111,114.29671466277584,142.61551965937576
3356,C2_02560W_A,20,C2,517641,517973,332,6.735385415241684,8.404182866803888
3358,C2_02570W_A,358,C2,519036,520763,1727,23.177213923392166,28.919732449821737
3360,C2_02580W_A,328,C2,521088,522620,1532,23.937876311297593,29.868860883272713
3362,C2_02590W_A,2002,C2,524004,525116,1112,201.2935346958722,251.16716731031195
3364,C2_02600C_A,178,C2,525523,526410,887,22.437110287436443,27.996256521794955
3366,C2_02610C_A,221,C2,526810,528321,1511,16.353034370850857,20.404755304537883
3368,C2_02620W_A,464,C2,529061,529480,419,123.8153523206624,154.49254919634905
3370,C2_02630W_A,413,C2,530019,531332,1313,35.16866361752775,43.882252016933805
3372,C2_02640C_A,1,C2,532052,533413,1361,0.08215091689420422,0.10250509595073072
3374,C2_02650C_A,1,C2,586142,586920,778,0.1437113083457737,0.17931804060275647
3376,C2_02660W_A,206,C2,536192,536950,758,30.385651670132535,37.9141737880245
3378,C2_02670C_A,59,C2,536947,537440,493,13.380601370563296,16.69585537474184
3380,C2_02680W_A,676,C2,537502,538596,1094,69.08756944760152,86.20509913905529
3382,C2_02690W_A,466,C2,538929,539834,905,57.571544108445934,71.83579777287088
3384,C2_02700C_A,295,C2,539908,540801,893,36.935254623111454,46.086543671599806
3386,C2_02710C_A,902,C2,540983,541825,842,119.77467090201517,149.45072553590018
3388,C2_02720W_A,2719,C2,542265,545273,3008,101.06526425236021,126.10576973615032
3390,C2_02730W_A,1278,C2,545624,546715,1091,130.97145234396814,163.42168531867193
3392,C2_02740C_A,589,C2,546837,547478,641,102.73721896877385,128.1919774756448
3394,C2_02750C_A,26,C2,548118,549434,1316,2.208960748646133,2.756265444766381
3396,C2_02760W_A,2171,C2,550317,553115,2798,86.75263074543565,108.2469566345956
3398,C2_02770W_A,2343,C2,553446,555599,2153,121.67428391236739,151.82099748485695
3400,C2_02780C_A,119,C2,555635,556579,944,14.094364776767398,17.58646486767415
3402,C2_02790C_A,38,C2,556999,558633,1634,2.6001720440235334,3.2444054788126633
3404,C2_02800W_A,200,C2,560211,560501,290,77.10855027104272,96.2134038544445
3406,C2_02810C_A,324,C2,560749,561198,449,80.68061674239614,100.6705058592829
3408,C2_02820C_A,420,C2,561952,563013,1061,44.25929040062678,55.22522426706569
3410,C2_02830C_A,2687,C2,563521,564555,1034,290.54785119779797,362.53564161266337
3412,C2_02840C_A,364,C2,564861,568430,3569,11.403164144874292,14.22847703961216
3414,C2_02850W_A,106,C2,570077,571711,1634,7.253111491223541,9.050183704056376
3416,C2_02860W_A,1656,C2,572923,573951,1028,180.10997170313985,224.7350441004787
3418,C2_02870W_A,285,C2,574346,575000,654,48.72340733869787,60.795396242888664
3420,C2_02880C_A,507,C2,575277,576455,1178,48.12084102865625,60.04353467198206
3422,C2_02890W_A,1477,C2,577820,579976,2156,76.59532777735559,95.57302243268602
3424,C2_02900W_A,145,C2,580559,580909,350,46.32020769853352,57.79676617256273
3426,C2_02910W_A,620,C2,581973,582236,263,263.57637526109283,328.88155918306313
3428,C2_02920W_A,1263,C2,583204,583761,557,253.5237765509409,316.3382713623643
3430,C2_02930C_A,1757,C2,584177,585442,1265,155.29296292333754,193.76923188124547
3432,C2_02940W_A,716,C2,586142,587827,1685,47.50984978717896,59.28116076064348
3434,C2_02950W_A,109,C2,588152,589513,1361,8.95444994146826,11.17305545862965
3436,C2_02960C_A,1341,C2,589813,591033,1220,122.89649227420412,153.34602715145456
3438,C2_02970C_A,59743,C2,591403,592902,1499,4456.11032176265,5560.181594656646
3440,C2_02980C_A,2962,C2,595308,597062,1754,188.81044045558804,235.5911905441583
3442,C2_02990C_A,2097,C2,597477,601388,3911,59.94889117403377,74.80216988750105
3444,C2_03000C_A,342,C2,602011,603051,1040,36.76743276866354,45.87714131867214
3446,C2_03010C_A,3958,C2,603455,604696,1241,356.5944245451582,444.9462901378262
3448,C2_03020C_A,15188,C2,606159,608219,2060,824.3353199995464,1028.5773338470335
3450,C2_03030W_A,2553,C2,610668,613454,2786,102.45667150784621,127.84191997795237
3452,C2_03040W_A,1637,C2,613973,614860,887,206.34578393558124,257.47119059650754
3454,C2_03050W_A,968,C2,615026,616600,1574,68.76083936495272,85.79741655025305
3456,C2_03060W_A,3387,C2,616878,618113,1235,306.6329203754101,382.6060391415021
3458,C2_03070C_A,336,C2,618202,619698,1496,25.111821986665788,31.333670025324437
3460,C2_03080W_A,5939,C2,620854,621963,1109,598.759365271955,747.1113958185225
3462,C2_03090C_A,635,C2,622122,622790,668,106.28397853602185,132.6175023936823
3464,C2_03100W_A,67231,C2,623498,626224,2726,2757.4919911023794,3440.7039119883816
3466,C2_03110W_A,172,C2,628185,629063,878,21.903043778585484,27.329866652959517
3468,C2_03120W_A,243,C2,630696,632825,2129,12.761483178958152,15.923340933825044
3470,C2_03130W_A,247,C2,633048,633668,620,44.54262464447412,55.578759016885954
3472,C2_03140C_A,1449,C2,633926,636181,2255,71.84431022038771,89.64486570659894
3474,C2_03150C_A,547,C2,636492,638513,2021,30.261576767678147,37.75935738107504
3476,C2_03160C_A,6623,C2,639344,641908,2564,288.80670680398526,360.3631013672307
3478,C2_03170W_A,297,C2,643405,644115,710,46.770136865105,58.3581723519951
3480,C2_03180C_A,6676,C2,644266,654126,9860,75.70245317786488,94.45892413709873
3482,C2_03200W_A,1194,C2,655510,656850,1340,99.62539782407183,124.30915380089533
3484,C2_03210W_A,171,C2,657092,657531,439,43.55140100160602,54.3419441587916
3486,C2_03220C_A,12996,C2,658895,660025,1130,1285.8840203695427,1604.4819689503743
3488,C2_03230C_A,716,C2,663649,664527,878,91.17778689225119,113.76851467162219
3490,C2_03240C_A,2980,C2,665418,669563,4145,80.38264070474683,100.29870158143659
3492,C2_03250W_A,350,C2,672719,674041,1322,29.601050879390456,36.935175836709966
3494,C2_03260W_A,197,C2,674262,674963,701,31.420909250960563,39.20593268334104
3496,C2_03270W_A,6543,C2,675806,676552,746,980.6378075254386,1223.6062158960642
3498,C2_03280W_A,3265,C2,677031,679187,2156,169.31871712462154,211.270086826486
3500,C2_03290W_A,310,C2,679560,680408,848,40.8729874373039,50.9999115950151
3502,C2_03300W_A,800,C2,680927,681952,1025,87.26431055064347,108.88541314259083
3504,C2_03310C_A,295,C2,682113,682763,650,50.74335750529004,63.315820767290205
3506,C2_03320W_A,693,C2,683898,691313,7415,10.449430443675965,13.038440844657927
3508,C2_03330C_A,1050,C2,691444,692577,1133,103.61674120711609,129.2894151530377
3510,C2_03340W_A,356,C2,692973,695063,2090,19.044705095651796,23.763329698403947
3512,C2_03350W_A,52,C2,695735,697408,1673,3.4751851108407776,4.336216766661754
3514,C2_03360W_A,2989,C2,698119,700455,2336,143.06177752663214,178.50757832849104
3516,C2_03370W_A,508,C2,700790,702436,1646,34.50677893660393,43.05637501773015
3518,C2_03380W_A,7984,C2,702727,706917,4190,213.0477958896915,265.833731203373
3520,C2_03390C_A,2766,C2,707074,709512,2438,126.84957447582897,158.2785475139543
3522,C2_03400C_A,301,C2,710171,711886,1715,19.623339222038833,24.485329511529034
3524,C2_03410W_A,1712,C2,712666,715701,3035,63.06895064014381,78.69527305709161
3526,C2_03420C_A,535,C2,715773,718100,2327,25.705611462295398,32.074580163337046
3528,C2_03430W_A,333,C2,718272,719168,896,41.55341908300556,51.848930860623355
3530,C2_03440W_A,465,C2,719546,720286,740,70.25735137871696,87.66471290386376
3532,C2_03450W_A,495,C2,720617,721876,1259,43.959223158888726,54.85081065649526
3534,C2_03460C_A,509,C2,721980,723086,1106,51.45566503394492,64.20461366615982
3536,C2_03470C_A,1849,C2,723706,724234,528,391.5376490609452,488.54724697719394
3538,C2_03480C_A,67,C2,724850,725209,359,20.86656172376546,26.03657990100079
3540,C2_03490C_A,830,C2,725206,726486,1280,72.50010957124994,90.4631496397062
3542,C2_03500W_A,1949,C2,728326,731385,3059,71.2365539370645,88.8865282650712
3544,C2_03520C_A,6212,C2,740722,742359,1637,424.28073042846074,529.4029406710588
3546,C2_03530W_A,775,C2,747174,748787,1613,53.72023147370382,67.03026198476876
3548,C2_03540W_A,3356,C2,749770,751692,1922,195.22665313680963,243.59712062252746
3550,C2_03550C_A,973,C2,751790,754894,3104,35.047873115303034,43.73153377192107
3552,C2_03560C_A,2638,C2,755206,756342,1136,259.6372496846528,323.96645341869333
3554,C2_03570C_A,157,C2,756676,757386,710,24.723607703102644,30.84926955980886
3556,C2_03580W_A,13,C2,757870,757953,83,17.512002079628378,21.850875453690104
3558,C2_03590C_A,238,C2,758090,758620,530,50.20785037459782,62.647633339941116
3560,C2_03600W_A,596,C2,759431,761515,2084,31.975628188212625,39.89809194386321
3562,C2_03610W_A,216,C2,763392,765050,1658,14.565981872672245,18.174932501334144
3564,C2_03620W_A,405,C2,766541,768199,1658,27.311216011260456,34.07799844000152
3566,C2_03630W_A,3,C2,768418,769167,749,0.44782669383048845,0.5587827860705388
3568,C2_03640W_A,237,C2,769687,770991,1304,20.32082308331582,25.35562594676369
3570,C2_03660W_A,1,C2,771703,771774,71,1.5747520830001682,1.964921628013303
3572,C2_03670W_A,99,C2,773072,774163,1091,10.145675885800351,12.659426327502755
3574,C2_03680W_A,236,C2,775409,776503,1094,24.119328978748463,30.095271297066642
3576,C2_03690C_A,490,C2,776856,779372,2516,21.774890686635874,27.169961621058352
3578,C2_03700W_A,280,C2,782202,783326,1124,27.85237669932682,34.75324018229934
3580,C2_03710W_A,224,C2,785869,788415,2546,9.836943098206863,12.274200146081528
3582,C2_03720W_A,1,C2,789500,789823,323,0.3461529346532877,0.43191775724131426
3584,C2_03730W_A,1,C2,790147,790219,72,1.5528805262918324,1.9376310498464517
3586,C2_03740W_A,1,C2,790226,790313,87,1.2851425045173785,1.603556730907408
3588,C2_03750W_A,1026,C2,790963,792051,1088,105.43602043954988,131.55944936972156
3590,C2_03760C_A,973,C2,792275,795163,2888,37.66918218486863,47.002313306109066
3592,C2_03770C_A,814,C2,795612,798083,2471,36.83173690202822,45.95737781036051
3594,C2_03780C_A,849,C2,798539,800725,2186,43.42382470776173,54.18275883577946
3596,C2_03790C_A,1108,C2,801061,801405,344,360.12382809725943,449.3501588155538
3598,C2_03800C_A,2304,C2,801900,803990,2090,123.25561949545434,153.79413377843454
3600,C2_03810C_A,9023,C2,804382,805193,811,1243.9434663238555,1552.1499843638057
3602,C2_03820C_A,8706,C2,805679,806736,1057,920.9036954177502,1149.0720399596507
3604,C2_03830W_A,483,C2,807027,808910,1883,28.679221020884107,35.78494816221996
3606,C2_03840C_A,470,C2,809042,809518,476,110.3980609447807,137.75091329160486
3608,C2_03850W_A,1,C2,810292,810364,72,1.5528805262918324,1.9376310498464517
3610,C2_03860W_A,1,C2,810371,810458,87,1.2851425045173785,1.603556730907408
3612,C2_03870W_A,179,C2,810975,811424,449,44.57355060768182,55.61734737287543
3614,C2_03880C_A,99,C2,811574,812026,452,24.48878847656678,30.55627018430422
3616,C2_03890W_A,46,C2,812259,813371,1112,4.625126171833228,5.7710737743628115
3618,C2_03900C_A,955,C2,813428,815788,2360,45.24409533382475,56.45403007942458
3620,C2_03910C_A,320,C2,816220,818748,2528,14.152835176330626,17.659422226448672
3622,C2_03920C_A,331,C2,819247,822291,3044,12.157768956171799,15.17004703677419
3624,C2_03930C_A,561,C2,822952,824469,1517,41.34736336056672,51.59182159881205
3626,C2_03940C_A,1505,C2,825401,827764,2363,71.21038249216376,88.85387243392361
3628,C2_03950W_A,1971,C2,830390,831187,797,276.50236041044735,345.01016003238345
3630,C2_03960W_A,3138,C2,831558,832282,724,484.60167760810975,604.6693492791545
3632,C2_03970W_A,310,C2,832702,833439,737,47.02889192243379,58.681038036055355
3634,C2_03980C_A,495,C2,833964,835820,1856,29.819322175129802,37.20752727183596
3636,C2_03990W_A,788,C2,836081,837178,1097,80.31379174083266,100.21279420609687
3638,C2_04000C_A,4,C2,837207,837875,668,0.6695053766048619,0.8353858418499671
3640,C2_04010C_A,109,C2,838065,838634,569,21.418288875814238,26.72500611457812
3642,C2_04020C_A,604,C2,839032,840156,1124,60.081555451404995,74.96770382181715
3644,C2_04030C_A,514,C2,840690,841022,332,173.09940517171128,215.9874996768599
3646,C2_04040C_A,310,C2,841309,846615,5306,6.532282952663722,8.150758581336751
3648,C2_04050C_A,1179,C2,847533,853277,5744,22.949324880895038,28.635380320223813
3650,C2_04060C_A,395,C2,854661,857303,2642,16.716094688773552,20.857769514622667
3652,C2_04070C_A,2,C2,857706,857920,214,1.0449289522711396,1.3038265008312573
3654,C2_04080W_A,2088,C2,858566,860644,2078,112.34545081838736,140.18079957156695
3656,C2_04090W_A,24,C2,860981,862354,1373,1.9543900578530857,2.438620869726634
3658,C2_04100W_A,222,C2,862515,863651,1136,21.849685151627334,27.26328758868458
3660,C2_04110W_A,512,C2,864185,867989,3804,15.04873494248741,18.777295221224914
3662,C2_04120C_A,1004,C2,868107,869474,1367,82.11750364636723,102.46340404630598
3664,C2_04130W_A,1191,C2,870626,872458,1832,72.68701467826268,90.696363420542
3666,C2_04140W_A,4009,C2,872931,874619,1688,265.5425699959034,331.3349095237432
3668,C2_04150C_A,326,C2,874851,875207,356,102.38542616045477,127.7530224775166
3670,C2_04160W_A,747,C2,875525,876382,857,97.45638999542582,121.60274023913833
3672,C2_04170C_A,1153,C2,876638,876868,230,560.4953468288816,699.3668662350132
3674,C2_04180C_A,279,C2,877101,878081,980,31.830881645051363,39.71748217277094
3676,C2_04190C_A,1152,C2,878553,879968,1415,91.02623489240267,113.57941328513363
3678,C2_04200W_A,1155,C2,880756,883416,2660,48.547949085123605,60.57646545309432
3680,C2_04210W_A,349,C2,884415,885788,1373,28.420088757946957,35.46161181394147
3682,C2_04220C_A,1122,C2,886061,886970,909,138.00649112866822,172.19976538041334
3684,C2_04230W_A,1704,C2,887776,888957,1181,161.32075021989192,201.2904980893831
3686,C2_04240C_A,359,C2,889091,890104,1013,39.62374713088972,49.44115239529228
3688,C2_04250W_A,627,C2,890702,892699,1997,35.104275652938654,43.80191092351938
3690,C2_04260W_A,227,C2,893030,894856,1826,13.899386265998746,17.343177370586204
3692,C2_04270W_A,80,C2,895055,896074,1019,8.777813377272773,10.952654413263554
3694,C2_04280W_A,364,C2,897773,900651,2878,14.141032951027224,17.64469581458506
3696,C2_04290W_A,1,C2,899422,900651,1229,0.09097428632466391,0.11351459364438123
3698,C2_04300C_A,290,C2,900914,901672,758,42.77591739970114,53.374322322947116
3700,C2_04310W_A,10483,C2,902492,903700,1208,970.2623775765269,1210.6601103302196
3702,C2_04320W_A,183,C2,903918,905699,1781,11.48835138372891,14.334770753945449
3704,C2_04330C_A,212,C2,905838,906848,1010,23.46848351813716,29.2831686582735
3706,C2_04340C_A,73,C2,907655,908230,575,14.19467834119978,17.71163269216165
3708,C2_04350C_A,571,C2,908645,910807,2162,29.5291508773866,36.84546148070644
3710,C2_04360W_A,660,C2,911437,914340,2903,25.419525528552494,31.71761194926055
3712,C2_04370W_A,92,C2,914705,915937,1232,8.34925373876388,10.417912397875726
3714,C2_04380C_A,491,C2,916040,917584,1544,35.555331842920246,44.364723364100875
3716,C2_04390W_A,45,C2,918662,919405,743,6.771645901999379,8.449427458280622
3718,C2_04400W_A,1340,C2,920773,921963,1190,125.90076737532438,157.09465856234087
3720,C2_04410W_A,507,C2,922531,924594,2063,27.47763002024094,34.28564413165044
3722,C2_04420W_A,209,C2,925532,927565,2033,11.494218474982537,14.34209150914383
3724,C2_04430W_A,9,C2,928590,928910,320,3.1445830657409615,3.9237028759390644
3726,C2_04440W_A,36,C2,928957,929604,647,6.221122603011485,7.762503371255027
3728,C2_04450W_A,86,C2,929893,930708,815,11.798081250060157,14.721241056011321
3730,C2_04460W_A,2091,C2,931947,933200,1253,186.583614520581,232.81263353270788
3732,C2_04470W_A,25,C2,935501,936349,848,3.2962086642987014,4.112896096372185
3734,C2_04480W_A,249,C2,937444,938493,1049,26.539601597101978,33.11520444389627
3736,C2_04490W_A,2354,C2,938705,939382,677,388.76604821292483,485.08893851754124
3738,C2_04500W_A,3225,C2,940654,946401,5747,62.742101653900036,78.28744210446251
3740,C2_04510W_A,447,C2,946908,948107,1199,41.68299154143148,52.01060692932293
3742,C2_04520C_A,69,C2,948352,949059,707,10.911895975414179,13.61548947049105
3744,C2_04530W_A,85,C2,949282,950001,719,13.217842588186393,16.492770549457973
3746,C2_04540C_A,421,C2,950284,951336,1052,44.74421531650003,55.83029694196353
3748,C2_04550C_A,3562,C2,952424,953896,1472,270.5556734340411,337.5900880216171
3750,C2_04560W_A,277,C2,955040,956479,1439,21.522341359530447,26.854839234286054
3752,C2_04570W_A,2387,C2,956813,958096,1283,208.0157901563675,259.55496707000043
3754,C2_04580W_A,519,C2,958569,959624,1055,55.00288104878976,68.63070812385043
3756,C2_04590C_A,1362,C2,959841,960128,287,530.5981739731089,662.0621995545032
3758,C2_04600C_A,5194,C2,961320,961877,557,1042.5989670669733,1300.9192252225812
3760,C2_04610C_A,2,C2,963219,963350,131,1.7069831739391135,2.129915047159458
3762,C2_04620W_A,4546,C2,965382,968297,2915,174.36584247740387,217.5677167023471
3764,C2_04640C_A,283,C2,971681,974749,3068,10.313394264577047,12.868699567037579
3766,C2_04650C_A,412,C2,975240,976046,806,57.15216865002596,71.31251546233888
3768,C2_04660C_A,694,C2,976775,979204,2429,31.944970826574842,39.85983873969843
3770,C2_04670W_A,33,C2,979878,980315,437,8.443121580021497,10.535037470103362
3772,C2_04680W_A,696,C2,981049,981513,464,167.71109683951792,209.26415338341675
3774,C2_04690C_A,196,C2,982318,984330,2012,10.891774347430587,13.590382393356425
3776,C2_04700C_A,109,C2,984870,985955,1085,11.23226393579567,14.015233621377837
3778,C2_04710C_A,174,C2,986357,987391,1034,18.81478455839853,23.476442739338825
3780,C2_04720C_A,439,C2,988585,990066,1481,33.14209836261462,41.353573412252956
3782,C2_04730W_A,95,C2,991582,993189,1607,6.609647044079734,8.247290840665668
3784,C2_04740C_A,60,C2,993261,994097,836,8.024454394235308,10.01263891786683
3786,C2_04750W_A,858,C2,995291,996994,1703,56.33044473999075,70.28719655626212
3788,C2_04760W_A,988,C2,997716,1000391,2675,41.295592193755446,51.52722331285128
3790,C2_04770W_A,564,C2,1000715,1001686,971,64.94271103157439,81.03328699502029
3792,C2_04780W_A,2951,C2,1001834,1004284,2450,134.67086987031763,168.03769160121436
3794,C2_04790C_A,1012,C2,1004405,1005511,1106,102.30477998890424,127.65239495118611
3796,C2_04800C_A,190,C2,1005765,1007186,1421,14.94961688928379,18.6536191146372
3798,C2_04810W_A,403,C2,1007626,1008294,668,67.45266669293984,84.16512356638418
3800,C2_04820W_A,750,C2,1008544,1009959,1415,59.26187167474131,73.94493052417555
3802,C2_04830W_A,683,C2,1010657,1011961,1304,58.5616969025515,73.07127646261435
3804,C2_04850C_A,2493,C2,1013027,1014433,1406,198.24739896677013,247.3663036438397
3806,C2_04860W_A,200,C2,1015779,1017017,1238,18.062584473830686,22.537873277697017
3808,C2_04870C_A,4450,C2,1017114,1021940,4826,103.09633663984732,128.64007218624184
3810,C2_04880C_A,301,C2,1023076,1023824,748,44.9920143927762,56.13949212870629
3812,C2_04890C_A,2,C2,1023950,1024021,71,3.1495041660003364,3.929843256026606
3814,C2_04910W_A,28,C2,1026161,1026466,305,10.264285708210931,12.807423595050643
3816,C2_04920W_A,1,C2,1027101,1027171,70,1.597248541328742,1.9929919369849218
3818,C2_04930C_A,913,C2,1027317,1029554,2237,45.632612550880594,56.938808534960366
3820,C2_04940C_A,1229,C2,1030003,1031667,1664,82.5789014486248,103.03912039592115
3822,C2_04950C_A,4748,C2,1032788,1033654,866,613.004070665151,764.8854505500099
3824,C2_04960C_A,173,C2,1034743,1035171,428,45.193177185726796,56.39049616095187
3826,C2_04970W_A,22,C2,1036592,1038424,1832,1.3426652585405365,1.6753316500855782
3828,C2_04980C_A,376,C2,1038614,1039603,989,42.50716037186298,53.038976523198315
3830,C2_04990W_A,124,C2,1040068,1040901,833,16.643598245778488,20.767310940010944
3832,C2_05000C_A,975,C2,1040957,1041808,851,128.0989576330043,159.8374849579564
3834,C2_05010W_A,1,C2,1042388,1042460,72,1.5528805262918324,1.9376310498464517
3836,C2_05020W_A,267,C2,1042890,1043339,449,66.48680453771534,82.9599539025572
3838,C2_05030C_A,648,C2,1043453,1044176,723,100.20912010328041,125.03750243656437
3840,C2_05040C_A,1189,C2,1044709,1045575,866,153.50923336580973,191.54355532939377
3842,C2_05050C_A,678,C2,1045870,1047258,1388,54.61485286128393,68.14653986261122
3844,C2_05060C_A,86,C2,1047799,1048197,398,24.159387484419668,30.14525492625434
3846,C2_05070W_A,242,C2,1049141,1051390,2249,12.030853841755842,15.011686710771261
3848,C2_05080C_A,186,C2,1051686,1052672,986,21.091456397667567,26.317195760186284
3850,C2_05090W_A,1543,C2,1052876,1055224,2348,73.4747934194708,91.67932670942989
3852,C2_05100C_A,2579,C2,1055350,1056660,1310,220.1154802794487,274.65254533121214
3854,C2_05110W_A,1920,C2,1056968,1058287,1319,162.75223954100298,203.0766613576751
3856,C2_05120C_A,183,C2,1058325,1058669,344,59.47893550703834,74.21577532783967
3858,C2_05130W_A,525,C2,1058903,1060021,1118,52.50347396585981,65.51203370679416
3860,C2_05140W_A,741,C2,1060271,1063651,3380,24.511621845775696,30.584760879114757
3862,C2_05150W_A,330,C2,1063895,1065157,1262,29.236482808790765,36.480280304557596
3864,C2_05160C_A,2111,C2,1065176,1067179,2003,117.83595454425773,147.03166177147372
3866,C2_05170W_A,569,C2,1067412,1068083,671,94.81134038915619,118.30233807765934
3868,C2_05180W_A,5218,C2,1068935,1069132,197,2961.477168557037,3695.2296187975253
3870,C2_05190W_A,884,C2,1069505,1070452,947,104.36931334469121,130.22844884965886
3872,C2_05200C_A,418,C2,1070553,1071908,1355,34.491138243010326,43.03685909681093
3874,C2_05210W_A,72,C2,1072110,1072487,377,21.35313699813491,26.643711836615395
3876,C2_05220C_A,1085,C2,1072541,1075639,3098,39.1578523931304,48.859824923823375
3878,C2_05230C_A,737,C2,1076054,1077037,983,83.82711317105779,104.59659616383735
3880,C2_05240C_A,1,C2,1077341,1077426,85,1.3153811516824934,1.6412874775169946
3882,C2_05250C_A,1738,C2,1077700,1079013,1313,147.9979113008795,184.6667167201718
3884,C2_05260W_A,1753,C2,1083758,1086160,2402,81.59798855389256,101.81517093564518
3886,C2_05270W_A,626,C2,1086618,1089464,2846,24.5929132399949,30.68619349215716
3888,C2_05280C_A,56,C2,1089779,1090675,896,6.987962368313246,8.719339724309032
3890,C2_05290C_A,116,C2,1090726,1091367,641,20.233476061761912,25.246637329668584
3892,C2_05300C_A,2360,C2,1091743,1092969,1226,215.22468109910946,268.54997389062726
3894,C2_05310C_A,1,C2,1092308,1092387,79,1.4152835176330625,1.765942222644867
3896,C2_05320W_A,601,C2,1093474,1095444,1970,34.109769611015324,42.561000400485106
3898,C2_05330C_A,232,C2,1095605,1097107,1502,17.26985107268893,21.54872773411127
3900,C2_05340C_A,746,C2,1097889,1098899,1010,82.58249388929397,103.0436029201511
3902,C2_05350C_A,135,C2,1099417,1100277,860,17.551161297158853,21.899736981985477
3904,C2_05360C_A,264,C2,1100492,1101952,1460,20.217228112161067,25.226363695535174
3906,C2_05370C_A,427,C2,1102511,1104064,1553,30.741634836005215,38.35835737055976
3908,C2_05380W_A,405,C2,1106562,1107680,1118,40.50267991652043,50.53785457381264
3910,C2_05390C_A,66,C2,1107956,1108372,416,17.73867370417978,22.133708530938314
3912,C2_05400W_A,53,C2,1108620,1109912,1292,4.586526384156063,5.722910283447414
3914,C2_05410W_A,5984,C2,1110394,1111214,820,815.9213036485165,1018.0786128832244
3916,C2_05420C_A,2,C2,1111557,1111675,118,1.8950406422544397,2.364566704897365
3918,C2_05430C_A,1,C2,1112160,1112246,86,1.3000860220117667,1.6222027394063316
3920,C2_05440W_A,808,C2,1112792,1116265,3473,26.01220198605058,32.457133301430225
3922,C2_05450C_A,95,C2,1116605,1117036,431,24.64432204138314,30.75033963097385
3924,C2_05460W_A,14314,C2,1118612,1120126,1514,1057.0746984415937,1318.9815462484491
3926,C2_05470W_A,2055,C2,1120484,1121404,920,249.7436985544995,311.6216197122619
3928,C2_05480C_A,65,C2,1121552,1121806,254,28.61212938206999,35.70123351685588
3930,C2_05490W_A,126,C2,1121980,1122426,446,31.586843350940594,39.41297956100226
3932,C2_05500W_A,5611,C2,1122648,1123349,701,894.9376741479172,1116.6725293717084
3934,C2_05510C_A,423,C2,1123477,1124784,1307,36.18556182765421,45.1511027192988
3936,C2_05520W_A,279,C2,1125205,1126004,799,39.04163205525699,48.71480917311078
3938,C2_05530C_A,1526,C2,1126080,1127237,1157,147.46593706545914,184.0029375183486
3940,C2_05540C_A,732,C2,1127540,1128659,1119,73.13942382277457,91.26086403137388
3942,C2_05550W_A,520,C2,1128947,1129336,389,149.45976067960467,186.49076222686668
3944,C2_05560W_A,365,C2,1129692,1130708,1016,40.167027786367484,50.11903936020152
3946,C2_05570C_A,200,C2,1130820,1131869,1049,21.316949073977494,26.59855778626206
3948,C2_05580W_A,2721,C2,1134957,1139015,4058,74.96991859706395,93.54489261644112
3950,C2_05590C_A,312,C2,1139195,1140115,920,37.917291459369274,47.311895547555096
3952,C2_05600W_A,19,C2,1141059,1141154,95,22.36147957860239,27.901887117788903
3954,C2_05610C_A,14105,C2,1141641,1142261,620,2543.618302066022,3173.8396596484877
3956,C2_05620W_A,66,C2,1143167,1143379,212,34.80796349499429,43.43218277769027
3958,C2_05630C_A,2,C2,1143807,1143888,81,2.76067649118548,3.444677421949247
3960,C2_05640W_A,3591,C2,1149967,1151790,1823,220.24156107175313,274.8098646187053
3962,C2_05650W_A,899,C2,1152540,1155374,2834,35.46748437043674,44.25511030150357
3964,C2_05660W_A,17202,C2,1156982,1159933,2951,651.7488507474047,813.2298580145793
3966,C2_05670C_A,119,C2,1160140,1160940,800,16.631350436585528,20.752028543855495
3968,C2_05680W_A,571,C2,1161273,1163942,2669,23.919829223270824,29.846342345930058
3970,C2_05690C_A,691,C2,1164030,1164677,647,119.41099218558153,148.99693970936733
3972,C2_05700W_A,3315,C2,1165370,1166881,1511,245.2955155627628,306.0713295680682
3974,C2_05710C_A,2967,C2,1167165,1167944,779,425.84409441407763,531.3536526218207
3976,C2_05720C_A,3576,C2,1168416,1169708,1292,309.46072358003926,386.13447497373494
3978,C2_05730C_A,563,C2,1170270,1171727,1457,43.20354496483578,53.907901329152885
3980,C2_05740W_A,430,C2,1172463,1174007,1544,31.1380706567326,38.85301638811279
3982,C2_05750W_A,984,C2,1174515,1175765,1250,88.014783621379,109.82182769561712
3984,C2_05760C_A,1712,C2,1175951,1176283,332,576.5489915446882,719.3980533984127
3986,C2_05770W_A,688,C2,1178196,1179634,1438,53.493386474542575,66.74721257662992
3988,C2_05780C_A,827,C2,1180382,1181722,1340,69.00352093844842,86.10022629257993
3990,C2_05790C_A,2311,C2,1182436,1185167,2731,94.6125582316919,118.05430452070699
3992,C2_05800C_A,992,C2,1185717,1187078,1361,81.49370955905059,101.68505518312486
3994,C2_05810W_A,754,C2,1189182,1190819,1637,51.49833720912096,64.2578585424949
3996,C2_05820W_A,328,C2,1191654,1193099,1445,25.379118691285754,31.667193683857302
3998,C2_05830C_A,370,C2,1193133,1194662,1529,27.05607404866869,33.75964105160855
4000,C2_05840W_A,259,C2,1194847,1196127,1280,22.623528167414136,28.22886235745049
4002,C2_05850C_A,216,C2,1196120,1198435,2315,10.432137341205435,13.016863104627221
4004,C2_05860C_A,276,C2,1198788,1200521,1733,17.80660231879475,22.218467525994622
4006,C2_05870W_A,44,C2,1204055,1204384,329,14.952965067758436,18.657796856880115
4008,C2_05880W_A,1,C2,1204115,1204271,156,0.7167140890577688,0.8942912537752854
4010,C2_05890C_A,2083,C2,1204413,1205714,1301,179.0121520454603,223.36522239183046
4012,C2_05900W_A,7,C2,1206361,1207523,1162,0.6735385415241683,0.8404182866803886
4014,C2_05910W_A,2375,C2,1208390,1210834,2444,108.65080605397027,135.57074857763635
4016,C2_05920C_A,2611,C2,1211100,1211381,281,1038.8936508848901,1296.2958587997655
4018,C2_05930W_A,786,C2,1211755,1211940,185,475.0303499670669,592.7265749887048
4020,C2_05940C_A,343,C2,1212168,1214264,2096,18.296725895659876,22.830026911740443
4022,C2_05950C_A,612,C2,1214551,1215612,1061,64.49210886948475,80.47104107486714
4024,C2_05960C_A,260,C2,1215977,1216873,896,32.444110995740076,40.482648720006225
4026,C2_05970C_A,482,C2,1217596,1218492,896,60.14639038441044,75.04860262708844
4028,C2_05980C_A,1104,C2,1219015,1219995,980,125.95445640192366,157.16164988795384
4030,C2_05990C_A,78,C2,1221317,1222471,1154,7.557172474570999,9.429580568403528
4032,C2_06000W_A,585,C2,1223238,1224716,1478,44.25394300907441,55.218551975326484
4034,C2_06010W_A,1573,C2,1225302,1230872,5570,31.575051505513066,39.39826610079169
4036,C2_06020W_A,2025,C2,1232702,1234528,1826,123.99232241694918,154.71336641161696
4038,C2_06030W_A,245,C2,1234771,1236204,1433,19.11571003753519,23.851927229093793
4040,C2_06040C_A,95,C2,1236216,1237487,1271,8.356965224103961,10.427534524744082
4042,C2_06050C_A,3,C2,1237790,1237863,73,4.594824570945696,5.733264476257993
4044,C2_06060C_A,2,C2,1238401,1238733,332,0.6735385415241683,0.8404182866803886
4046,C2_06070W_A,1049,C2,1238997,1241150,2153,54.4755970226519,67.97278120427441
4048,C2_06080C_A,467,C2,1241414,1242331,917,56.94008158782615,71.0478805016762
4050,C2_06090W_A,484,C2,1242516,1245644,3128,17.30012166886758,21.586498345603946
4052,C2_06100W_A,1836,C2,1246014,1248281,2267,90.55067601745476,112.98602723480464
4054,C2_06110W_A,533,C2,1248593,1249798,1205,49.45505649541524,61.7083229617489
4056,C2_06120C_A,174,C2,1249804,1250850,1046,18.59893616958325,23.207114524355966
4058,C2_06130W_A,411,C2,1251040,1251990,950,48.37141108845044,60.35618739690126
4060,C2_06140C_A,48,C2,1252015,1253619,1604,3.345857293556467,4.17484595278637
4062,C2_06150C_A,1469,C2,1253885,1254724,839,195.76289333114966,244.26622274154883
4064,C2_06160W_A,80,C2,1255039,1255347,308,29.04088256961349,36.23621703608948
4066,C2_06170C_A,5075,C2,1255583,1259896,4313,131.5609887101868,164.15728857266248
4068,C2_06180C_A,5,C2,1260497,1261645,1148,0.4869660186977872,0.6076194929832078
4070,C2_06190W_A,1423,C2,1262842,1264551,1709,93.09650509172383,116.16262542016854
4072,C2_06200C_A,916,C2,1264660,1266624,1964,52.14642386456158,65.06651883883563
4074,C2_06210C_A,2161,C2,1266800,1267978,1178,205.1067800057715,255.92520399635748
4076,C2_06220C_A,197,C2,1268218,1269177,959,22.967734499398702,28.65835121065909
4078,C2_06230W_A,1305,C2,1269257,1271869,2612,55.86089366400482,69.70130683138308
4080,C2_06240W_A,51,C2,1272064,1272479,415,13.740186247093035,17.144533048279925
4082,C2_06250C_A,800,C2,1272572,1274758,2186,40.91762045489916,51.055603143255084
4084,C2_06260W_A,71,C2,1275158,1275673,515,15.414223787191938,19.233339663718564
4086,C2_06270W_A,103,C2,1275898,1277094,1196,9.628897979080461,12.014608583328835
4088,C2_06280C_A,32,C2,1277091,1278281,1190,3.006585489559985,3.751514234324558
4090,C2_06290C_A,1913,C2,1278612,1279313,701,305.1177634369926,380.7154782905148
4092,C2_06300W_A,368,C2,1279697,1280149,452,91.02903191289468,113.58290331135305
4094,C2_06310C_A,5402,C2,1280608,1281252,644,937.8626761149853,1170.2328743035378
4096,C2_06320W_A,1818,C2,1285202,1288468,3266,62.23694101944144,77.65711999409098
4098,C2_06330C_A,248,C2,1288828,1290435,1607,17.254657546650257,21.529769773527217
4100,C2_06340W_A,269,C2,1295311,1297473,2162,13.911281236457082,17.35801950667256
4102,C2_06350C_A,17,C2,1297757,1299199,1442,1.3181177282810008,1.6447020839195954
4104,C2_06360C_A,1604,C2,1299920,1300867,947,189.37599389692838,236.29686872720907
4106,C2_06370C_A,46,C2,1301184,1301768,584,8.806747094312584,10.988756912827823
4108,C2_06390C_A,4610,C2,1302199,1304011,1812,284.4548036902787,354.9329459520056
4110,C2_06400C_A,1,C2,1303415,1303501,86,1.3000860220117667,1.6222027394063316
4112,C2_06410W_A,1,C2,1304759,1304860,101,1.1070039395347717,1.381281540484599
4114,C2_06420C_A,3396,C2,1305528,1308080,2552,148.78445268208017,185.6481360736895
4116,C2_06430C_A,217,C2,1309685,1310272,587,41.33254743234002,51.57333479182446
4118,C2_06440C_A,424,C2,1310642,1311376,734,64.58628979105868,80.58855679797338
4120,C2_06460W_A,4122,C2,1314688,1316082,1394,330.6098236119048,412.52359648323477
4122,C2_06470W_A,5624,C2,1317087,1318448,1361,462.0167566130046,576.4886596269096
4124,C2_06480W_A,448,C2,1318661,1319632,971,51.585699542810865,64.36686626554804
4126,C2_06490W_A,978,C2,1319860,1321047,1187,92.12100685708987,114.94543218701578
4128,C2_06500W_A,1,C2,1321383,1321469,86,1.3000860220117667,1.6222027394063316
4130,C2_06510W_A,435,C2,1321731,1323038,1307,37.212102588722416,46.43198506594557
4132,C2_06520C_A,130,C2,1323080,1323985,905,16.06073118905144,20.04002942161634
4134,C2_06530W_A,69,C2,1324473,1325444,971,7.9451189027989955,9.913646813220566
4136,C2_06540C_A,3086,C2,1325586,1329257,3671,93.99009258998498,117.27761324638594
4138,C2_06550W_A,96,C2,1330846,1331601,755,14.216569798316751,17.738948101375726
4140,C2_06560W_A,1,C2,1332428,1332503,75,1.4907653052401593,1.8601258078525935
4142,C2_06570C_A,188,C2,1332506,1332811,305,68.91734689798768,85.99270128105432
4144,C2_06590C_A,32,C2,1334165,1335724,1559,2.294956210760989,2.8635676323580657
4146,C2_06600W_A,2770,C2,1341011,1343941,2930,105.70187445858124,131.89117289466768
4148,C2_06610C_A,87,C2,1345071,1345313,242,40.19522155657867,50.15421857949658
4150,C2_06620W_A,87,C2,1346884,1348161,1277,7.617262033431511,9.504558258604677
4152,C2_06630C_A,76,C2,1349765,1349971,206,41.24933126149955,51.46950050854264
4154,C2_06640C_A,4655,C2,1350861,1354220,3359,154.94594736289687,193.33623776913865
4156,C2_06650C_A,95,C2,1354541,1356250,1709,6.215156699728574,7.755059321796213
4158,C2_06660W_A,91,C2,1356510,1357319,809,12.576604707372173,15.69265591915198
4160,C2_06670C_A,549,C2,1357769,1359901,2132,28.79092938239379,35.924334023607194
4162,C2_06680W_A,1076,C2,1365086,1365943,857,140.37894998002434,175.1600381490132
4164,C2_06690C_A,217,C2,1366921,1367544,623,38.94414982790304,48.59317419390202
4166,C2_06700W_A,465,C2,1371621,1373636,2015,25.801707206079676,32.19448513591028
4168,C2_06710W_A,87,C2,1374467,1375636,1169,8.320995394946141,10.382652605849591
4170,C2_06720W_A,550,C2,1376330,1377367,1037,59.299969952899296,73.99246824871696
4172,C2_06730W_A,2700,C2,1379376,1380329,953,316.7680737787327,395.25233587633807
4174,C2_06740W_A,698,C2,1383179,1385761,2582,30.225237695322363,37.71401473318485
4176,C2_06750C_A,95,C2,1386153,1386893,740,14.35365243221099,17.909995109391527
4178,C2_06760C_A,67,C2,1387411,1388661,1250,5.99287652706544,7.477705747567426
4180,C2_06770W_A,66,C2,1389019,1390239,1220,6.048596935195729,7.5472317613691295
4182,C2_06780C_A,375,C2,1390337,1391983,1646,25.472523821311956,31.78374140088347
4184,C2_06790W_A,20,C2,1392264,1392623,359,6.228824395153869,7.772113403283816
4186,C2_06800C_A,233,C2,1392696,1393475,779,33.441750589309095,41.727469181288924
4188,C2_06810C_A,3036,C2,1395463,1396380,917,370.17149400565347,461.8872916554368
4190,C2_06820C_A,1195,C2,1396740,1397597,857,155.90413125104934,194.5318267547126
4192,C2_06830C_A,978,C2,1398004,1401462,3458,31.621641162338253,39.456399076341164
4194,C2_06840W_A,3,C2,1402344,1403921,1577,0.2126963815339479,0.26539524842538587
4196,C2_06850W_A,156,C2,1404233,1404912,679,25.687708499719978,32.05224146078843
4198,C2_06860W_A,462,C2,1407205,1412160,4955,10.424827008389812,13.00774152211753
4200,C2_06870C_A,964,C2,1412526,1413122,596,180.8428382027911,225.64948977809144
4202,C2_06880C_A,1699,C2,1413826,1415223,1397,135.97764425213123,169.66823984654022
4204,C2_06890C_A,1081,C2,1415603,1416562,959,126.03107103477156,157.25724699859123
4206,C2_06910W_A,291,C2,1417595,1418248,653,49.825348831342225,62.170361035808355
4208,C2_06920C_A,247,C2,1418391,1419161,770,35.86548997347266,44.751728039570516
4210,C2_06930C_A,50,C2,1419414,1420940,1526,3.663414085616381,4.571082424277344
4212,C2_06940C_A,1486,C2,1422371,1424200,1829,90.83969014161606,113.34664914443496
4214,C2_06950C_A,324,C2,1426287,1427003,716,50.5944091024244,63.129968059801705
4216,C2_06960W_A,1052,C2,1427773,1428666,893,131.71487411360422,164.34930150007798
4218,C2_06970W_A,76,C2,1429227,1430270,1043,8.147039539663382,10.1655964571043
4220,C2_06980W_A,15,C2,1431599,1433137,1538,1.0904492642361374,1.3606251845475732
4222,C2_06990W_A,51,C2,1434464,1436020,1556,3.66463836281723,4.57261003537029
4224,C2_07000W_A,632,C2,1436457,1437149,692,102.11311483870456,127.41324175175279
4226,C2_07010W_A,1785,C2,1437380,1438551,1171,170.4322845764529,212.659558092456
4228,C2_07020C_A,356,C2,1438706,1439890,1184,33.61776490702048,41.94709380883805
4230,C2_07030C_A,1335,C2,1440117,1440932,815,183.14463335849194,228.52159081133854
4232,C2_07040W_A,453,C2,1441145,1442233,1088,46.55216107126324,58.08618963399987
4234,C2_07060W_A,615,C2,1442700,1443479,779,88.26899833658838,110.13902809653514
4236,C2_07070W_A,666,C2,1443720,1444874,1154,64.52662651364467,80.51411100713781
4238,C2_07080C_A,286,C2,1444905,1445444,539,59.32637439221042,74.02541480229709
4240,C2_07090C_A,879,C2,1445733,1447313,1580,62.2017105999731,77.61316068524191
4242,C2_07100W_A,1057,C2,1447672,1449081,1409,83.87538649603523,104.65682996274973
4244,C2_07110C_A,737,C2,1449220,1451712,2492,33.06663412806975,41.25941172915414
4246,C2_07120W_A,950,C2,1452374,1453192,818,129.84966747965933,162.02196064730722
4248,C2_07130C_A,4372,C2,1453673,1455391,1718,284.5296528453133,355.0263401599915
4250,C2_07140W_A,952,C2,1457732,1458469,737,144.42421003276442,180.20757487201516
4252,C2_07160W_A,2480,C2,1459884,1461638,1754,158.08571651919593,197.25393401401504
4254,C2_07170C_A,644,C2,1461999,1464395,2396,30.051737997954795,37.49752776263784
4256,C2_07180W_A,84,C2,1466280,1467026,746,12.589572953100543,15.70883725130206
4258,C2_07190C_A,2227,C2,1467249,1467773,524,475.1814410453008,592.9151012530142
4260,C2_07200W_A,180,C2,1468331,1468669,338,59.542401244799265,74.29496569825447
4262,C2_07210C_A,978,C2,1469096,1470337,1241,88.112518242841,109.94377760353565
4264,C2_07220W_A,1303,C2,1472227,1473021,794,183.48241744911155,228.94306621208398
4266,C2_07230C_A,335,C2,1473205,1475970,2765,13.546285097345027,16.902589845315156
4268,C2_07240C_A,189,C2,1476788,1478290,1502,14.06897350318193,17.5547825075303
4270,C2_07250C_A,97,C2,1479002,1479994,992,10.93277983429653,13.641547633193163
4272,C2_07260C_A,906,C2,1480464,1480904,440,230.22159657061096,287.26261055359936
4274,C2_07270W_A,699,C2,1481388,1482407,1019,76.69614438392085,95.6988179358903
4276,C2_07280W_A,135,C2,1482648,1484342,1694,8.910270788404139,11.117930226982
4278,C2_07290W_A,2325,C2,1484562,1485518,956,271.91652730256567,339.28811479528866
4280,C2_07300C_A,182,C2,1485601,1485972,371,54.848912173930394,68.43859104363315
4282,C2_07310W_A,3551,C2,1486613,1488259,1646,241.20781890527667,300.97084190543256
4284,C2_07320W_A,2058,C2,1488635,1489894,1259,182.7638005272586,228.04640066882268
4286,C2_07330W_A,2628,C2,1490143,1497591,7448,39.45083803206705,49.225402353349374
4288,C2_07340W_A,493,C2,1498450,1500138,1688,32.65464879221261,40.74535056004126
4290,C2_07350W_A,1238,C2,1500487,1503123,2636,52.510454700891046,65.52074402849519
4292,C2_07360W_A,702,C2,1503394,1504845,1451,54.092896844172564,67.49526104992353
4294,C2_07370W_A,340,C2,1505218,1506252,1034,36.76452155089368,45.8735088010069
4296,C2_07380W_A,40576,C2,1506829,1508775,1946,2331.293410537951,2908.9079437086393
4298,C2_07390C_A,577,C2,1509083,1511452,2369,27.232109997580366,33.97929266982735
4300,C2_07400C_A,7960,C2,1512062,1513321,1259,706.8998309995036,882.045359243843
4302,C2_07410W_A,304,C2,1514557,1516023,1466,23.18516300100657,28.929651036179486
4304,C2_07420W_A,783,C2,1516379,1517101,722,121.25372929394509,151.29624385892458
4306,C2_07430C_A,356,C2,1517213,1518205,992,40.12442908257283,50.06588615893573
4308,C2_07440C_A,817,C2,1519101,1520804,1703,53.63866358108677,66.92848436651066
4310,C2_07450C_A,476,C2,1521450,1522565,1115,47.73122995253246,59.557391336625635
4312,C2_07460W_A,661,C2,1523224,1524315,1091,67.74032081327304,84.52404850989213
4314,C2_07470W_A,1053,C2,1524598,1528116,3518,33.4659437127179,41.757656530744335
4316,C2_07480W_A,1753,C2,1528366,1530174,1808,108.40617727126656,135.2655091744578
4318,C2_07490W_A,1375,C2,1530892,1532052,1160,132.53032077835468,165.36678787482646
4320,C2_07500C_A,342,C2,1532147,1533118,971,39.380154561699364,49.137205943788906
4322,C2_07510W_A,88,C2,1533370,1534185,815,12.072455232619694,15.063595499174378
4324,C2_07520C_A,500,C2,1534182,1535540,1358,41.166199518782015,51.36577157177633
4326,C2_07530C_A,11,C2,1535671,1537075,1404,0.875983886626162,1.0930226435031265
4328,C2_07540W_A,807,C2,1537720,1538052,332,271.77280150500195,339.1087786755368
4330,C2_07550W_A,2138,C2,1538564,1539199,635,376.4475853468654,469.7183831325407
4332,C2_07560W_A,2294,C2,1539744,1544669,4925,52.07841030793287,64.98165385604847
4334,C2_07570W_A,1107,C2,1545974,1547158,1184,104.53613975301033,130.4366091190554
4336,C2_07580W_A,543,C2,1547643,1548842,1199,50.63504341610132,63.180670162466114
4338,C2_07590W_A,1711,C2,1549130,1549471,341,561.0042750584852,700.0018894213608
4340,C2_07600C_A,4923,C2,1549800,1551644,1844,298.4966484963654,372.45387820193804
4342,C2_07610C_A,1788,C2,1552100,1554259,2159,92.59454721292514,115.5362995984404
4344,C2_07620W_A,98,C2,1554569,1556356,1787,6.131575262179726,7.650769271245977
4346,C2_07630C_A,876,C2,1556455,1556820,365,268.33775494322873,334.82264541346683
4348,C2_07640W_A,857,C2,1558200,1560074,1874,51.1307043726314,63.79913890060056
4350,C2_07650C_A,896,C2,1560176,1561576,1400,71.55673465152763,89.28603877692449
4352,C2_07660W_A,1193,C2,1561929,1565840,3911,34.105401607354445,42.55555015535945
4354,C2_07670C_A,1438,C2,1565975,1567477,1502,107.04330104537362,133.56495897263795
4356,C2_07680W_A,1593,C2,1568150,1569013,863,206.38375995778452,257.51857577426256
4358,C2_07690W_A,240,C2,1569249,1570613,1364,19.6728559342543,24.547114766383196
4360,C2_07700C_A,74,C2,1570678,1570995,317,26.100149665876607,32.56687139931197
4362,C2_07710W_A,26,C2,1571237,1572079,842,3.452484970568065,4.307892310347455
4364,C2_07720C_A,636,C2,1572155,1574203,2048,34.721438017556444,43.3242192551605
4366,C2_07730W_A,1853,C2,1577337,1579364,2027,102.20972288887576,127.53378596266116
4368,C2_07740W_A,3442,C2,1580583,1584782,4199,91.65064623666281,114.35853234035415
4370,C2_07750W_A,447,C2,1585672,1586235,563,88.77070489906988,110.76504033438401
4372,C2_07760W_A,815,C2,1587535,1588641,1106,82.38971906221043,102.80306510396905
4374,C2_07770C_A,19,C2,1588820,1589116,296,7.176826216105496,8.954997554695764
4376,C2_07780W_A,4,C2,1589082,1589399,317,1.4108189008581948,1.760371426989836
4378,C2_07790C_A,112,C2,1589416,1590141,725,17.27231526071357,21.551802463395568
4380,C2_07800W_A,224,C2,1590890,1591228,338,74.09721043797241,92.45595731338332
4382,C2_07810W_A,932,C2,1591735,1593045,1310,79.5454159055627,99.25404119763076
4384,C2_07820C_A,244,C2,1593194,1594201,1007,27.091365527204484,33.80367654786739
4386,C2_07830W_A,341,C2,1595572,1597728,2156,17.683823136139644,22.06526787376163
4388,C2_07840W_A,15,C2,1598697,1600199,1502,1.1165851986652326,1.3932367069468494
4390,C2_07850C_A,1,C2,1600287,1600358,71,1.5747520830001682,1.964921628013303
4392,C2_07860W_A,299,C2,1600857,1602221,1364,24.509099684758485,30.58161381311907
4394,C2_07870C_A,1,C2,1601234,1601776,542,0.2062867119797268,0.257397482636429
4396,C2_07880W_A,521,C2,1602503,1603915,1412,41.25471267865384,51.47621525626069
4398,C2_07890W_A,1151,C2,1604218,1605558,1340,96.03754848869907,119.83235847975756
4400,C2_07900W_A,5466,C2,1608279,1611449,3170,192.78840280227237,240.5547554981611
4402,C2_07910C_A,86,C2,1611757,1611933,176,54.63316033408539,68.16938329914333
4404,C2_07920W_A,288,C2,1612098,1613135,1037,31.051620629881818,38.74514701023725
4406,C2_07930C_A,1994,C2,1613187,1615181,1994,111.80739789301195,139.5094355889445
4408,C2_07940C_A,536,C2,1615386,1616870,1484,40.38326500717952,50.388852746411224
4410,C2_07950W_A,566,C2,1617396,1618439,1043,60.674004992756245,75.70694203580307
4412,C2_07960C_A,673,C2,1618432,1619652,1220,61.677359657374616,76.95889356668823
4414,C2_07970W_A,1,C2,1620166,1620252,86,1.3000860220117667,1.6222027394063316
4416,C2_07980W_A,462,C2,1620414,1621292,878,58.832594335502876,73.40929298643778
4418,C2_07990W_A,1,C2,1621504,1621576,72,1.5528805262918324,1.9376310498464517
4420,C2_08000C_A,4318,C2,1621750,1623579,1829,263.9608223630539,329.3612590886071
4422,C2_08010W_A,3829,C2,1624653,1631255,6602,64.84558111668325,80.9120916192167
4424,C2_08020C_A,390,C2,1631507,1632622,1115,39.10752033925978,48.797022313621845
4426,C2_08030W_A,9,C2,1632157,1632687,530,1.8986161906360524,2.3690281515103786
4428,C2_08040C_A,6509,C2,1633293,1633968,675,1078.1545968675775,1345.284320368059
4430,C2_08050C_A,542,C2,1634398,1636212,1814,33.4066205391469,41.68363510981693
4432,C2_08055W_A,191,C2,1637752,1638088,336,63.557181540372866,79.30447082585835
4434,C2_08060W_A,67,C2,1638309,1638518,209,35.842562960917704,44.72312049980518
4436,C2_08070C_A,1011,C2,1638718,1639695,977,115.69834111549139,144.36442106491594
4438,C2_08080C_A,308,C2,1640824,1641633,809,42.56696977879812,53.11360464943747
4440,C2_08090W_A,62,C2,1641292,1641828,536,12.932945278669292,16.137285459915223
4442,C2_08100W_A,1847,C2,1642751,1643854,1103,187.2241739876637,233.61190166163237
4444,C2_08110W_A,624,C2,1644085,1645620,1535,45.45134611416251,56.712630493486245
4446,C2_08120W_A,647,C2,1646053,1647380,1327,54.51347885213166,68.02004885158033
4448,C2_08130W_A,586,C2,1647947,1648927,980,66.8562603727602,83.42094821951173
4450,C2_08140C_A,3641,C2,1649319,1652102,2783,146.2776628560749,182.5202497230855
4452,C2_08150W_A,25,C2,1654158,1654853,695,4.021848845072372,5.018325021185054
4454,C2_08160C_A,705,C2,1654999,1655677,678,116.25990488875136,145.06512107699982
4456,C2_08170W_A,100,C2,1656941,1658284,1343,8.325197162547427,10.387895427322748
4458,C2_08180C_A,1584,C2,1658532,1659985,1453,121.88776205267098,152.08736818505722
4460,C2_08190W_A,227,C2,1660612,1661778,1166,21.766963397696152,27.16007022186141
4462,C2_08200W_A,109,C2,1662501,1663337,836,14.577758816194141,18.18962736745808
4464,C2_08210C_A,15,C2,1663652,1663780,128,13.102429440587338,16.348761983079434
4466,C2_08240W_A,1019,C2,1665658,1669284,3626,31.420777289845333,39.20576802678833
4468,C2_08260W_A,8,C2,1670481,1670792,311,2.87607454387169,3.5886671534133634
4470,C2_08270C_A,318,C2,1671420,1672556,1136,31.298197649628346,39.0528173567644
4472,C2_08280W_A,167,C2,1673267,1674376,1109,16.8366415222119,21.008183718082716
4474,C2_08290C_A,1064,C2,1675845,1676450,605,196.63317579861936,245.35213134981316
4476,C2_08300C_A,48,C2,1676486,1677021,535,10.031317941802941,12.516734407980067
4478,C2_08310W_A,470,C2,1678351,1678905,554,94.85465164208594,118.35638037329227
4480,C2_08320C_A,140,C2,1679166,1679777,611,25.618716374830885,31.966155454095304
4482,C2_08330W_A,436,C2,1681559,1682557,998,48.84571691518357,60.948009936653115
4484,C2_08340C_A,104,C2,1682884,1683324,440,26.42720313834828,32.974957502841434
4486,C2_08350C_A,9,C2,1684411,1684974,563,1.7873296288403333,2.230168597336591
4488,C2_08360C_A,17,C2,1685485,1688250,2765,0.6874234228503447,0.8577433652846499
4490,C2_08370C_A,4155,C2,1690400,1691776,1376,337.61608884118067,421.26577388958174
4492,C2_08380C_A,695,C2,1692182,1694329,2147,36.1928931232619,45.160250458461306
4494,C2_08390W_A,741,C2,1695306,1696499,1193,69.44617086229829,86.65254968265539
4496,C2_08400C_A,9,C2,1696572,1696691,119,8.456021689387459,10.55113378403782
4498,C2_08420W_A,110,C2,1699140,1700204,1064,11.559035496458002,14.42296796502246
4500,C2_08430C_A,11,C2,1700273,1701295,1022,1.2034064352476823,1.5015692675913792
4502,C2_08440W_A,5,C2,1701368,1701685,317,1.7635236260727436,2.200464283737295
4504,C2_08450W_A,1231,C2,1704611,1709302,4691,29.34020609812358,36.6097026668068
4506,C2_08460C_A,55,C2,1709508,1709996,488,12.6012436149911,15.72339950285235
4508,C2_08470C_A,103,C2,1710326,1712089,1763,6.532139525229853,8.150579617504983
4510,C2_08480W_A,924,C2,1712468,1713754,1286,80.33439786403036,100.23850581973929
4512,C2_08490W_A,313,C2,1715956,1718130,2174,16.09738525322573,20.085765105492012
4514,C2_08500W_A,1781,C2,1719320,1721818,2498,79.71536254902092,99.46609478939558
4516,C2_08510W_A,120,C2,1722519,1723238,719,18.6604836539102,23.283911363940668
4518,C2_08520C_A,4,C2,1723457,1723618,161,2.7778235501369424,3.4660729338868204
4520,C2_08530C_A,69,C2,1724226,1726340,2114,3.6493426937643445,4.553524624237073
4522,C2_08540C_A,111,C2,1726552,1727601,1049,11.830906736057507,14.762199571375444
4524,C2_08550C_A,437,C2,1728216,1731656,3440,14.203439790478551,17.722564928014172
4526,C2_08560W_A,367,C2,1732007,1735522,3515,11.673773834064122,14.566134526640866
4528,C2_08570W_A,638,C2,1736690,1737976,1286,55.4689890013543,69.21230163743904
4530,C2_08580W_A,55,C2,1739575,1740807,1232,4.991401691652319,6.228099803077881
4532,C2_08590W_A,5140,C2,1746839,1748440,1601,358.9569176577648,447.89412799948457
4534,C2_08600W_A,204,C2,1749986,1751044,1058,21.55832624780193,26.899739943425974
4536,C2_08610W_A,596,C2,1751816,1753162,1346,49.50758480255209,61.77386598143457
4538,C2_08620W_A,1821,C2,1753778,1755259,1481,137.47553785494583,171.53726009957325
4540,C2_08630C_A,607,C2,1755545,1756948,1403,48.37283714972078,60.35796678723401
4542,C2_08640C_A,162,C2,1757291,1757896,605,29.938509849037906,37.356245562659524
4544,C2_08650W_A,669,C2,1758955,1759428,473,158.13773613197674,197.31884230233376
4546,C2_08660C_A,406,C2,1759736,1761676,1940,23.398867806475696,29.196304561397667
4548,C2_08670C_A,322,C2,1762253,1763524,1271,28.3257137069629,35.34385386281678
4550,C2_08680W_A,272,C2,1764313,1767426,3113,9.769229754866448,12.189709759136816
4552,C2_08690C_A,72,C2,1767421,1768830,1409,5.713365967563422,7.128942059903481
4554,C2_08700C_A,459,C2,1769650,1770171,521,98.50210294221206,122.90754498143096
4556,C2_08710W_A,149,C2,1770912,1771637,725,22.978347980770728,28.671594348624456
4558,C2_08720W_A,785,C2,1772078,1773226,1148,76.4536649355526,95.39626039836362
4560,C2_08730W_A,759,C2,1774396,1776672,2276,37.28550746959405,46.52357715817614
4562,C2_08740W_A,197,C2,1776991,1778634,1643,13.405999625638074,16.72754644614855
4564,C2_08750W_A,30,C2,1778791,1779492,701,4.784910038217345,5.970446601524016
4566,C2_08760C_A,8218,C2,1779860,1783114,3254,282.3703736585041,352.3320656637818
4568,C2_08770C_A,71,C2,1783693,1784028,335,23.696493284787607,29.56767142332854
4570,C2_08780W_A,2806,C2,1784325,1785530,1205,260.3581398238934,324.8659554046293
4572,C2_08790W_A,1147,C2,1785847,1787757,1910,67.14297664046319,83.7787029426803
4574,C2_08800C_A,942,C2,1787951,1789603,1652,63.75458160727437,79.55077985761847
4576,C2_08810C_A,7994,C2,1790255,1791121,866,1032.0881509893043,1287.804189489633
4578,C2_08820C_A,27,C2,1791402,1792331,929,3.2495153316591203,4.054633757698064
4580,C2_08830W_A,728,C2,1793219,1794115,896,90.84351078807221,113.35141641601741
4582,C2_08840W_A,84,C2,1794757,1795149,392,23.958728119931134,29.89487905477382
4584,C2_08850C_A,757,C2,1795173,1796258,1085,78.00755779263599,97.33515459984422
4586,C2_08860W_A,2037,C2,1797497,1799881,2384,95.53341841781264,119.20332227125837
4588,C2_08870C_A,14730,C2,1800507,1801664,1157,1423.4424986724857,1776.122719295724
4590,C2_08880W_A,9,C2,1807223,1807564,341,2.9509283901381456,3.6820672149574802
4592,C2_08890W_A,6,C2,1809126,1810265,1139,0.5889766350817135,0.7349048406792511
4594,C2_08900W_A,451,C2,1812528,1812710,182,277.0611892843318,345.7074475308461
4596,C2_08910C_A,930,C2,1812881,1814407,1526,68.13950199246467,85.02213309155857
4598,C2_08920W_A,3001,C2,1816047,1817795,1748,191.9530898609433,239.51248066500142
4600,C2_08930W_A,681,C2,1818186,1819019,833,91.40556778528348,114.05273185602788
4602,C2_08940C_A,339,C2,1819068,1819814,746,50.80791941787004,63.396378907040464
4604,C2_08950W_A,246,C2,1820110,1820652,542,50.7465311470128,63.319780728561526
4606,C2_08960C_A,627,C2,1820603,1821982,1379,50.836286061579756,63.43177383195663
4608,C2_08970C_A,191,C2,1822232,1823080,848,25.18303419524208,31.42252617628349
4610,C2_08980C_A,609,C2,1823866,1828080,4214,16.158211987860533,20.161662618335832
4612,C2_08990C_A,803,C2,1830609,1833755,3146,28.538251909754795,35.60905174123409
4614,C2_09000C_A,113,C2,1839535,1840146,611,20.677963931113503,25.80125404509121
4616,C2_09010W_A,727,C2,1842875,1844386,1511,53.79482347334195,67.12333532307258
4618,C2_09020W_A,1751,C2,1844929,1847274,2345,83.48603569751127,104.17101139285366
4620,C2_09030W_A,117,C2,1847640,1848216,576,22.710877697018052,28.337854104004354
4622,C2_09040W_A,780,C2,1848596,1849177,581,150.1028749682432,187.29321817448658
4624,C2_09050C_A,574,C2,1849370,1850905,1535,41.809411329373845,52.168349203944075
4626,C2_09060C_A,7943,C2,1851749,1853470,1721,516.0291466962195,643.8834671022581
4628,C2_09070C_A,260,C2,1854294,1856705,2411,12.057205911316096,15.04456791917278
4630,C2_09080C_A,1,C2,1858791,1859419,628,0.1780372577914203,0.2221487827849435
4632,C2_09100C_A,1431,C2,1860193,1862481,2288,69.92849055284094,87.25437164675682
4634,C2_09110C_A,1,C2,1862511,1862975,464,0.24096421959700848,0.30066688704513905
4636,C2_09120C_A,1,C2,1863726,1864559,833,0.13422256649821362,0.16747831403234634
4638,C2_09130C_A,517,C2,1865856,1869113,3257,17.747750909022773,22.145034755752015
4640,C2_09140C_A,2988,C2,1872612,1875896,3284,101.72975179790491,126.93489450053781
4642,C2_09150W_A,3659,C2,1880424,1882058,1634,250.36919760742396,312.4020959730404
4644,C2_09160W_A,162,C2,1882409,1883422,1013,17.880353858507338,22.310492167234955
4646,C2_09170W_A,545,C2,1883670,1884461,791,77.03543849771367,96.12217749175065
4648,C2_09180W_A,177,C2,1884891,1885955,1064,18.599538935209694,23.20786663462705
4650,C2_09200W_A,14,C2,1888032,1888123,91,17.20113813738645,21.462990090606844
4652,C2_09210W_A,6,C2,1889155,1889655,500,1.3416887747161435,1.6741132270673342
4654,C2_09220W_A,47265,C2,1889869,1890507,638,8283.035519456442,10335.287575409815
4656,C2_09230C_A,1502,C2,1891008,1892246,1238,135.65000939846846,169.25942831550458
4658,C2_09240C_A,73,C2,1892523,1893164,641,12.733135797488101,15.887970043670746
4660,C2_09250W_A,319,C2,1893408,1894058,650,54.871630658262795,68.46693838903585
4662,C2_09260C_A,1211,C2,1894128,1894934,806,167.98853455141125,209.6103306429427
4664,C2_09270C_A,3208,C2,1895205,1896446,1241,289.0234749724273,360.63357725167924
4666,C2_09280C_A,555,C2,1896700,1898205,1505,41.231299555230315,51.447001164029366
4668,C2_09290W_A,204,C2,1898815,1899127,312,73.10483708389243,91.21770788507911
4670,C2_09300W_A,726,C2,1899244,1900299,1055,76.94044632258453,96.00364951428787
4672,C2_09310C_A,196,C2,1900351,1900848,497,44.09305832400471,55.017805584372475
4674,C2_09320C_A,4757,C2,1901073,1902836,1763,301.6833759370719,376.4301673832155
4676,C2_09330C_A,4,C2,1903115,1903606,491,0.9108545653198529,1.136533080154334
4678,C2_09340W_A,3,C2,1903774,1904226,452,0.7420844992899023,0.9259475813425522
4680,C2_09350W_A,633,C2,1904445,1905677,1232,57.446495833016684,71.6797668245145
4682,C2_09360W_A,607,C2,1906142,1908715,2573,26.376638368075497,32.91186451709651
4684,C2_09370C_A,626,C2,1908759,1910822,2063,33.92701458120479,42.33296494361573
4686,C2_09380W_A,820,C2,1911130,1911897,767,119.53333281912619,149.14959215506454
4688,C2_09390W_A,794,C2,1912239,1913105,866,102.51163271022111,127.91049868085675
4690,C2_09400C_A,3195,C2,1913246,1914592,1346,265.397203765359,331.15352652799237
4692,C2_09410W_A,12,C2,1917972,1918328,356,3.7687886930228744,4.702565244571164
4694,C2_09420W_A,751,C2,1919179,1921308,2129,39.43981015389947,49.21164214527822
4696,C2_09430W_A,18105,C2,1921832,1923001,1169,1731.6278347758607,2160.665809527665
4698,C2_09460C_A,517,C2,1930208,1933412,3204,18.04133105826691,22.511353994845294
4700,C2_09470C_A,377,C2,1936516,1939248,2732,15.428766107491034,19.25148507212009
4702,C2_09480W_A,130,C2,1939565,1940335,770,18.87657367024877,23.553541073458163
4704,C2_09490W_A,177,C2,1940851,1941816,965,20.507678162759703,25.58877730491521
4706,C2_09500W_A,422,C2,1942008,1943411,1403,33.62988019305135,41.962210847137975
4708,C2_09510C_A,745,C2,1943575,1945293,1718,48.48458174056688,60.49739785434439
4710,C2_09520C_A,2088,C2,1946179,1947759,1580,147.75559924089174,184.36436804412412
4712,C2_09530W_A,622,C2,1951210,1953171,1961,35.46364175902775,44.25031562280647
4714,C2_09540W_A,15,C2,1953454,1953601,147,11.408918152348159,14.23565669274944
4716,C2_09550C_A,1,C2,1953891,1954005,114,0.9807666481843152,1.2237669788503904
4718,C2_09560C_A,378,C2,1954790,1957033,2243,18.842263220489755,23.51072967125324
4720,C2_09570C_A,369,C2,1957829,1958539,710,58.10835186270621,72.50560807369088
4722,C2_09580W_A,946,C2,1960675,1961838,1163,90.94565641168471,113.4788702211019
4724,C2_09590C_A,817,C2,1962052,1963068,1016,89.90811425058146,112.18426070488944
4726,C2_09600C_A,323,C2,1965926,1966426,500,72.22757903888572,90.12309539045815
4728,C2_09610W_A,294,C2,1967507,1968607,1100,29.88306816413228,37.287067330136075
4730,C2_09620W_A,612,C2,1968951,1971164,2213,30.920075693865034,38.58100975166473
4732,C2_09630C_A,107,C2,1971151,1971660,509,23.503716256487778,29.32713086054433
4734,C2_09640W_A,1144,C2,1972394,1973719,1325,96.53408542611749,120.45192023679436
4736,C2_09650W_A,5398,C2,1974605,1975096,491,1229.1982358991418,1533.7513916682738
4738,C2_09660W_A,796,C2,1977647,1978303,656,135.66873280920353,169.2827907451217
4740,C2_09670C_A,345,C2,1978366,1979250,884,43.63524012792887,54.44655574455413
4742,C2_09680W_A,333,C2,1979666,1980118,452,82.37137942117916,102.78018152902328
4744,C2_09690C_A,634,C2,1980286,1982229,1943,36.48270214316499,45.5218642117297
4746,C2_09700W_A,180,C2,1982608,1983588,980,20.536052674226685,25.62418204694899
4748,C2_09710C_A,821,C2,1983621,1985015,1394,65.84926375191019,82.16445238057636
4750,C2_09720W_A,5122,C2,1985611,1987776,2165,264.51616259030357,330.05419357347523
4752,C2_09730C_A,1152,C2,1987847,1988899,1052,122.43547754063668,152.77078878180998
4754,C2_09740W_A,1827,C2,1989824,1990711,887,230.29550839969878,287.3548351984235
4756,C2_09750W_A,3301,C2,1992136,1993851,1715,215.20479326229295,268.52515853009083
4758,C2_09760W_A,466,C2,1994315,1994887,572,91.08784513661463,113.65628843434989
4760,C2_09770C_A,991,C2,1994898,1997858,2960,37.432814632423934,46.707381982650006
4762,C2_09780C_A,349,C2,1998133,1998852,719,54.27090662678883,67.71737555012744
4764,C2_09790W_A,628,C2,1999375,2000892,1517,46.28546201503725,57.753411700630956
4766,C2_09800C_A,3,C2,2001195,2002058,863,0.3886699810881064,0.48496906925473177
4768,C2_09810C_A,237,C2,2003065,2004369,1304,20.32082308331582,25.35562594676369
4770,C2_09820W_A,21,C2,2009284,2011107,1823,1.2879623454488487,1.6070752316883352
4772,C2_09830C_A,104,C2,2012619,2012861,242,48.04946025154233,59.954468186984414
4774,C2_09840W_A,40,C2,2013163,2014107,944,4.737601605636099,5.911416762243411
4776,C2_09850C_A,47,C2,2014219,2015478,1259,4.173906037308627,5.2080567694046
4778,C2_09860C_A,147,C2,2015889,2017409,1520,10.812952296232075,13.492030941825554
4780,C2_09870W_A,483,C2,2018704,2019741,1037,52.07615543136429,64.97884029841872
4782,C2_09880C_A,1169,C2,2020316,2021494,1178,110.95318178007724,138.44357402671997
4784,C2_09890W_A,430,C2,2024080,2025381,1301,36.954020825515094,46.10995949519303
4786,C2_09900C_A,1027,C2,2025549,2026205,656,175.03993542091962,218.40882675281404
4788,C2_09910C_A,54,C2,2026825,2027007,182,33.173623550673874,41.39290946045607
4790,C2_09920W_A,70,C2,2027268,2027756,488,16.03794641907958,20.01159936726663
4792,C2_09930W_A,750,C2,2028006,2029757,1751,47.89009047387719,59.75561204552164
4794,C2_09940W_A,3151,C2,2031192,2032163,971,362.8270965611542,452.7232044704059
4796,C2_09950W_A,1514,C2,2034730,2036274,1544,109.63497435882131,136.79876002698316
4798,C2_09960W_A,316,C2,2036718,2037725,1007,35.085538961461545,43.77853192264793
4800,C2_09970C_A,870,C2,2038151,2039194,1043,93.26216315140978,116.36932786422025
4802,C2_09980W_A,1322,C2,2041560,2042537,977,151.28902765052382,188.77325880100784
4804,C2_09990C_A,6254,C2,2042831,2047297,4466,156.57041343996792,195.3631908135376
4806,C2_10000C_A,125,C2,2048493,2049189,696,20.080351633084042,25.055573920428255
4808,C2_10010C_A,422,C2,2049481,2050200,719,65.6227008495842,81.88175496319136
4810,C2_10020C_A,10,C2,2050568,2051806,1238,0.9031292236915343,1.1268936638848506
4812,C2_10030C_A,8564,C2,2053448,2054584,1136,842.88605242584,1051.7243013941204
4814,C2_10040W_A,5,C2,2056151,2056465,314,1.780372577914203,2.221487827849435
4816,C2_10050W_A,2660,C2,2057988,2062139,4151,71.6472364238525,89.3989637838093
4818,C2_10060C_A,58,C2,2062293,2063261,968,6.699203592763113,8.359036429916097
4820,C2_10070W_A,7,C2,2064740,2065882,1142,0.6853343128293201,0.8551366454663848
4822,C2_10080W_A,303,C2,2066873,2068165,1292,26.221084799986546,32.71777011102956
4824,C2_10090C_A,474,C2,2068477,2071431,2954,17.940658971322836,22.385738818266656
4826,C2_10100W_A,174,C2,2071601,2073547,1946,9.997167129179896,12.474122195517134
4828,C2_10110W_A,2526,C2,2074655,2074987,332,850.6791779450247,1061.448296077331
4830,C2_10120W_A,209,C2,2075721,2076518,797,29.319631316988076,36.58403016071443
4832,C2_10130W_A,164,C2,2076975,2080109,3134,5.850801931861505,7.300429941476356
4834,C2_10140W_A,115,C2,2081130,2082971,1841,6.984166625581953,8.714603526740152
4836,C2_10150W_A,310,C2,2084376,2085581,1205,28.763728918534195,35.89039421790274
4838,C2_10160W_A,789,C2,2088696,2089952,1256,70.23569819871531,87.63769480866021
4840,C2_10170C_A,629,C2,2090445,2091293,848,82.93260999375534,103.48046578472416
4842,C2_10180W_A,185,C2,2093231,2094343,1112,18.601050908459726,23.20975322298088
4844,C2_10190C_A,402,C2,2094546,2095355,809,55.558187828171576,69.32360087361643
4846,C2_10200W_A,241,C2,2095699,2096214,515,52.32152017905995,65.28499801346723
4848,C2_10210C_A,1024,C2,2096599,2097471,872,131.29676082849107,163.82759408609996
4850,C2_10220C_A,1029,C2,2099020,2100465,1445,79.61924735772268,99.34616555088158
4852,C2_10230W_A,780,C2,2102788,2104539,1751,49.805694092832276,62.145836527342496
4854,C2_10240W_A,414,C2,2107703,2108914,1211,38.22317318555486,47.69356427235592
4856,C2_10250C_A,896,C2,2109181,2111715,2534,39.53410754228046,49.32930319167099
4858,C2_10260C_A,847,C2,2112284,2113717,1433,66.0857404154788,82.45951984915283
4860,C2_10270W_A,1042,C2,2114376,2116652,2276,51.18774543256522,63.87031277841836
4862,C2_10280C_A,1557,C2,2116936,2119164,2228,78.13470310566409,97.49380215977855
4864,C2_10290W_A,2665,C2,2120835,2122465,1630,182.80166588029257,228.09364775738473
4866,C2_10300C_A,251,C2,2122695,2124740,2045,13.723059594692419,17.123162998936465
4868,C2_10310C_A,149,C2,2125311,2127308,1997,8.34216438961381,10.409066551203171
4870,C2_10320C_A,48,C2,2127689,2129014,1325,4.050381206690244,5.0539267232221405
4872,C2_10330C_A,56,C2,2129274,2129768,494,12.674522838074227,15.814834803605045
4874,C2_10340W_A,80,C2,2131033,2131848,815,10.97495930238154,13.69417772652216
4876,C2_10350C_A,2300,C2,2132111,2134138,2027,126.86581902019117,158.29881689914768
4878,C2_10360C_A,699,C2,2137302,2138324,1022,76.47100893073909,95.41790164057947
4880,C2_10420W_A,139,C2,2151459,2152997,1538,10.104829848588206,12.60846004347418
4882,C2_10430C_A,305,C2,2156597,2158927,2330,14.6357323422183,18.26196474447557
4884,C2_10440C_A,662,C2,2159273,2162185,2912,25.417753229798734,31.715400535673513
4886,C2_10450W_A,133,C2,2162387,2162893,506,29.38811051338061,36.66947615282534
4888,C2_10460C_A,1246,C2,2162911,2164833,1922,72.4828396330348,90.44160080323874
4890,C2_10470C_A,610,C2,2165301,2166059,758,89.97692970281963,112.27012626550943
4892,C2_10480W_A,1174,C2,2166474,2167502,1028,127.68665868326461,159.3230324721993
4894,C2_10490C_A,5,C2,2167627,2167722,95,5.884599889105892,7.342601873102343
4896,C2_10500W_A,1,C2,2168360,2168447,87,1.2851425045173785,1.603556730907408
4898,C2_10530C_A,902,C2,2169608,2170894,1286,78.42167410536297,97.8518747287931
4900,C2_10540W_A,446,C2,2171151,2171960,809,61.63918351085702,76.91125868067893
4902,C2_10550C_A,4918,C2,2171966,2179213,7247,75.87536675008042,94.67467976078778
4904,C2_10560C_A,336,C2,2179659,2180270,611,61.48491929959414,76.71877308982873
4906,C2_10570W_A,1627,C2,2181205,2184774,3569,50.96963753766614,63.59816522925546
4908,C2_10580W_A,205,C2,2184896,2185423,527,43.49244130563083,54.26837627273933
4910,C2_10590W_A,1284,C2,2186547,2187332,785,182.8798712033469,228.19122967669392
4912,C2_10600W_A,431,C2,2187377,2187721,344,140.08426887176785,174.79234517103222
4914,C2_10610W_A,1293,C2,2187993,2189639,1646,87.82926213588364,109.5903403502462
4916,C2_10620W_A,5899,C2,2189809,2190597,788,836.9947210290322,1044.373300176629
4918,C2_10630W_A,1168,C2,2190690,2192378,1688,77.36436062739216,96.53259524163934
4920,C2_10640C_A,248,C2,2192388,2192990,602,46.06019049413117,57.47232562468147
4922,C2_10650W_A,29,C2,2193331,2193519,188,17.24688584519865,21.520072511060587
4924,C2_10660W_A,906,C2,2194521,2195870,1349,75.09080985253433,93.69573657789752
4926,C2_10670W_A,2437,C2,2196056,2197075,1019,267.39414000517183,333.64523506404095
4928,C2_10680W_A,1040,C2,2197235,2198446,1211,96.01956549028277,119.80991991123229
4930,C2_10690W_A,1836,C2,2198731,2201816,3085,66.54080471039545,83.02733346557605
4932,C2_10700C_A,442,C2,2201813,2202685,872,56.67301590448542,70.71464510357049
4934,C2_10710W_A,3390,C2,2202878,2203342,464,816.8687044338589,1019.2607470830212
4936,C2_10720C_A,901,C2,2203464,2204570,1106,91.08360352767068,113.65099590021609
4938,C2_10730W_A,144,C2,2204861,2205835,974,16.53004650574304,20.625624974135533
4940,C2_10740C_A,951,C2,2205832,2208582,2750,38.665031053183405,48.24489936184954
4942,C2_10750C_A,1731,C2,2208732,2210936,2204,87.81243455208879,109.56934346844962
4944,C2_10760C_A,882,C2,2211080,2213146,2066,47.73190945868177,59.558239201088604
4946,C2_10770W_A,94,C2,2213264,2213599,335,31.372822095352603,39.14593118018144
4948,C2_10780C_A,142,C2,2213596,2215209,1613,9.8429327345367,12.281673808822145
4950,C2_10790C_A,201,C2,2215273,2215932,659,34.102104668430044,42.55143634806957
4952,C2_10800W_A,4,C2,2216095,2216185,90,4.969217684133864,6.200419359508644
4954,C2_10810W_A,285,C2,2216351,2217262,911,34.97816509276444,43.644554492699434
4956,C2_10820C_A,1896,C2,2217265,2220897,3632,58.366416961770554,72.82761285149746
4958,C2_10830W_A,259,C2,2221164,2221412,248,116.76659699310522,145.69735410297025
4960,C2_10840W_A,594,C2,2221521,2223911,2390,27.788114790146068,34.67305637649918
4962,C2_10850C_A,1084,C2,2223908,2225521,1613,75.13900763547734,93.75587611805074
4964,C2_10860C_A,2090,C2,2225780,2226865,1085,215.3709323469078,268.7324611805475
4966,C2_10870W_A,2,C2,2227315,2228484,1169,0.19128725045853198,0.2386816690999906
4968,C3_00010C_A,464,C3,3828,4880,1052,49.31428956497866,61.532678814895675
4970,C3_00020W_A,1,C3,3999,4823,824,0.13568858967598535,0.16930756746231126
4972,C3_00030C_A,5000,C3,4903,8097,3194,175.02723527396986,218.3929799451229
4974,C3_00040W_A,1,C3,5971,7002,1031,0.10844558476528801,0.13531468049364162
4976,C3_00050C_A,13,C3,12190,12501,311,4.673621133791496,5.831584124296716
4978,C3_00060W_A,16,C3,13756,14265,509,3.514574393493499,4.385365362324385
4980,C3_00090W_A,11086,C3,15901,16308,407,3045.446715090738,3800.003938425157
4982,C3_00100W_A,450,C3,16407,17105,698,72.08213331211373,89.94161320204158
4984,C3_00110C_A,2429,C3,17074,19533,2459,110.44333854498821,137.80740912791632
4986,C3_00120W_A,1,C3,17482,18108,626,0.1786060669217443,0.22285852330502318
4988,C3_00130C_A,1189,C3,19602,21179,1577,84.29866588128803,105.18498345926128
4990,C3_00140W_A,1,C3,19605,20204,599,0.18665675775127202,0.2329038991468189
4992,C3_00150W_A,1,C3,20107,20643,536,0.20859589159144018,0.2602787977405681
4994,C3_00160C_A,821,C3,21254,22687,1433,64.0571344523118,79.92829491871838
4996,C3_00170C_A,405,C3,22745,23092,347,130.49566612873153,162.8280156009295
4998,C3_00180C_A,426,C3,23211,24971,1760,27.062472444558576,33.76762475050589
5000,C3_00190W_A,1,C3,24430,24810,380,0.2942299944552946,0.3671300936551171
5002,C3_00200C_A,3322,C3,25109,26203,1094,339.5102155398407,423.6292002070144
5004,C3_00210C_A,354,C3,26343,26975,632,62.62629565526302,78.14294335203537
5006,C3_00220W_A,6400,C3,28278,30170,1892,378.20684276705947,471.91352419093283
5008,C3_00230C_A,1,C3,29708,30205,497,0.22496458328573832,0.2807030897161861
5010,C3_00240C_A,3008,C3,30220,31575,1355,248.2041718540073,309.7006511081513
5012,C3_00250C_A,4036,C3,31718,32992,1274,354.2030281759782,441.9623877841288
5014,C3_00260C_A,3142,C3,33094,34464,1370,256.4225139998858,319.95521651128735
5016,C3_00270C_A,1272,C3,34558,36054,1496,95.06618323523476,118.62032223872822
5018,C3_00280C_A,1107,C3,36189,38813,2624,47.168745986114416,58.85554313908597
5020,C3_00290W_A,4837,C3,39195,40520,1325,408.1602895158481,509.2884075046978
5022,C3_00300W_A,1365,C3,40606,42942,2336,65.33266186813412,81.51985427179335
5024,C3_00310C_A,462,C3,42951,43340,389,132.78924891149492,165.68986951694697
5026,C3_00320W_A,7655,C3,45115,45879,764,1120.2691503547205,1397.8334154887045
5028,C3_00330W_A,2127,C3,46161,48251,2090,113.78676331025666,141.97921985535166
5030,C3_00340W_A,438,C3,48422,48775,353,138.7298591420375,173.10235917268471
5032,C3_00350W_A,314,C3,48915,49538,623,56.35236426710394,70.31454699025454
5034,C3_00360W_A,423,C3,51706,52413,707,66.89466663188692,83.46887023214077
5036,C3_00370C_A,669,C3,52683,53342,659,113.50402001581942,141.62642247193304
5038,C3_00380C_A,318,C3,53465,55492,2027,17.540578455835124,21.886532075621286
5040,C3_00390W_A,92,C3,55651,56463,812,12.667833258814161,15.80648777608731
5042,C3_00400C_A,785,C3,56493,59342,2849,30.806882185333233,38.43977077477061
5044,C3_00410C_A,40,C3,59698,60243,545,8.206047551780694,10.239224630381248
5046,C3_00420W_A,1135,C3,59837,62410,2573,49.3204028793504,61.54030679885427
5048,C3_00430W_A,83,C3,62513,63145,632,14.683566495443024,18.321650559940498
5050,C3_00440W_A,139,C3,63282,63911,629,24.707835146468458,30.829589104711108
5052,C3_00450C_A,3768,C3,63988,65094,1106,380.9134496029557,475.2907353518471
5054,C3_00460W_A,5974,C3,65437,66054,617,1082.5565559365532,1350.7769338871221
5056,C3_00470W_A,1025,C3,66463,67896,1433,79.97388893254518,99.78867514212709
5058,C3_00480C_A,1905,C3,68046,68837,791,269.2706611709074,335.9866938014403
5060,C3_00490W_A,851,C3,70068,71693,1625,58.55267421966349,73.06001826842571
5062,C3_00500C_A,264,C3,71714,72883,1169,25.249917060526222,31.505980321198763
5064,C3_00510W_A,231,C3,73019,74104,1085,23.804155680447707,29.70200886732367
5066,C3_00520W_A,311,C3,74279,74863,584,59.54126839850464,74.29355217150983
5068,C3_00530C_A,335,C3,74962,76422,1460,25.65443718778014,32.01072665910713
5070,C3_00540C_A,313,C3,77128,77889,761,45.98648559857128,57.38035918441476
5072,C3_00550C_A,2103,C3,78180,80270,2090,112.50285060717901,140.37719762849295
5074,C3_00560C_A,1003,C3,81718,83028,1310,85.60520617304655,106.81523961504682
5076,C3_00570C_A,663,C3,83705,85030,1325,55.945890417409004,69.80736286450582
5078,C3_00580W_A,572,C3,88912,92647,3735,17.122846477858857,21.365300443608103
5080,C3_00590W_A,1,C3,90951,91517,566,0.1975395722491377,0.24648310174725177
5082,C3_00600W_A,23,C3,95652,97187,1535,1.675290001002785,2.0903693931893965
5084,C3_00610W_A,138,C3,97647,98375,728,21.19425949070831,26.445469933069152
5086,C3_00620C_A,268,C3,98473,98888,415,72.20333165139084,90.09284033213765
5088,C3_00630W_A,826,C3,99338,103045,3707,24.91311320734499,31.08572802710228
5090,C3_00640W_A,563,C3,103831,105315,1484,42.41749664000386,52.927097194458064
5092,C3_00650W_A,93,C3,107369,108898,1529,6.800580774395102,8.485531399458365
5094,C3_00660W_A,466,C3,109086,112745,3659,14.239477293835357,17.76753128845262
5096,C3_00670C_A,683,C3,113161,115300,2139,35.70100643334603,44.54649112073356
5098,C3_00680C_A,1,C3,113161,113604,443,0.2523869026930292,0.31491971916240297
5100,C3_00690C_A,409,C3,116945,118288,1343,34.05005639481898,42.48649229775005
5102,C3_00700W_A,384,C3,118533,122573,4040,10.627237819533809,13.260302788652151
5104,C3_00710W_A,2360,C3,123503,126820,3317,79.54942991483516,99.25904974070215
5106,C3_00720W_A,8135,C3,133119,135806,2687,338.5013702492193,422.370397661356
5108,C3_00730W_A,374,C3,137630,139981,2351,17.786459724366853,22.193334287650043
5110,C3_00740W_A,1,C3,138354,138815,461,0.24253231647074172,0.302623504531333
5112,C3_00750W_A,491,C3,140432,143014,2582,21.261592705448823,26.52948600858705
5114,C3_00760W_A,4119,C3,143568,144977,1409,326.8521447276907,407.8348936769783
5116,C3_00770C_A,1299,C3,145178,145921,743,195.47484503771537,243.90680596236732
5118,C3_00780W_A,570,C3,146262,147626,1364,46.723032843853964,58.299397570160096
5120,C3_00790W_A,279,C3,148259,150694,2435,12.810786041950857,15.98485935495504
5122,C3_00800W_A,1094,C3,155046,157730,2684,45.57276203239757,56.86412911114207
5124,C3_00810C_A,3251,C3,157966,160686,2720,133.63450387874335,166.74454966899214
5126,C3_00820W_A,671,C3,162847,165159,2312,32.44929238157916,40.489113875511144
5128,C3_00830C_A,718,C3,165325,167637,2312,34.72219363632464,43.3251620903383
5130,C3_00840C_A,388,C3,167936,168433,497,87.28625831486647,108.91279880988023
5132,C3_00850C_A,5586,C3,168880,171330,2450,254.92086719606723,318.0815131427935
5134,C3_00860W_A,521,C3,173043,173678,635,91.73488866497516,114.46364715250408
5136,C3_00870W_A,6,C3,174371,174697,326,2.0578048691965387,2.567658323722905
5138,C3_00880W_A,15645,C3,175316,178306,2990,585.0256655639372,729.974956451183
5140,C3_00890C_A,581,C3,178624,180774,2150,30.213999151553462,37.69999166380315
5142,C3_00900C_A,449,C3,181128,182009,881,56.98243093525808,71.10072256462666
5144,C3_00910W_A,269,C3,183121,185799,2678,11.230840191643097,14.013457122265152
5146,C3_00920W_A,149,C3,187453,188250,797,20.90251227861829,26.081437770078708
5148,C3_00930W_A,1712,C3,189352,190149,797,240.16846322815115,299.6739695461393
5150,C3_00940W_A,1404,C3,191169,192854,1685,93.16177248770848,116.24406383790983
5152,C3_00950C_A,178,C3,193060,194184,1124,17.706153758857763,22.09313125874744
5154,C3_00960W_A,216,C3,194324,195466,1142,21.147458795876165,26.387073631534165
5156,C3_00970W_A,1,C3,196070,196140,70,1.597248541328742,1.9929919369849218
5158,C3_00980W_A,1970,C3,198697,201123,2426,90.79166275730978,113.2867222218552
5160,C3_00990C_A,109,C3,201335,202591,1256,9.703030549632405,12.107108661779419
5162,C3_01000W_A,3452,C3,202840,206472,3632,106.26628235866663,132.5954217106378
5164,C3_01010W_A,7,C3,206574,206882,308,2.5410772248411804,3.1706689906578296
5166,C3_01020W_A,715,C3,209718,211511,1793,44.58577216592501,55.632597013996275
5168,C3_01030W_A,319,C3,211924,213378,1454,24.529958684918032,30.607640957959628
5170,C3_01040C_A,36,C3,213598,215352,1754,2.2947926591496186,2.86336355826796
5172,C3_01050C_A,1,C3,214825,215352,527,0.2121582502713699,0.2647237866962894
5174,C3_01060W_A,106,C3,216483,216692,209,56.7061443859295,70.75598168625893
5176,C3_01070C_A,77,C3,216964,219954,2990,2.8793209490842537,3.592717906471146
5178,C3_01080W_A,320,C3,220263,220553,290,123.37368043366835,153.9414461671112
5180,C3_01090W_A,82,C3,221731,221955,224,40.92949387154901,51.07041838523861
5182,C3_01100W_A,119,C3,222887,223546,659,20.189803261408837,25.192143907563576
5184,C3_01110C_A,42,C3,223626,225776,2150,2.1841445169797686,2.7253006022026365
5186,C3_01120W_A,97,C3,226014,227075,1061,10.221788497287614,12.754397033108026
5188,C3_01130C_A,3385,C3,227408,230062,2654,142.6028793774851,177.93498096027773
5190,C3_01140W_A,464,C3,231342,232058,716,72.45619081334853,90.40834932020985
5192,C3_01150C_A,357,C3,232663,233589,926,43.10501193067524,53.784955189258305
5194,C3_01160W_A,2664,C3,236495,238651,2156,138.15162708116134,172.3808610431114
5196,C3_01170W_A,554,C3,239217,240671,1454,42.600617904215014,53.155589626049014
5198,C3_01180C_A,942,C3,240894,244154,3260,32.30753644638566,40.31223568244961
5200,C3_01190C_A,410,C3,248165,249589,1424,32.191736752903715,40.16774479737868
5202,C3_01200W_A,878,C3,249962,257464,7502,13.085429932026726,16.327550579457913
5204,C3_01210C_A,665,C3,257541,258550,1009,73.68872110887308,91.94625834157394
5206,C3_01220W_A,96,C3,259791,260798,1007,10.658897912342749,13.299807166374055
5208,C3_01230C_A,104,C3,260834,261466,632,18.398685729229815,22.957248894383277
5210,C3_01240C_A,11,C3,261805,261893,88,13.975924736626494,17.438679448618064
5212,C3_01250W_A,6849,C3,264875,268510,3635,210.66543828589792,262.8611071110539
5214,C3_01260C_A,499,C3,269315,271492,2177,25.627878524856666,31.977587670594083
5216,C3_01270W_A,41,C3,273811,274278,467,9.816067052705545,12.248151732648232
5218,C3_01280W_A,261,C3,274498,275166,668,43.68522582346724,54.50892618071036
5220,C3_01290W_A,12,C3,275345,275761,416,3.22521340075996,4.024310641988785
5222,C3_01300C_A,907,C3,275604,276449,845,120.01101762007319,149.74563086292625
5224,C3_01310W_A,653,C3,277446,280040,2594,28.145809878233155,35.119376036846866
5226,C3_01320C_A,929,C3,280383,282077,1694,61.31586342538849,76.50783096937984
5228,C3_01330W_A,534,C3,285386,288133,2747,21.734674362893475,27.119781071895293
5230,C3_01340W_A,77,C3,288691,290076,1385,6.216006958672866,7.756120245739154
5232,C3_01350C_A,888,C3,290231,291043,812,122.27212971551059,152.56696896919055
5234,C3_01360C_A,714,C3,291479,293269,1790,44.59803469028522,55.64789777123261
5236,C3_01370C_A,12,C3,294348,295271,923,1.4536173073847707,1.8137738104738181
5238,C3_01390C_A,917,C3,296783,300166,3383,30.306646132986096,37.8155933890222
5240,C3_01400W_A,296,C3,301408,302595,1187,27.881204529344178,34.7892105596694
5242,C3_01410C_A,321,C3,302676,303515,839,42.777323866098726,53.376077263469824
5244,C3_01420C_A,995,C3,304687,305070,383,290.4656942651355,362.43312901044334
5246,C3_01430W_A,105,C3,306714,307373,659,17.814532289478382,22.228362271379623
5248,C3_01440C_A,28,C3,307532,307839,307,10.197417397408255,12.723987610718066
5250,C3_01450C_A,223,C3,307886,311137,3251,7.669347809948221,9.569549103763343
5252,C3_01460C_A,1908,C3,311442,312674,1232,173.15626232132047,216.05844407768353
5254,C3_01470W_A,427,C3,315066,315707,641,74.4801230894167,92.9337425842111
5256,C3_01480C_A,341,C3,315941,316663,722,52.80654111013445,65.89019049283945
5258,C3_01490W_A,2859,C3,317330,317890,560,570.8166974573592,712.2454934799864
5260,C3_01500C_A,951,C3,318169,320031,1862,57.104637699384725,71.25320797265641
5262,C3_01510W_A,1322,C3,320814,322712,1898,77.87638567679757,97.17148253350088
5264,C3_01520C_A,1009,C3,322839,323900,1061,106.32767622436292,132.67202687016496
5266,C3_01530C_A,2934,C3,324169,332661,8492,38.62964029888095,48.200739992694686
5268,C3_01540W_A,4007,C3,335765,336352,587,763.2235832321958,952.3242051190812
5270,C3_01550C_A,9114,C3,336811,338214,1403,726.3097821788389,906.2644304758662
5272,C3_01560W_A,1737,C3,342573,344876,2303,84.32889715161171,105.22270500130116
5274,C3_01570W_A,252,C3,345322,347031,1709,16.486520929806325,20.571315253606794
5276,C3_01580W_A,223,C3,347678,349027,1349,18.48261655310724,23.061974897208767
5278,C3_01590W_A,321,C3,349149,350831,1682,21.337797100866133,26.62457123903162
5280,C3_01600W_A,896,C3,351734,352816,1082,92.58727219236478,115.52722207735147
5282,C3_01610W_A,4050,C3,353503,354663,1160,390.36203574715375,487.08035701312525
5284,C3_01620W_A,181,C3,354930,355490,560,36.13774824756279,45.09144257428385
5286,C3_01630W_A,2499,C3,355874,357804,1930,144.7703043184647,180.63941944910482
5288,C3_01640C_A,62,C3,358102,359031,929,7.461850020846868,9.31064048064
5290,C3_01660W_A,325,C3,360108,360458,350,103.82115518636823,129.5444759040199
5292,C3_01670W_A,717,C3,360537,361334,797,100.5845725085189,125.50597906809689
5294,C3_01680C_A,363,C3,362632,363738,1106,36.6962797786287,45.78835905857763
5296,C3_01690W_A,788,C3,365248,366450,1202,73.29802790323912,91.45876476213667
5298,C3_01700W_A,749,C3,367274,369532,2258,37.08757352606995,46.27660197348071
5300,C3_01710C_A,199,C3,369832,371523,1691,13.157700875641265,16.417727783678274
5302,C3_01720C_A,2752,C3,372130,375795,3665,83.9546954983817,104.75578901521838
5304,C3_01730C_A,1927,C3,376289,377701,1412,152.58700831433006,190.3928345466686
5306,C3_01740C_A,5,C3,379671,380057,386,1.4482823561270977,1.8071170413075712
5308,C3_01750C_A,543,C3,381920,384757,2837,21.39986501794342,26.702017456748987
5310,C3_01760W_A,3276,C3,385547,387934,2387,153.44827628718355,191.46749517778898
5312,C3_01770C_A,292,C3,388103,389974,1871,17.449364075232225,21.772717900572847
5314,C3_01780C_A,274,C3,390197,390463,266,115.17002640107246,143.70520808786014
5316,C3_01790C_A,708,C3,390676,394428,3752,21.09798446381995,26.32534125718889
5318,C3_01800C_A,520,C3,395037,396632,1595,36.45131467358384,45.48270000391921
5320,C3_01810C_A,3169,C3,399010,400305,1295,273.604358241664,341.3941323408225
5322,C3_01820W_A,215,C3,402434,405034,2600,9.245611748845219,11.53635717370118
5324,C3_01830C_A,845,C3,405200,406585,1385,68.21462181920222,85.11586503441019
5326,C3_01840C_A,1,C3,407931,408004,73,1.531608190315232,1.9110881587526645
5328,C3_01850W_A,1107,C3,408919,409974,1055,117.31828385551113,146.38573004451334
5330,C3_01860C_A,2318,C3,410208,411830,1622,159.7839385425411,199.37291719801073
5332,C3_01870C_A,1,C3,412026,412100,74,1.5109107823379992,1.8852626430938448
5334,C3_01880W_A,212,C3,412494,414257,1763,13.444792032511929,16.77595028068987
5336,C3_01890C_A,3214,C3,414635,416522,1887,190.43400997781683,237.61702489818106
5338,C3_01900C_A,450,C3,418351,420147,1796,28.014103035554218,34.95503675669545
5340,C3_01910C_A,243,C3,422590,422757,167,162.68980651498148,202.99875956954202
5342,C3_01920C_A,3,C3,423654,423768,114,2.942299944552946,3.6713009365511713
5344,C3_01930W_A,199,C3,425210,427384,2174,10.234439825533293,12.77018292649492
5346,C3_01940C_A,423,C3,427510,428097,587,80.56989660774114,100.53235307346428
5348,C3_01950C_A,142,C3,428436,429026,590,26.909577120013044,33.57684720954258
5350,C3_01960C_A,3646,C3,429483,431612,2129,191.47476407605524,238.9156421593667
5352,C3_01970C_A,37,C3,433673,434200,527,7.8498552600406875,9.794780107762707
5354,C3_01980C_A,980,C3,435718,435888,170,644.5367643244218,804.2308639833273
5356,C3_01990W_A,1857,C3,436119,437363,1244,166.90220087405402,208.25484074651925
5358,C3_02000W_A,1411,C3,437485,441483,3998,39.45978950151073,49.23657168984509
5360,C3_02010C_A,64,C3,441503,442610,1107,6.464023003751367,8.065586158710433
5362,C3_02020W_A,1344,C3,442844,445369,2525,59.51253178938934,74.25769561645205
5364,C3_02030W_A,1353,C3,445556,446539,983,153.89156597074788,192.02061683808944
5366,C3_02040C_A,891,C3,446602,447222,620,160.678050843022,200.48855985443475
5368,C3_02050C_A,1,C3,447502,447595,93,1.202230084871096,1.50010145794564
5370,C3_02060W_A,159,C3,448127,449398,1271,13.986920743500315,17.4523998887822
5372,C3_02070C_A,41,C3,449448,450614,1166,3.931477970508996,4.905563344036643
5374,C3_02080W_A,562,C3,451391,453976,2585,24.307836601884997,30.330484642548093
5376,C3_02090C_A,292,C3,453985,454926,941,34.69475046201859,43.290919438864826
5378,C3_02100W_A,555,C3,456047,457429,1382,44.90094488467556,56.02585872059638
5380,C3_02110W_A,10943,C3,457757,458254,497,2461.7874348958344,3071.7339107642247
5382,C3_02120W_A,794,C3,459265,460465,1200,73.9792282725429,92.30874321468495
5384,C3_02130W_A,978,C3,460854,463085,2231,49.0128351140142,61.15653429224013
5386,C3_02140C_A,2291,C3,463157,464374,1217,210.47719685529202,262.62622591148056
5388,C3_02150C_A,25456,C3,464995,466125,1130,2518.7337351898336,3142.789550754134
5390,C3_02160C_A,1740,C3,467068,469592,2524,77.07800013226655,96.1752844392882
5392,C3_02170C_A,2973,C3,470417,471970,1553,214.0395324764485,267.07118609525565
5394,C3_02180C_A,707,C3,472269,473408,1139,69.40108016712857,86.59628706003842
5396,C3_02190C_A,1102,C3,473862,474284,422,291.970977436254,364.3113697133101
5398,C3_02200W_A,32,C3,474569,474745,176,20.328617798729443,25.365351925262637
5400,C3_02210C_A,438,C3,474790,477275,2485,19.70689749583068,24.589590659137905
5402,C3_02220W_A,1531,C3,478901,480400,1499,114.19421359186212,142.48762233934227
5404,C3_02230C_A,1230,C3,480639,484418,3779,36.391399684679726,45.407940136121134
5406,C3_02240C_A,618,C3,484858,486369,1511,45.72929973387253,57.059451485087834
5408,C3_02250C_A,3,C3,488396,488884,488,0.6873405608176963,0.8576399728828557
5410,C3_02260C_A,1425,C3,489073,490833,1760,90.52587613496706,112.95508279218518
5412,C3_02270W_A,116,C3,492474,492698,224,57.9002596231669,72.24595771570341
5414,C3_02280C_A,4488,C3,493362,495503,2141,234.3725370125351,292.44201164090754
5416,C3_02290W_A,649,C3,497382,498554,1172,61.91382357727368,77.25394513415101
5418,C3_02300W_A,677,C3,499465,502809,3344,22.635648437072096,28.243985614149352
5420,C3_02310W_A,899,C3,504690,506297,1607,62.54813360660718,78.04541542903615
5422,C3_02320W_A,2753,C3,507101,509152,2051,150.07594656239,187.25961783342967
5424,C3_02330C_A,14,C3,509669,510601,932,1.6795102687791492,2.095635298546377
5426,C3_02340W_A,104,C3,511298,512449,1151,10.102492946023668,12.60554413662053
5428,C3_02350W_A,1985,C3,512751,514754,2003,110.80263845113764,138.25573122518963
5430,C3_02360C_A,80,C3,514904,516670,1766,5.064887786772908,6.319793231662265
5432,C3_02370C_A,1293,C3,517634,520423,2789,51.83469540181587,64.67755475672472
5434,C3_02390W_A,223,C3,524126,525751,1625,15.343415218548717,19.144987160821305
5436,C3_02400C_A,192,C3,526430,526759,329,65.249302113855,81.41584083002235
5438,C3_02410C_A,484,C3,527091,528625,1534,35.27691041735188,44.017318660397095
5440,C3_02420C_A,72,C3,529159,531802,2643,3.045831497652993,3.8004840569065474
5442,C3_02430W_A,734,C3,532621,534945,2324,35.312663534195686,44.06193017310038
5444,C3_02440C_A,173,C3,535056,535970,914,21.162669404257187,26.40605290687899
5446,C3_02450W_A,373,C3,536423,536868,445,93.71721216650215,116.93712241500292
5448,C3_02460C_A,143,C3,537128,538135,1007,15.877316681927217,19.811171091578018
5450,C3_02470C_A,4085,C3,538836,539411,575,794.3186441616588,991.1235554449363
5452,C3_02480C_A,2514,C3,539890,540990,1100,255.53072573002913,318.84247370055135
5454,C3_02490C_A,1724,C3,542174,546082,3908,49.323427320253984,61.544080592461704
5456,C3_02500W_A,491,C3,547221,547778,557,98.55912453405541,122.97869456763331
5458,C3_02510C_A,102,C3,548135,549352,1217,9.370874761780788,11.692656064151471
5460,C3_02520W_A,1,C3,550994,551065,71,1.5747520830001682,1.964921628013303
5462,C3_02530W_A,108,C3,551544,551732,188,64.22978176832602,80.14371831705323
5464,C3_02540C_A,459,C3,552298,553335,1037,49.48852037887414,61.75007804756561
5466,C3_02550C_A,119,C3,553678,554376,698,19.061719698092297,23.784559935650996
5468,C3_02560W_A,238,C3,554571,556037,1466,18.151542086314354,22.64887153490368
5470,C3_02570W_A,1385,C3,556571,558802,2231,69.40979205818984,86.60715745884723
5472,C3_02580C_A,96,C3,558799,559533,734,14.623310896088755,18.246465690107186
5474,C3_02590W_A,1280,C3,559817,563116,3299,43.38086368689157,54.129153547695964
5476,C3_02600C_A,198,C3,563328,564209,881,25.12810985563719,31.353993469479015
5478,C3_02610C_A,1765,C3,565145,565855,710,277.94374264952967,346.80866734434795
5480,C3_02620C_A,31,C3,567608,567961,353,9.818779984938727,12.25153683642289
5482,C3_02630C_A,1296,C3,568695,569963,1268,114.27633096951378,142.5900855861767
5484,C3_02640C_A,2040,C3,570176,572692,2516,90.65464694027996,113.11575858563069
5486,C3_02650W_A,18,C3,572852,573178,326,6.173414607589618,7.702974971168715
5488,C3_02660W_A,36,C3,576543,577301,758,5.310113884100832,6.625777943538262
5490,C3_02670W_A,253,C3,577678,578433,755,37.46658498931394,46.74951947550062
5492,C3_02680C_A,4176,C3,578561,580315,1754,266.19594846135567,332.1501727590834
5494,C3_02690C_A,529,C3,580798,582558,1760,33.605746298524615,41.932097401449795
5496,C3_02700W_A,410,C3,583141,586854,3713,12.346090260203312,15.40502789966799
5498,C3_02710W_A,3582,C3,588383,589213,830,482.5230111479142,602.0756605778304
5500,C3_02720W_A,323,C3,590432,591784,1352,26.711382780653008,33.329547111855824
5502,C3_02730C_A,2,C3,591928,592015,87,2.570285009034757,3.207113461814816
5504,C3_02740C_A,1,C3,592024,592096,72,1.5528805262918324,1.9376310498464517
5506,C3_02750W_A,31,C3,593790,595292,1502,2.307609410574814,2.8793558610234884
5508,C3_02760C_A,1855,C3,595659,599300,3641,56.96312087106212,71.07662812894591
5510,C3_02770C_A,527,C3,599619,600962,1343,43.87378904662494,54.74420890199089
5512,C3_02780W_A,5566,C3,601266,602642,1376,452.26742490734335,564.3237779709775
5514,C3_02790W_A,204,C3,603064,603378,314,72.63920117889948,90.63670337625695
5516,C3_02800W_A,21,C3,604119,604895,776,3.0257156646304786,3.77538421052556
5518,C3_02810C_A,2303,C3,605101,607257,2156,119.4306295675355,149.02144256091802
5520,C3_02820C_A,603,C3,609991,610995,1004,67.15125590586275,83.78903352602941
5522,C3_02830W_A,667,C3,612045,615218,3173,23.5031624313391,29.32643981652253
5524,C3_02840W_A,127,C3,615473,616045,572,24.824369811909992,30.974997062580336
5526,C3_02850C_A,270,C3,616015,617427,1412,21.379601580108517,26.676733434146616
5528,C3_02860W_A,359,C3,618110,619654,1544,25.996668292481402,32.437750891470905
5530,C3_02870C_A,454,C3,619691,621118,1427,35.5715197220935,44.384922044415426
5532,C3_02880W_A,3,C3,621776,622186,410,0.8181029114122825,1.0208007482117891
5534,C3_02890C_A,1,C3,622287,622697,410,0.2727009704707608,0.34026691607059634
5536,C3_02900W_A,1,C3,622956,624053,1097,0.10192105550867087,0.12717359670824477
5538,C3_02910W_A,9,C3,624195,624851,656,1.53394295889803,1.9140014028971046
5540,C3_02920W_A,1058,C3,625101,625490,389,304.0931284596572,379.43697391543265
5542,C3_02930W_A,81,C3,625968,626501,533,16.991368160101253,21.20124630901408
5544,C3_02940C_A,1819,C3,626532,627116,584,348.24941227292595,434.5336700963871
5546,C3_02950C_A,2418,C3,628092,629936,1844,146.61078530656337,182.9359084891908
5548,C3_02960C_A,1232,C3,630423,634766,4343,31.716950081554387,39.57532227620991
5550,C3_02970C_A,767,C3,634951,635871,920,93.21334150428278,116.3084098877396
5552,C3_02980C_A,7,C3,636147,636803,656,1.1930667458095785,1.488667757808859
5554,C3_02990C_A,1,C3,636945,638042,1097,0.10192105550867087,0.12717359670824477
5556,C3_03000W_A,1,C3,638299,638709,410,0.2727009704707608,0.34026691607059634
5558,C3_03010C_A,243,C3,638810,639382,572,47.49859735664669,59.26712036383481
5560,C3_03020W_A,28,C3,639381,639884,503,6.22387105567462,7.76593279620367
5562,C3_03030C_A,503,C3,639619,641031,1412,39.82940590664661,49.69776636065091
5564,C3_03040W_A,3172,C3,641788,643371,1583,224.0385761949677,279.5476498345748
5566,C3_03050C_A,682,C3,644041,646302,2261,33.72518591907746,42.08113006265376
5568,C3_03060W_A,149,C3,651582,652064,482,34.562867813399954,43.12636079409281
5570,C3_03070W_A,474,C3,652782,654299,1517,34.93520540625423,43.59095086958451
5572,C3_03080W_A,242,C3,654514,655764,1250,21.645912232087113,27.009026730019656
5574,C3_03090W_A,276,C3,656093,657952,1859,16.59969974097434,20.71253589163458
5576,C3_03100C_A,620,C3,658005,659477,1472,47.09278987341536,58.7607677073
5578,C3_03110W_A,593,C3,660875,662410,1535,43.193346547593535,53.89517609397009
5580,C3_03120C_A,55,C3,663210,664787,1577,3.8994336614557112,4.865579554465407
5582,C3_03130C_A,1,C3,665661,667181,1520,0.07355749861382364,0.09178252341377928
5584,C3_03140C_A,36,C3,667510,669222,1712,2.3510901426100648,2.9336096268703282
5586,C3_03150W_A,1209,C3,670712,673711,2999,45.073405819490304,56.24104955886426
5588,C3_03160C_A,144,C3,673704,674318,614,26.221930450478375,32.7188252847036
5590,C3_03170W_A,1504,C3,674583,675479,896,187.67670360612718,234.1765525957283
5592,C3_03180C_A,568,C3,675607,676530,923,68.80455254954582,85.85196036242738
5594,C3_03190C_A,744,C3,676936,678345,1409,59.03811499815535,73.66573461900263
5596,C3_03200C_A,121,C3,678753,678989,236,57.324979428196805,71.52814282314529
5598,C3_03210W_A,493,C3,680030,681031,1001,55.06598118007482,68.7094423030466
5600,C3_03220C_A,1,C3,681177,681266,89,1.2562628976742913,1.567521748190388
5602,C3_03230C_A,266,C3,681408,683057,1649,18.035638471522848,22.50425098038765
5604,C3_03240C_A,2,C3,684502,684936,434,0.5152414649447554,0.6429006248338456
5606,C3_03250W_A,972,C3,685105,689544,4439,24.482268698357203,30.548135028712338
5608,C3_03260W_A,1584,C3,689950,692745,2795,63.36419258051196,79.06366582214243
5610,C3_03270W_A,282,C3,693052,693507,455,69.29601363918542,86.46518865073044
5612,C3_03280C_A,650,C3,693795,694196,401,181.23393673430863,226.13748910926168
5614,C3_03290C_A,477,C3,694449,696431,1982,26.908238544382797,33.57517698079038
5616,C3_03300C_A,1276,C3,696906,698273,1367,104.36447674578147,130.2224139074566
5618,C3_03310C_A,173,C3,698460,699125,665,29.086736594723412,36.29343211562014
5620,C3_03320W_A,304,C3,699327,699560,233,145.87746334538897,182.02089450231387
5622,C3_03330C_A,866,C3,699627,701732,2105,45.997722838645295,57.39438062709072
5624,C3_03340C_A,524,C3,702202,702486,284,206.29252287302205,257.4047332697427
5626,C3_03350W_A,6,C3,703089,703182,93,7.213380509226577,9.000608747673839
5628,C3_03360W_A,522,C3,704145,705725,1580,36.938899810222935,46.09109201103103
5630,C3_03370C_A,1313,C3,708490,709062,572,256.64879970895925,320.2375680564408
5632,C3_03380W_A,117,C3,714210,716651,2441,5.359060038296763,6.686851275668377
5634,C3_03390C_A,454,C3,716811,717320,509,99.72604841537805,124.43474215595444
5636,C3_03400C_A,301,C3,717691,718467,776,43.36859119303685,54.11384035086636
5638,C3_03410C_A,6271,C3,718781,721924,3143,223.0811938234419,278.35306095395197
5640,C3_03420C_A,2635,C3,722858,724582,1724,170.88891731327521,213.22932875688446
5642,C3_03430C_A,110,C3,725582,726181,599,20.532243352639924,25.61942890615008
5644,C3_03440C_A,736,C3,726384,728315,1931,42.61535207108068,53.1739744140151
5646,C3_03450C_A,263,C3,728899,730854,1955,15.041097517065033,18.767765503781284
5648,C3_03460C_A,1952,C3,733522,734337,815,267.78900697810957,334.1379365271407
5650,C3_03470W_A,318,C3,737492,738967,1475,24.104916969476474,30.077288486294478
5652,C3_03480C_A,2121,C3,739106,740668,1562,151.82041672924348,189.43630786437342
5654,C3_03490W_A,691,C3,743259,744101,842,91.75642748702049,114.49052255577276
5656,C3_03500W_A,2926,C3,745852,748008,2156,151.73861142623053,189.33423401356754
5658,C3_03510C_A,433,C3,748403,750508,2105,22.998861419322647,28.69719031354536
5660,C3_03520C_A,1027,C3,750831,751586,755,152.08767898824274,189.7697885428424
5662,C3_03530W_A,82,C3,752036,752503,467,19.63213410541109,24.496303465296464
5664,C3_03540W_A,456,C3,752749,754380,1631,31.259456431154785,39.00447739335297
5666,C3_03550C_A,317,C3,754424,755479,1055,33.59520865600454,41.91894889260229
5668,C3_03560W_A,578,C3,755825,757297,1472,43.90263314005497,54.780199572289355
5670,C3_03570C_A,30,C3,757464,758735,1271,2.6390416497170404,3.2929056393928677
5672,C3_03580C_A,27,C3,759278,760178,900,3.3542219367903585,4.185283067668335
5674,C3_03590W_A,901,C3,761498,762349,851,118.376575207525,147.7062296893525
5676,C3_03600C_A,25,C3,762417,763243,826,3.384001146882928,4.22244054445958
5678,C3_03610W_A,76,C3,763787,765499,1712,4.963412523287913,6.1931758789484705
5680,C3_03620C_A,1,C3,765496,765804,308,0.3630110321201686,0.4529527129511185
5682,C3_03630W_A,1,C3,765830,767350,1520,0.07355749861382364,0.09178252341377928
5684,C3_03640W_A,179,C3,768366,769943,1577,12.690884098192225,15.83524982271469
5686,C3_03650W_A,1432,C3,770431,771831,1400,114.36299555913793,142.69822268812038
5688,C3_03660W_A,2402,C3,772084,774000,1916,140.16772950888034,174.89648449094193
5690,C3_03670W_A,489,C3,774527,776536,2009,27.214443787796338,33.957249379290126
5692,C3_03680W_A,1155,C3,777344,779113,1769,73.00030783856913,91.08727987859294
5694,C3_03690W_A,272,C3,779861,780721,860,35.36233979872006,44.12391451185222
5696,C3_03700C_A,6,C3,781934,782260,326,2.0578048691965387,2.567658323722905
5698,C3_03710W_A,1114,C3,782645,783583,938,132.78618470449393,165.68604610456734
5700,C3_03720W_A,1030,C3,784714,785540,826,139.42084725157665,173.9645504317347
5702,C3_03730C_A,767,C3,785608,786459,851,100.77118000463003,125.73882150025904
5704,C3_03740W_A,126,C3,787084,787413,329,42.81985451221734,53.42914554470215
5706,C3_03750C_A,1564,C3,787516,789564,2048,85.38416518782749,106.53943225640099
5708,C3_03760W_A,1003,C3,791640,793373,1733,64.7102250933012,80.74319901656743
5710,C3_03770C_A,383,C3,793475,794341,866,49.448306458456784,61.69990049718909
5712,C3_03780W_A,1,C3,793920,794360,440,0.25410772248411806,0.317066899065783
5714,C3_03790W_A,1573,C3,794780,795814,1034,170.0899776457522,212.23243924701134
5716,C3_03800W_A,5171,C3,797737,799467,1730,334.1942511588236,416.9961222141226
5718,C3_03810W_A,745,C3,799968,802067,2099,39.68390253944445,49.516212250482916
5720,C3_03820C_A,640,C3,802124,803323,1199,59.680345831132314,74.46708822095454
5722,C3_03830W_A,312,C3,803446,804522,1076,32.41998898012986,40.45255009642257
5724,C3_03840C_A,677,C3,804528,805997,1469,51.52730318146296,64.29400128911874
5726,C3_03850C_A,567,C3,806218,806934,716,88.5402159292427,110.47744410465299
5728,C3_03860W_A,156,C3,807802,808329,527,33.09668704233371,41.29691072462114
5730,C3_03870C_A,11313,C3,808654,810288,1634,774.0985877378483,965.8936626791489
5732,C3_03880C_A,641,C3,811840,812883,1043,68.71384664373986,85.73878064478757
5734,C3_03890W_A,1917,C3,813612,817613,4001,53.57030286450985,66.8431862094493
5736,C3_03900C_A,2094,C3,817866,818258,392,597.2568652754261,745.2366278654331
5738,C3_03910W_A,756,C3,818804,819202,398,212.37787137466592,264.99782237498005
5740,C3_03920W_A,267,C3,819467,819682,215,138.8491871508567,173.25125256859621
5742,C3_03930W_A,512,C3,819740,820771,1031,55.52413939982746,69.28111641274451
5744,C3_03940C_A,1,C3,822151,822279,128,0.8734952960391558,1.089917465538629
5746,C3_03970W_A,2,C3,826066,826155,89,2.5125257953485827,3.135043496380776
5748,C3_03980C_A,150,C3,826496,828007,1511,11.099344595600128,13.849381428419376
5750,C3_03990C_A,455,C3,828580,830493,1913,26.592977543816225,33.181805119168715
5752,C3_04000C_A,1860,C3,832411,835089,2678,77.65562362994854,96.89602322458433
5754,C3_04010C_A,1,C3,835704,835800,96,1.1646603947188743,1.4532232873848385
5756,C3_04020C_A,527,C3,836183,839419,3236,18.208435936222898,22.719861729101904
5758,C3_04030C_A,313,C3,841090,843573,2483,14.094126274874242,17.58616727319357
5760,C3_04040W_A,3,C3,844399,845358,959,0.34976245430556396,0.43642159204049374
5762,C3_04050W_A,1,C3,845662,845734,72,1.5528805262918324,1.9376310498464517
5764,C3_04060C_A,5462,C3,846209,847180,971,628.9310064795379,784.7585346929093
5766,C3_04070C_A,3224,C3,848680,853218,4538,79.43302133254087,99.11379910505887
5768,C3_04080W_A,3285,C3,854961,855487,526,698.2648328489435,871.2709047712599
5770,C3_04090W_A,4341,C3,856852,857700,848,572.3536724688265,714.1632781740661
5772,C3_04100W_A,40,C3,858695,859174,479,9.336734688351727,11.650057251686388
5774,C3_04110C_A,1072,C3,859230,861788,2558,46.85595408182518,58.465252131097934
5776,C3_04120C_A,215,C3,862452,863414,962,24.988139861743836,31.179343712705894
5778,C3_04130W_A,548,C3,863945,864979,1034,59.255758264381576,73.93730242044641
5780,C3_04140C_A,4055,C3,865042,865578,536,845.85634040329,1055.4305248380037
5782,C3_04150W_A,422,C3,865874,866186,312,151.22667279118923,188.6954545465852
5784,C3_04160W_A,225,C3,867053,868633,1580,15.921939573371954,19.866850004754756
5786,C3_04170W_A,45,C3,869575,869979,404,12.453794319766184,15.539417330451741
5788,C3_04180W_A,2248,C3,870556,871371,815,308.3963563969213,384.80639411527267
5790,C3_04190W_A,312,C3,872065,872355,290,120.28933842282666,150.0929100129334
5792,C3_04200W_A,748,C3,872655,873911,1256,66.5859344139912,83.08364476156885
5794,C3_04210W_A,39,C3,874795,875313,518,8.417931501597424,10.503606154379993
5796,C3_04220C_A,429,C3,875584,877221,1637,29.300778067258477,36.560505722454
5798,C3_04230W_A,460,C3,877509,880106,2597,19.80415981162322,24.71095124024431
5800,C3_04240C_A,18,C3,881322,881645,323,6.230752823759181,7.774519630343657
5802,C3_04250W_A,926,C3,883024,884100,1076,96.22086472948799,120.06109419643367
5804,C3_04260W_A,1259,C3,885203,886766,1563,90.06110937127451,112.37516276806214
5806,C3_04270C_A,277,C3,886986,887941,955,32.42999917943907,40.46504047972526
5808,C3_04290C_A,1042,C3,890865,892955,2090,55.74320985862126,69.55446501611492
5810,C3_04300C_A,2050,C3,893246,897658,4412,51.95040019960891,64.82192723421039
5812,C3_04310C_A,100,C3,898103,898993,890,12.562628976742916,15.675217481903877
5814,C3_04320W_A,367,C3,899511,900371,860,47.713157007831846,59.53484053621237
5816,C3_04330C_A,1453,C3,900521,900976,455,357.0464816231788,445.51035145216787
5818,C3_04340W_A,1801,C3,901780,903258,1478,136.24162625528723,169.99762753429573
5820,C3_04350C_A,384,C3,903462,904355,893,48.07843313652474,59.990619558963814
5822,C3_04360W_A,526,C3,905118,907424,2306,25.503335338995786,31.822186955674248
5824,C3_04370C_A,771,C3,907472,910834,3362,25.640542467433736,31.993389303710956
5826,C3_04380C_A,1167,C3,911155,911535,380,343.3664035293288,428.4408192955217
5828,C3_04390W_A,1348,C3,912024,912804,780,193.22611840997448,241.1009220178169
5830,C3_04400C_A,830,C3,913107,915428,2321,39.982826476174026,49.88919928428433
5832,C3_04410C_A,1310,C3,915591,918926,3335,43.918348197854776,54.79980828231403
5834,C3_04420W_A,1685,C3,919600,922284,2684,70.19205121077688,87.58323359440071
5836,C3_04430W_A,5428,C3,922611,923421,810,749.2475997077394,934.8854523170257
5838,C3_04440C_A,71,C3,923719,925423,1704,4.658641578875498,5.812893149539354
5840,C3_04450C_A,10,C3,925625,926464,839,1.3326269117164713,1.6628061452794338
5842,C3_04460W_A,968,C3,927344,930337,2993,36.16089581036938,45.120325309087306
5844,C3_04470W_A,2074,C3,931012,934305,3293,70.41862837233732,87.8659488039693
5846,C3_04480C_A,178,C3,934439,935401,962,20.68785532739722,25.81359619005418
5848,C3_04490W_A,879,C3,939148,940800,1652,59.490740162201874,74.23050477159941
5850,C3_04500C_A,14015,C3,941278,942286,1008,1554.5443268557167,1939.707083114144
5852,C3_04510W_A,385,C3,942851,943153,302,142.53592115499868,177.85143278723058
5854,C3_04520C_A,2036,C3,943416,945122,1706,133.43485469529443,166.4954342667591
5856,C3_04530C_A,519,C3,949762,951993,2231,26.009878756823486,32.45423445569798
5858,C3_04540C_A,584,C3,958062,960341,2279,28.65095233414611,35.74967546465274
5860,C3_04550C_A,2887,C3,960570,961817,1247,258.8516100377911,322.9861592183503
5862,C3_04560W_A,3351,C3,962464,965664,3200,117.08330948108845,146.09253708079783
5864,C3_04570C_A,102,C3,965801,967807,2006,5.68512192676332,7.093700114692094
5866,C3_04580C_A,442,C3,968946,970256,1310,37.72432814405442,47.071122542224025
5868,C3_04590W_A,1402,C3,973774,975360,1586,98.83604782219592,123.32422994684754
5870,C3_04600C_A,239,C3,975446,975751,305,87.61301015222902,109.320508543468
5872,C3_04610W_A,131,C3,976463,978352,1889,7.75371578823958,9.674820572870159
5874,C3_04620C_A,278,C3,978529,978939,410,75.81086979087151,94.5942026676258
5876,C3_04630W_A,468,C3,980490,981581,1091,47.961376914692565,59.84456082092212
5878,C3_04640W_A,754,C3,985016,988408,3392,24.85341332881221,31.01123656664628
5880,C3_04650W_A,152,C3,989048,990181,1133,14.999756822363473,18.716182003106415
5882,C3_04660C_A,77,C3,990298,991251,953,9.033756178134228,11.272011060177048
5884,C3_04670C_A,5332,C3,991751,992554,803,742.4122609782562,926.3565511335643
5886,C3_04680W_A,2808,C3,993011,993346,335,937.1796217420225,1169.3805824888243
5888,C3_04690C_A,368,C3,993464,994486,1022,40.2594152882861,50.234317315784324
5890,C3_04700W_A,463,C3,994723,995823,1100,47.060750204058664,58.72078970698301
5892,C3_04710W_A,57,C3,995983,996873,890,7.160698516743462,8.93487396468521
5894,C3_04720C_A,456,C3,996870,999467,2597,19.631949726304757,24.49607340337262
5896,C3_04730C_A,9,C3,1000090,1001517,1427,0.7051622852397391,0.8798773092505259
5898,C3_04740C_A,382,C3,1004284,1006173,1889,22.61007199318717,28.21207220485802
5900,C3_04750W_A,301,C3,1006868,1008700,1832,18.370101946395522,22.92158303071632
5902,C3_04760C_A,2566,C3,1008831,1014887,6056,47.374138539212126,59.11182492094313
5904,C3_04770C_A,474,C3,1015233,1017383,2150,24.649630977343097,30.756963939144047
5906,C3_04780C_A,427,C3,1018054,1019091,1037,46.03834030888727,57.4450617130948
5908,C3_04790W_A,287,C3,1019402,1020850,1448,22.160720438739247,27.6513867500187
5910,C3_04800C_A,593,C3,1020896,1022662,1766,37.54348071945418,46.84546732969654
5912,C3_04810C_A,10856,C3,1023134,1024411,1277,950.4942141946262,1185.9940742001422
5914,C3_04820C_A,2766,C3,1024767,1030286,5519,56.035380063792545,69.91902497536158
5916,C3_04830C_A,20279,C3,1030626,1036280,5654,401.01560344400235,500.37351331945626
5918,C3_04840C_A,278,C3,1037259,1038575,1316,23.6188880047548,29.470838217117457
5920,C3_04850C_A,1,C3,1038960,1039044,84,1.331040451107285,1.6608266141541013
5922,C3_04860W_A,4156,C3,1041331,1042668,1337,347.5479025006415,433.65835026750443
5924,C3_04870W_A,19,C3,1043577,1045197,1620,1.311321333313103,1.6362217754258925
5926,C3_04880W_A,3114,C3,1045564,1046421,857,406.26398720984736,506.92226653905857
5928,C3_04890W_A,2413,C3,1047887,1052386,4499,59.96693734515178,74.82468728075641
5930,C3_04900W_A,988,C3,1052736,1055264,2528,43.69687860692081,54.52346612416027
5932,C3_04910C_A,2663,C3,1056652,1057164,512,581.529493338068,725.6125526823422
5934,C3_04920C_A,712,C3,1059572,1060321,749,106.28420200243592,132.61778122740785
5936,C3_04930C_A,2106,C3,1060721,1062967,2246,104.83810327813141,130.81338884698002
5938,C3_04940W_A,500,C3,1064140,1065189,1049,53.29237268494373,66.49639446565514
5940,C3_04950W_A,4017,C3,1066127,1066672,545,824.0923253875761,1028.2741335060368
5942,C3_04960W_A,1579,C3,1067838,1068640,802,220.1295277719026,274.6700733104032
5944,C3_04970C_A,1153,C3,1068899,1072126,3227,39.94853727010931,49.84641438923242
5946,C3_04980W_A,7,C3,1072322,1072663,341,2.2951665256630016,2.86383005607804
5948,C3_04990W_A,1258,C3,1073082,1074314,1232,114.16696960179306,142.4536282231268
5950,C3_05000W_A,1741,C3,1075012,1075623,611,318.58703720414695,397.5219760398566
5952,C3_05010C_A,398,C3,1076055,1078643,2588,17.19449163887896,21.45469681777431
5954,C3_05020W_A,176,C3,1078882,1080726,1844,10.671421924712638,13.315434199378652
5956,C3_05030W_A,901,C3,1081001,1081912,911,110.58009385466934,137.97804771200768
5958,C3_05040C_A,471,C3,1082115,1084973,2858,18.42592176613318,22.99123308691143
5960,C3_05050W_A,423,C3,1087547,1088407,860,54.99363873109773,68.61917587688782
5962,C3_05060W_A,229,C3,1089895,1091235,1340,19.10738366977592,23.84153787303604
5964,C3_05070W_A,366,C3,1091284,1092609,1325,30.88415670101311,38.53619126456883
5966,C3_05080W_A,125,C3,1093188,1094402,1214,11.512293852245875,14.364645344825423
5968,C3_05090C_A,385,C3,1094445,1096175,1730,24.88199317272231,31.046897515458753
5970,C3_05100C_A,8387,C3,1096555,1097574,1019,920.2440099398344,1148.2489070505176
5972,C3_05110W_A,416,C3,1097924,1098925,1001,46.46541211138159,57.97794725774317
5974,C3_05120C_A,382,C3,1099004,1099615,611,69.90249753703857,87.2219384533172
5976,C3_05130C_A,96,C3,1099836,1100900,1064,10.087885524181528,12.587317496746874
5978,C3_05140C_A,660,C3,1101306,1102724,1418,52.040114675167764,64.93386987919844
5980,C3_05150W_A,2241,C3,1103435,1104862,1427,175.585409024695,219.089450003381
5982,C3_05160C_A,2963,C3,1104957,1107683,2726,121.52799704952105,151.6384657557016
5984,C3_05170W_A,1516,C3,1118725,1120065,1340,126.49254866104934,157.83306294988049
5986,C3_05180W_A,190,C3,1126468,1127022,554,38.34549747233261,47.84619632111816
5988,C3_05190C_A,2138,C3,1127463,1128809,1346,177.59600051653754,221.598197094475
5990,C3_05200W_A,6819,C3,1130252,1131056,804,948.2769231746872,1183.2274145286226
5992,C3_05210C_A,2168,C3,1131286,1143771,12485,19.415173298522216,24.22558721320238
5994,C3_05220W_A,30525,C3,1146045,1150550,4505,757.5850878322285,945.2886839850236
5996,C3_05230W_A,110,C3,1151651,1152847,1196,10.283289103872336,12.831135380254095
5998,C3_05240C_A,5926,C3,1153146,1153934,788,840.8256851700365,1049.1534458122908
6000,C3_05250C_A,624,C3,1154421,1156208,1787,39.04186697551173,48.71510229854581
6002,C3_05270C_A,682,C3,1158476,1160710,2234,34.13278664415136,42.5897202648434
6004,C3_05280C_A,505,C3,1161511,1162572,1061,53.216527743610776,66.40175774968613
6006,C3_05290C_A,172,C3,1163817,1166642,2825,6.8073884734860375,8.494025812849012
6008,C3_05300C_A,119,C3,1168301,1170169,1868,7.122634019950976,8.887378391372803
6010,C3_05310W_A,2358,C3,1171323,1174715,3392,77.72460030416337,96.98208995245612
6012,C3_05320W_A,851,C3,1178238,1181699,3461,27.491504075976067,34.30295570245356
6014,C3_05330C_A,21,C3,1181872,1182843,971,2.41807966606926,3.017196856197564
6016,C3_05340W_A,61,C3,1183239,1184501,1262,5.404319549503747,6.743324541145495
6018,C3_05350C_A,295,C3,1184605,1186257,1652,19.965606766609277,24.912399212311524
6020,C3_05360C_A,1294,C3,1186862,1190638,3776,38.315352985581946,47.80858306464359
6022,C3_05370C_A,12523,C3,1193027,1194203,1176,1190.6156835154666,1485.6094063608434
6024,C3_05380W_A,220,C3,1195336,1197177,1841,13.361014414156777,16.67141544245942
6026,C3_05390C_A,63,C3,1197250,1199196,1946,3.619663960565135,4.516492519066549
6028,C3_05400C_A,4,C3,1199156,1199485,329,1.3593604607053122,1.6961633506254654
6030,C3_05410W_A,1400,C3,1201743,1204085,2342,66.83619002998152,83.39590513429647
6032,C3_05420W_A,246,C3,1205701,1207458,1757,15.654308413022731,19.532909023836286
6034,C3_05430W_A,120,C3,1207783,1209570,1787,7.508051341444563,9.368288903566503
6036,C3_05440C_A,206,C3,1209706,1210995,1289,17.868366148922004,22.2955343144473
6038,C3_05450C_A,205,C3,1216080,1217252,1172,19.55675475091079,24.40224769260548
6040,C3_05460W_A,386,C3,1226660,1228948,2288,18.86261170747492,23.536119815267735
6042,C3_05470W_A,454,C3,1229344,1232046,2702,18.786291133762926,23.440889621532495
6044,C3_05480C_A,2,C3,1232492,1232565,73,3.063216380630464,3.822176317505329
6046,C3_05490C_A,1,C3,1232581,1232654,73,1.531608190315232,1.9110881587526645
6048,C3_05500W_A,20,C3,1233522,1233619,97,23.053071730517928,28.764832080194743
6050,C3_05510W_A,299,C3,1233917,1236124,2207,15.147445387408506,18.90046272818052
6052,C3_05520C_A,2169,C3,1236311,1238911,2600,93.27317154997804,116.38306376631564
6054,C3_05530W_A,609,C3,1240041,1241453,1412,48.2228791195781,60.17085430146403
6056,C3_05540C_A,56,C3,1241446,1241769,323,19.384564340584113,24.1873944055136
6058,C3_05550C_A,231,C3,1241895,1242686,791,32.651717968755705,40.7416935790723
6060,C3_05560W_A,1072,C3,1243106,1243750,644,186.11417785917516,232.22688657041695
6062,C3_05570W_A,1273,C3,1245025,1246539,1514,94.00978699987068,117.30218725543352
6064,C3_05580C_A,1272,C3,1246780,1248546,1766,80.53171580968925,100.48471238343001
6066,C3_05590C_A,3137,C3,1250579,1251688,1109,316.2667332645433,394.6267803809909
6068,C3_05600W_A,111,C3,1252997,1253842,845,14.687125640383817,18.32609153890277
6070,C3_05610W_A,573,C3,1254541,1256598,2057,31.145181814630945,38.861889446993295
6072,C3_05620W_A,91,C3,1257308,1258150,842,12.083697396988228,15.077623086216091
6074,C3_05630W_A,3,C3,1258947,1259750,803,0.41771132463142696,0.5212058614779994
6076,C3_05640W_A,6,C3,1260221,1261498,1277,0.5253284160987249,0.6554867764554948
6078,C3_05650W_A,2312,C3,1263720,1265207,1487,173.83907459895335,216.91043381414912
6080,C3_05660C_A,7,C3,1266051,1267238,1187,0.6593528098155716,0.8227178172894791
6082,C3_05670C_A,68,C3,1269469,1269789,320,23.75907205226504,29.645755062650707
6084,C3_05680W_A,886,C3,1269788,1270519,731,135.5148488826383,169.09077966047172
6086,C3_05700W_A,4292,C3,1275033,1277288,2255,212.80592095645557,265.5319279590908
6088,C3_05710W_A,25211,C3,1279081,1279656,575,4902.219666575173,6116.821531535443
6090,C3_05720C_A,754,C3,1279891,1282809,2918,28.8906024713266,36.04870268473755
6092,C3_05730C_A,449,C3,1283574,1284857,1283,39.12823199841182,48.82286561140771
6094,C3_05740C_A,469,C3,1286414,1287718,1304,40.21293681888237,50.176323076085104
6096,C3_05750C_A,86,C3,1288112,1288444,332,28.96215728553924,36.13798632725671
6098,C3_05760W_A,1280,C3,1289599,1290645,1046,136.81976032796874,170.71900339756115
6100,C3_05770C_A,187,C3,1290741,1292264,1523,13.72815719369221,17.129523608097585
6102,C3_05780C_A,4414,C3,1292710,1294905,2195,224.83729125273564,280.5442590841007
6104,C3_05790C_A,98,C3,1298064,1298540,476,23.019170154443636,28.7225308565474
6106,C3_05800W_A,635,C3,1298785,1300203,1418,50.06889821019929,62.47425359589547
6108,C3_05810C_A,1126,C3,1300265,1302478,2213,56.88889743675168,70.98401467381451
6110,C3_05820W_A,14,C3,1305719,1305824,105,14.90765305240159,18.601258078525937
6112,C3_05830W_A,2821,C3,1306093,1308315,2222,141.9480960648905,177.1179648048661
6114,C3_05840W_A,59,C3,1309841,1311451,1610,4.097289736451991,5.11245757748306
6116,C3_05850W_A,148,C3,1312151,1313869,1718,9.631836372622683,12.018275009990564
6118,C3_05860C_A,223,C3,1313895,1314956,1061,23.49957561747565,29.32196431322774
6120,C3_05870C_A,791,C3,1315290,1317704,2414,36.63614404862157,45.713323757603604
6122,C3_05880C_A,1839,C3,1318841,1320373,1532,134.21266626974477,167.46596086688572
6124,C3_05890W_A,170,C3,1321857,1323116,1259,15.097106943456739,18.837652144654943
6126,C3_05900W_A,324,C3,1323692,1324687,995,36.407635092799865,45.428198121425154
6128,C3_05910W_A,628,C3,1325453,1328761,3308,21.225830071587517,26.484862620875802
6130,C3_05920W_A,1037,C3,1329263,1332589,3326,34.85997342605334,43.49707898548871
6132,C3_05930W_A,1848,C3,1333825,1336875,3050,67.74428567419216,84.52899572733426
6134,C3_05940C_A,92,C3,1336989,1337603,614,16.752900010027847,20.903693931893965
6136,C3_05950W_A,253,C3,1337786,1340074,2288,12.363318036246513,15.426524127623674
6138,C3_05960W_A,364,C3,1340442,1343162,2720,14.962460600388365,18.669645056755808
6140,C3_05970C_A,872,C3,1343332,1344948,1616,60.33171470464506,75.27984395641066
6142,C3_05980C_A,453,C3,1345603,1347867,2264,22.371356557214845,27.914211272876265
6144,C3_05990C_A,331,C3,1349838,1352354,2516,14.70916085158464,18.353586319531253
6146,C3_06000W_A,1377,C3,1362512,1364386,1874,82.15516910281615,102.5104017107666
6148,C3_06010W_A,2805,C3,1366624,1368091,1467,213.78306141097377,266.7511702978796
6150,C3_06020W_A,787,C3,1368673,1369779,1106,79.5591520269443,99.27118065867931
6152,C3_06030W_A,2198,C3,1370186,1372108,1922,127.86298676838724,159.5430486079605
6154,C3_06040W_A,182,C3,1373713,1375218,1505,13.520894628922376,16.870908489825847
6156,C3_06050C_A,745,C3,1375404,1376279,875,95.19601306319304,118.78231944430134
6158,C3_06060W_A,816,C3,1376548,1378191,1643,55.529419769140446,69.28770507643257
6160,C3_06070C_A,1398,C3,1378314,1379951,1637,95.48365440099614,119.14122843820674
6162,C3_06080W_A,1105,C3,1380538,1385430,4892,25.25494167452539,31.512249862179825
6164,C3_06090C_A,739,C3,1385507,1386664,1157,71.4137139524078,89.1075824548228
6166,C3_06100C_A,5621,C3,1387874,1389892,2018,311.4318055285531,388.59392341202033
6168,C3_06110C_A,1142,C3,1391037,1392815,1778,71.81330055895369,89.60617291483388
6170,C3_06120C_A,2505,C3,1393714,1395513,1799,155.68512046803497,194.25855261273261
6172,C3_06130W_A,2,C3,1395597,1395914,317,0.7054094504290974,0.880185713494918
6174,C3_06140W_A,116,C3,1397002,1398207,1205,10.76320178887086,13.429953965408767
6176,C3_06150W_A,819,C3,1399074,1402343,3269,28.011703540647535,34.95204274926447
6178,C3_06160C_A,1,C3,1402376,1403161,785,0.14242980623313622,0.17771902622795477
6180,C3_06170C_A,1,C3,1404228,1405019,791,0.14134942843617185,0.17637096787477183
6182,C3_06180C_A,1,C3,1405934,1406524,590,0.18950406422544397,0.23645667048973645
6184,C3_06190C_A,204,C3,1407764,1411864,4100,5.563099797603522,6.941445087840166
6186,C3_06200C_A,267,C3,1416009,1416827,818,36.49459075480952,45.536698413506336
6188,C3_06210C_A,1099,C3,1417168,1419369,2201,55.82750126507049,69.65964094150387
6190,C3_06220C_A,61,C3,1419828,1420880,1052,6.483128585051073,8.089425447647923
6192,C3_06230W_A,2359,C3,1421438,1424542,3104,84.97218158170594,106.02537324559282
6194,C3_06240C_A,314,C3,1424631,1424843,212,165.60152329436676,206.63189988173855
6196,C3_06250W_A,894,C3,1425217,1425864,647,154.49121130811852,192.76883371949984
6198,C3_06260C_A,319,C3,1425861,1427921,2060,17.313864042655737,21.60364560819092
6200,C3_06270C_A,172,C3,1428461,1429165,704,27.316580167042694,34.08469164957167
6202,C3_06280W_A,839,C3,1429597,1430595,998,93.994395623484,117.28298242397238
6204,C3_06290W_A,927,C3,1431324,1433579,2255,45.96250902298097,57.350442035898695
6206,C3_06300W_A,1595,C3,1434184,1438215,4031,44.240337295796095,55.2015752330356
6208,C3_06310C_A,725,C3,1438401,1441571,3170,25.57109257805478,31.906732114190778
6210,C3_06320W_A,361,C3,1446503,1451209,4706,8.576810590602914,10.701850031366122
6212,C3_06330W_A,1,C3,1452363,1452953,590,0.18950406422544397,0.23645667048973645
6214,C3_06340W_A,43,C3,1453205,1453747,542,8.870328615128255,11.068091753366447
6216,C3_06350W_A,21,C3,1453866,1454657,791,2.9683379971596096,3.7037903253702087
6218,C3_06360C_A,2333,C3,1454762,1455369,607,429.7309049166341,536.2034814316435
6220,C3_06370C_A,629,C3,1455629,1456801,1172,60.0058475040141,74.8732380421895
6222,C3_06380W_A,1,C3,1456914,1457699,785,0.14242980623313622,0.17771902622795477
6224,C3_06390W_A,1,C3,1457202,1457699,497,0.22496458328573832,0.2807030897161861
6226,C3_06400C_A,587,C3,1457924,1458991,1067,61.509786844609195,76.74980195942871
6228,C3_06410C_A,295,C3,1459414,1460436,1022,32.27317258164239,40.269357630859716
6230,C3_06420C_A,420,C3,1460652,1461866,1214,38.681307343546145,48.26520835861342
6232,C3_06430W_A,1537,C3,1462286,1463470,1184,145.14186702834405,181.10304265220248
6234,C3_06440W_A,4235,C3,1463534,1466824,3290,143.92228877717497,179.58129474747116
6236,C3_06450W_A,179,C3,1467909,1468994,1085,18.445644445022246,23.015842369051676
6238,C3_06460C_A,4,C3,1469508,1469605,97,4.610614346103585,5.752966416038949
6240,C3_06470W_A,2096,C3,1477198,1479036,1838,127.5017986853934,159.0923705083937
6242,C3_06480C_A,605,C3,1479207,1479679,472,143.312448570492,178.8203570578632
6244,C3_06490W_A,943,C3,1481888,1482811,923,114.2300934053199,142.5323919397342
6246,C3_06500W_A,5738,C3,1483052,1486117,3065,209.31512205876106,261.1762288448168
6248,C3_06510C_A,79,C3,1486242,1490213,3971,2.224322446121366,2.7754332438999287
6250,C3_06520C_A,197,C3,1490884,1491810,926,23.786239076591094,29.679653143652338
6252,C3_06530W_A,197,C3,1492058,1492954,896,24.58265333138767,30.673391530158554
6254,C3_06540C_A,32,C3,1492993,1493760,767,4.6647154270878515,5.820471888978129
6256,C3_06550C_A,275,C3,1493769,1494794,1025,29.997106751783694,37.4293607677656
6258,C3_06560W_A,644,C3,1496301,1497788,1487,48.42230278621364,60.41968831155364
6260,C3_06570C_A,80,C3,1498396,1499073,677,13.212100194152075,16.48560538717217
6262,C3_06580W_A,28,C3,1501918,1503543,1625,1.9265274713872826,2.4038548901479664
6264,C3_06590W_A,4389,C3,1504006,1505340,1334,367.8580729778331,459.0006842577792
6266,C3_06600C_A,213,C3,1505399,1507120,1721,13.837870860669115,17.2664205580739
6268,C3_06610W_A,540,C3,1508187,1509278,1091,55.34005028618373,69.05141633183321
6270,C3_06620W_A,709,C3,1510924,1514895,3971,19.962590054430994,24.908635062342398
6272,C3_06630W_A,181,C3,1515330,1517540,2210,9.157076479020436,11.425885901175999
6274,C3_06640W_A,178,C3,1517766,1518587,821,24.240824390933163,30.246869104545823
6276,C3_06650C_A,508,C3,1518671,1520230,1559,36.432429845830704,45.45913616368429
6278,C3_06660C_A,77,C3,1520428,1521507,1079,7.9788411842093785,9.95572431913691
6280,C3_06670C_A,218,C3,1523520,1524584,1064,22.907906711162223,28.583700148862693
6282,C3_06680C_A,854,C3,1525242,1526126,884,108.01302918623551,134.77495248072242
6284,C3_06690C_A,450,C3,1526530,1526895,365,137.8447371283709,171.9979342877398
6286,C3_06700C_A,5728,C3,1527476,1529317,1841,347.8722298376819,434.06303479276164
6288,C3_06710W_A,1260,C3,1533041,1535032,1991,70.7570674762406,88.28824150782023
6290,C3_06720W_A,1199,C3,1535326,1537980,2654,50.51133009559959,63.026304925073276
6292,C3_06730W_A,274,C3,1538299,1539096,797,38.43817694188868,47.96183858390313
6294,C3_06740W_A,663,C3,1539368,1541332,1964,37.74353605044141,47.09508950889522
6296,C3_06750W_A,230,C3,1541633,1541839,206,124.83350250190655,155.76296206532638
6298,C3_06760W_A,367,C3,1542502,1543329,827,49.61706774695935,61.91047504370331
6300,C3_06770W_A,411,C3,1543770,1544822,1052,43.68140735173756,54.504161622676996
6302,C3_06780C_A,331,C3,1544843,1546036,1193,31.02116404240315,38.70714432518076
6304,C3_06790W_A,225,C3,1548990,1550393,1403,17.930623325679036,22.37321668390058
6306,C3_06800C_A,204,C3,1550697,1551773,1076,21.1976851023926,26.44974429381476
6308,C3_06810W_A,340,C3,1552208,1554631,2423,15.689028181437914,19.576231159818878
6310,C3_06820C_A,923,C3,1554678,1556225,1547,66.70861554961216,83.23672207407613
6312,C3_06830C_A,1727,C3,1556453,1560565,4112,46.958019494462945,58.59260585167976
6314,C3_06840C_A,6,C3,1560848,1560943,95,7.06151986692707,8.81112224772281
6316,C3_06850W_A,2702,C3,1568451,1570004,1553,194.52903355242643,242.72665483665685
6318,C3_06860C_A,1274,C3,1572462,1573310,848,167.97479353266183,209.59318507112653
6320,C3_06870W_A,35142,C3,1574865,1575872,1007,3901.822817036967,4868.560660840802
6322,C3_06880W_A,25,C3,1576153,1576956,803,3.4809277052618914,4.343382178983329
6324,C3_06890W_A,3400,C3,1577290,1579599,2309,164.6362723413775,205.4274928550937
6326,C3_06900W_A,129,C3,1580008,1580706,698,20.663544882805933,25.783262451251925
6328,C3_06910C_A,513,C3,1580822,1582753,1931,29.703363603891834,37.062838144551286
6330,C3_06920W_A,532,C3,1584075,1585043,968,61.44786743706855,76.6725410468166
6332,C3_06940W_A,1389,C3,1585276,1587105,1829,84.91004684165861,105.94784364846579
6334,C3_06950W_A,655,C3,1591959,1594790,2831,25.868543136673555,32.27788071732909
6336,C3_06960C_A,9,C3,1595078,1595193,115,8.750144182931372,10.918129741743483
6338,C3_06970W_A,274,C3,1595830,1597650,1820,16.832542320156744,21.003068874379558
6340,C3_06980W_A,177,C3,1597909,1599021,1112,17.796681139445248,22.20608821874386
6342,C3_06990W_A,57,C3,1599406,1600539,1133,5.624908808386303,7.018568251164905
6344,C3_07000W_A,1202,C3,1600835,1602568,1733,77.5490434318525,96.76303610958529
6346,C3_07010W_A,825,C3,1603060,1604628,1568,58.827234223045195,73.4026048219893
6348,C3_07020W_A,6057,C3,1607932,1611174,3242,208.88877515051615,260.6442477983457
6350,C3_07030C_A,430,C3,1611520,1614048,2528,19.017872268194278,23.729848616790402
6352,C3_07040C_A,273,C3,1614394,1615095,701,43.54268134777784,54.331064073868546
6354,C3_07050W_A,99,C3,1615420,1615779,359,30.83268075601165,38.47196134625489
6356,C3_07060W_A,1266,C3,1616538,1617209,671,210.9510666655039,263.21750440477456
6358,C3_07070C_A,789,C3,1617559,1618656,1097,80.41571279634131,100.33996780280513
6360,C3_07080W_A,335,C3,1620223,1621497,1274,29.39990446951256,36.684192246700476
6362,C3_07090W_A,2343,C3,1622261,1622671,410,638.9383738129926,797.2453843534074
6364,C3_07100C_A,1337,C3,1623757,1626420,2663,56.13461922003642,70.04285219016853
6366,C3_07110W_A,416,C3,1628166,1631963,3797,12.249638536605998,15.284678747695791
6368,C3_07120W_A,112,C3,1632270,1633007,737,16.9910835332664,21.20089116141355
6370,C3_07130W_A,50,C3,1633324,1633997,673,8.306641745394646,10.36474261433466
6372,C3_07140C_A,574,C3,1634324,1636125,1801,35.63434002808931,44.46330706721496
6374,C3_07150C_A,3459,C3,1636561,1636992,431,897.3127362225715,1119.6360503530373
6376,C3_07160W_A,132,C3,1637897,1639189,1292,11.423046843558497,14.25328598896337
6378,C3_07170C_A,793,C3,1639579,1641591,2012,44.06722988526763,54.9855777445492
6380,C3_07180C_A,146,C3,1643662,1645716,2054,7.947361291324122,9.9164447886981
6382,C3_07200C_A,73,C3,1649675,1651255,1580,5.165784839360679,6.445689112653766
6384,C3_07210W_A,132,C3,1652454,1653311,857,17.221209477103358,21.488034419767416
6386,C3_07220C_A,570,C3,1653321,1654661,1340,47.55986328284836,59.34356588484953
6388,C3_07230W_A,1699,C3,1655226,1659188,3962,47.945676178755,59.82496998122582
6390,C3_07240W_A,41,C3,1660226,1660924,698,6.567483257325915,8.19468031396379
6392,C3_07250W_A,707,C3,1661263,1662765,1502,52.62838236375462,65.6678901207615
6394,C3_07260C_A,2246,C3,1662823,1668402,5579,45.01154609566317,56.163863117542455
6396,C3_07270C_A,5876,C3,1668585,1669274,689,953.5272424083283,1189.7785827585456
6398,C3_07280C_A,713,C3,1670305,1671261,956,83.38773503945347,104.04835520388853
6400,C3_07290W_A,1321,C3,1673212,1675362,2150,68.69654540310177,85.71719275023057
6402,C3_07300W_A,841,C3,1675626,1676816,1190,79.01682489749837,98.59448347084229
6404,C3_07310C_A,11706,C3,1677116,1680709,3593,364.2686890441408,454.521974117502
6406,C3_07320W_A,1638,C3,1682965,1687116,4151,44.11961400837234,55.050940856345726
6408,C3_07330W_A,618,C3,1687597,1688466,869,79.5132012633848,99.21384487222981
6410,C3_07340W_A,1323,C3,1688903,1689790,887,166.76571297909223,208.08453583334114
6412,C3_07350W_A,853,C3,1690050,1690943,893,106.79922777462396,133.2604127182191
6414,C3_07360W_A,937,C3,1691219,1692820,1601,65.43630969753417,81.64918247772705
6416,C3_07370W_A,923,C3,1693663,1694244,581,177.62173537908782,221.63030817314248
6418,C3_07380W_A,702,C3,1694611,1695268,657,119.4654388445881,149.06487638270787
6420,C3_07390C_A,1030,C3,1695339,1696043,704,163.581846349151,204.11181627359778
6422,C3_07400W_A,311,C3,1696236,1697117,881,39.46889982375336,49.24793923741401
6424,C3_07410C_A,7940,C3,1697167,1698951,1784,497.6181273937863,620.9108287983292
6426,C3_07420W_A,1518,C3,1699250,1700236,986,172.13349898741595,214.78227507506872
6428,C3_07430W_A,666,C3,1700498,1701494,996,74.76277810918269,93.28642982152313
6430,C3_07440W_A,5562,C3,1701963,1702709,746,833.6095805374429,1040.1494379969295
6432,C3_07450C_A,207,C3,1702725,1703696,971,23.835356708396983,29.740940439661703
6434,C3_07460W_A,1236,C3,1704278,1706584,2306,59.92798950379999,74.77608950040565
6436,C3_07470W_A,145,C3,1707692,1708939,1247,13.00086022011767,16.222027394063314
6438,C3_07480W_A,639,C3,1709297,1710637,1340,53.31710989077211,66.52726070248922
6440,C3_07490W_A,1318,C3,1710784,1712634,1850,79.65521644485932,99.39104654390749
6442,C3_07500W_A,948,C3,1713090,1714644,1554,68.20682960268682,85.10614217395072
6444,C3_07510C_A,25,C3,1714800,1714923,123,22.725080872563403,28.355576339216366
6446,C3_07520W_A,2,C3,1715652,1715724,72,3.1057610525836647,3.8752620996929035
6448,C3_07530W_A,1,C3,1715733,1715820,87,1.2851425045173785,1.603556730907408
6450,C3_07540C_A,442,C3,1715989,1716855,866,57.06566959435483,71.20458490798322
6452,C3_07550C_A,1113,C3,1719339,1721228,1889,65.8769898649668,82.1990480733167
6454,C3_07560W_A,3723,C3,1729949,1732195,2246,185.33345608000155,231.25272871666985
6456,C3_07570C_A,193,C3,1732312,1733178,866,24.91781500386987,31.09159476751304
6458,C3_07580W_A,380,C3,1733433,1733702,269,157.94353605704288,197.07652611077663
6460,C3_07590W_A,161,C3,1733947,1734279,332,54.21985259269555,67.65367207777128
6462,C3_07600W_A,429,C3,1734635,1735285,650,73.79288260938789,92.07622748870338
6464,C3_07610W_A,1661,C3,1735459,1739046,3587,51.77365149157872,64.6013862596144
6466,C3_07620C_A,466,C3,1739081,1740394,1313,39.681833524861815,49.51363060506332
6468,C3_07630C_A,1194,C3,1740463,1741461,998,133.76556421268162,166.90808225771517
6470,C3_07640C_A,4996,C3,1741637,1743169,1532,364.6147257659841,454.95374686838556
6472,C3_07650C_A,246,C3,1743425,1745305,1880,14.630116958340924,18.254958061106567
6474,C3_07660W_A,565,C3,1745619,1747748,2129,29.671761300869775,37.023405874943
6476,C3_07670W_A,470,C3,1748233,1748973,740,71.01280676988597,88.60734422541069
6478,C3_07680W_A,1072,C3,1749088,1753920,4832,24.804952512688082,30.950768822712856
6480,C3_07690C_A,381,C3,1753937,1754744,807,52.78639231380118,65.86504951597009
6482,C3_07700W_A,636,C3,1754845,1755624,779,91.28306169442311,113.89987295836805
6484,C3_07710W_A,1117,C3,1755737,1757161,1424,87.70285354388648,109.43261204554145
6486,C3_07720C_A,3,C3,1757860,1758168,308,1.089033096360506,1.3588581388533556
6488,C3_07730W_A,970,C3,1761811,1763016,1205,90.00263564831667,112.30220126246986
6490,C3_07740W_A,1796,C3,1763210,1765186,1976,101.62251346955945,126.80108619319044
6492,C3_07750W_A,1608,C3,1765306,1766643,1337,134.46992955270247,167.7869651660604
6494,C3_07760C_A,481,C3,1766636,1767562,926,58.07706089259044,72.46656427460293
6496,C3_07770C_A,389,C3,1767841,1768743,902,48.21848977869362,60.165377432482714
6498,C3_07780C_A,2723,C3,1768864,1771416,2552,119.29919453866438,148.85744244071157
6500,C3_07790W_A,585,C3,1772206,1773213,1007,64.95265915333862,81.0456999200919
6502,C3_07800C_A,708,C3,1773215,1773838,623,127.06201879334263,158.5436282455421
6504,C3_07810C_A,4023,C3,1773915,1775354,1439,312.5789866042996,390.0253366048115
6506,C3_07820W_A,275,C3,1775574,1775900,326,94.31605650484137,117.68433983729982
6508,C3_07830W_A,345,C3,1776048,1777043,995,38.76738921918504,48.37261837003604
6510,C3_07840C_A,1,C3,1776123,1776815,692,0.16157138423845654,0.20160323061986202
6512,C3_07850W_A,370,C3,1777118,1778428,1310,31.57918871787361,39.40342837244997
6514,C3_07860C_A,652,C3,1778415,1780547,2132,34.19250629748771,42.66423639962092
6516,C3_07870W_A,1,C3,1778544,1778849,305,0.3665816324361047,0.457407985537523
6518,C3_07880C_A,142,C3,1780559,1781017,458,34.66517576595567,43.254017147664015
6520,C3_07890W_A,348,C3,1781080,1781346,266,146.27434010063217,182.51610370282967
6522,C3_07900C_A,369,C3,1781343,1782407,1064,38.775309983572754,48.38250162812079
6524,C3_07910W_A,1,C3,1782289,1783212,923,0.12113477561539755,0.15114781753948486
6526,C3_07920W_A,690,C3,1782289,1784314,2025,38.09733557835962,47.536548422899614
6528,C3_07930C_A,1,C3,1783243,1783560,317,0.3527047252145487,0.440092856747459
6530,C3_07940W_A,542,C3,1784362,1785075,713,84.99243991306098,106.0506508965048
6532,C3_07950C_A,8597,C3,1785089,1786177,1088,883.4634188292497,1102.3553472041876
6534,C3_07970C_A,47,C3,1787605,1788114,509,10.324062280887153,12.882010751827883
6536,C3_07980C_A,13,C3,1795809,1796210,401,3.624678734686173,4.522749782185233
6538,C4_00010W_A,252,C4,983,1660,677,41.61811561157904,51.929656969592344
6540,C4_00020W_A,2859,C4,2845,3891,1046,305.59976154504886,381.31689899502135
6542,C4_00030C_A,423,C4,3894,4904,1010,46.826266642320846,58.42820916249854
6544,C4_00040W_A,2044,C4,5033,7435,2402,95.14334774909094,118.71660547202438
6546,C4_00050W_A,488,C4,7507,8355,848,64.34199312711064,80.28373180118506
6548,C4_00060W_A,255,C4,8369,8995,626,45.5445470650448,56.82892344278091
6550,C4_00070C_A,3292,C4,8937,11315,2378,154.7813094465077,193.13080822489712
6552,C4_00080C_A,541,C4,11383,12630,1247,48.506657786783855,60.5249435875052
6554,C4_00090W_A,558,C4,12793,14309,1516,41.153382601781445,51.349779062421526
6556,C4_00100C_A,511,C4,14306,15706,1400,40.80970023094936,50.92094398996475
6558,C4_00110C_A,1275,C4,15792,17456,1664,85.66973095768645,106.89575142782708
6560,C4_00120W_A,382,C4,17803,18462,659,64.81096509124517,80.86889893016206
6562,C4_00130W_A,977,C4,19713,20438,725,150.67010722961749,188.00099113158453
6564,C4_00140C_A,5330,C4,21178,23694,2516,236.85748440769228,295.54264375559393
6566,C4_00150C_A,1823,C4,23853,25631,1778,114.63716893079909,143.0403268158863
6568,C4_00160C_A,5959,C4,25876,27186,1310,508.5956366751589,634.6081883011606
6570,C4_00170W_A,1306,C4,27530,27943,413,353.5604398263283,441.1605880851368
6572,C4_00180W_A,990,C4,28147,29691,1544,71.68997662829133,89.45229354472478
6574,C4_00190W_A,277,C4,29746,30663,917,33.773881370081035,42.14189057594071
6576,C4_00200C_A,4021,C4,30660,31982,1322,340.07378738865435,424.33240582688796
6578,C4_00210W_A,134,C4,32585,33277,692,21.65056548795318,27.01483290306151
6580,C4_00220C_A,3810,C4,33383,34763,1380,308.68564200896776,385.1673547781729
6582,C4_00230W_A,333,C4,34782,35390,608,61.23661759600819,76.40895074197124
6584,C4_00240C_A,464,C4,35411,36235,824,62.959505609657214,78.55871130251244
6586,C4_00250W_A,1,C4,35436,35975,539,0.2074348754972392,0.25883012168635344
6588,C4_00260W_A,1061,C4,36910,39081,2171,54.64193881367373,68.18033678483194
6590,C4_00270W_A,40656,C4,39465,41389,1924,2362.599567951296,2947.9706929855133
6592,C4_00280W_A,1169,C4,41651,43041,1390,94.03082599779208,117.32843899530657
6594,C4_00290C_A,113,C4,43184,44714,1530,8.257670563340097,10.30363805330113
6596,C4_00300C_A,1048,C4,45136,48099,2963,39.545782312479425,49.34387056942755
6598,C4_00310C_A,688,C4,48304,49311,1007,76.3887683717897,95.3152846923474
6600,C4_00320C_A,249,C4,49530,50508,978,28.46630069055212,35.51927347816685
6602,C4_00330C_A,1377,C4,50924,51205,281,547.8960387853291,683.6458818718029
6604,C4_00340W_A,1595,C4,51516,52568,1052,169.51787037961412,211.51858342620392
6606,C4_00350W_A,290,C4,52677,54014,1337,24.25141764321127,30.260087001341738
6608,C4_00360C_A,632,C4,54076,55311,1235,57.21641738330652,71.39268282770279
6610,C4_00370W_A,332,C4,56577,58400,1823,20.362071366143702,25.407094139072722
6612,C4_00380W_A,531,C4,58581,59564,983,60.396468241291295,75.36064119809718
6614,C4_00390W_A,1185,C4,59710,60150,440,301.11765114367995,375.7242753929528
6616,C4_00400W_A,1524,C4,60939,63332,2393,71.20538002045558,88.84763052133366
6618,C4_00410W_A,533,C4,63553,64113,560,106.41668406602744,132.7830878016204
6620,C4_00420C_A,1826,C4,64264,66699,2435,83.84406922079663,104.6177533410319
6622,C4_00430W_A,745,C4,67988,69430,1442,57.76457103349092,72.07665014824109
6624,C4_00440C_A,254,C4,69499,71742,2243,12.66120332805396,15.798215175921491
6626,C4_00450C_A,13,C4,72788,73540,752,1.932840655065366,2.411732264170583
6628,C4_00460C_A,1162,C4,74264,77572,3308,39.27454545093104,49.00543051824472
6630,C4_00470C_A,966,C4,78356,80167,1811,59.63884393409693,74.4153035775375
6632,C4_00480W_A,208,C4,81574,83547,1973,11.787095165608964,14.707532996705757
6634,C4_00490W_A,73,C4,84041,85630,1589,5.136526146123268,6.409181118938294
6636,C4_00500W_A,809,C4,86313,89231,2918,30.9980071608796,38.67824996280196
6638,C4_00510C_A,804,C4,89384,90013,629,142.91438458820605,178.32366647617076
6640,C4_00520W_A,1019,C4,90446,90919,473,240.87048298727098,300.5499257191003
6642,C4_00530C_A,10,C4,91405,92481,1076,1.039102210901598,1.2965560928340567
6644,C4_00540C_A,1309,C4,93725,96778,3053,47.93838317784234,59.81587002487008
6646,C4_00550C_A,3,C4,97323,97393,70,4.791745623986226,5.978975810954764
6648,C4_00560C_A,506,C4,97569,98888,1319,42.891996462368496,53.51916179530396
6650,C4_00570C_A,1187,C4,99126,100499,1373,96.66087494465053,120.6101238485631
6652,C4_00580W_A,62,C4,100978,101433,455,15.235293778828002,19.010076937394633
6654,C4_00590C_A,1852,C4,101589,103595,2006,103.2239785133889,128.79933933735057
6656,C4_00600C_A,3939,C4,104411,107074,2663,165.38090135207437,206.3566153904816
6658,C4_00610W_A,225,C4,107335,108391,1056,23.822598982886067,29.725021787417152
6660,C4_00620C_A,129,C4,108410,108919,509,28.33625604754134,35.35700823374036
6662,C4_00630C_A,184,C4,109388,110002,614,33.505800020055695,41.80738786378793
6664,C4_00640W_A,8,C4,110378,110908,530,1.6876588361209348,2.1058028013425587
6666,C4_00650W_A,722,C4,111275,112444,1169,69.05469741553006,86.1640825450966
6668,C4_00660W_A,1832,C4,112691,113431,740,276.79885532432144,345.3801162147924
6670,C4_00670W_A,996,C4,113645,115870,2225,50.049513843343775,62.45006644790505
6672,C4_00680W_A,312,C4,116219,117580,1361,25.63108607099172,31.981589936627984
6674,C4_00690C_A,113,C4,117577,119166,1589,7.951061020711359,9.921061184109961
6676,C4_00700C_A,435,C4,119423,120388,965,50.400225993223,62.88767303750348
6678,C4_00710W_A,785,C4,121067,123004,1937,45.311722945799886,56.538413493712675
6680,C4_00720W_A,71,C4,124043,124867,824,9.633889866994961,12.020837289824103
6682,C4_00730C_A,61,C4,125251,125643,392,17.39860018233094,21.709376456442893
6684,C4_00740W_A,203,C4,126005,126508,503,45.123065153641,56.303012772476606
6686,C4_00750C_A,193,C4,126564,127100,536,40.259007077147956,50.23380796392964
6688,C4_00760W_A,2974,C4,131930,133819,1889,176.0271049940802,219.64058308180043
6690,C4_00770C_A,621,C4,134409,135143,734,94.59454235907415,118.03182493288085
6692,C4_00780C_A,796,C4,135543,138761,3218,27.656522288016628,34.50885976656303
6694,C4_00790C_A,215,C4,140612,142765,2153,11.165160495586424,13.931504250637746
6696,C4_00800W_A,125,C4,142969,144084,1115,12.534461647198649,15.640071254365976
6698,C4_00810C_A,456,C4,144138,145490,1352,37.71018745503954,47.05347827556116
6700,C4_00820W_A,397,C4,146312,147412,1100,40.352306330477944,50.35022357164634
6702,C4_00830W_A,403,C4,148156,149028,872,51.672455677619055,64.47511759443192
6704,C4_00840W_A,1436,C4,150338,152152,1814,88.50905367936336,110.43856091826038
6706,C4_00850C_A,295,C4,152453,154591,2138,15.427119915078825,19.249431009700015
6708,C4_00860C_A,1247,C4,155846,156343,497,280.5308353573157,350.0367528760841
6710,C4_00870W_A,1,C4,157051,157121,70,1.597248541328742,1.9929919369849218
6712,C4_00880W_A,1053,C4,157302,158897,1595,73.81391221400726,92.1024675079364
6714,C4_00890W_A,4980,C4,159230,163885,4655,119.61349978672384,149.2496217471415
6716,C4_00900C_A,1,C4,164078,164148,70,1.597248541328742,1.9929919369849218
6718,C4_00910C_A,719,C4,165104,166809,1705,47.14927805576281,58.83125172343173
6720,C4_00920C_A,293,C4,166683,167584,901,36.35912051348779,45.36766329363012
6722,C4_00930W_A,1,C4,168204,168274,70,1.597248541328742,1.9929919369849218
6724,C4_00940W_A,73,C4,168441,169364,923,8.842838619924024,11.033790680382394
6726,C4_00950C_A,199,C4,169418,171475,2057,10.816564015901497,13.496537521730655
6728,C4_00960W_A,246,C4,174413,175678,1265,21.742782515162798,27.129898146150474
6730,C4_00970C_A,3742,C4,176031,191138,15107,27.69466359407233,34.55645117983917
6732,C4_00980C_A,66,C4,192152,192757,605,12.197170679237667,15.219211155157584
6734,C4_00990W_A,258,C4,195174,196907,1733,16.645302167569003,20.769437035168888
6736,C4_01000C_A,56,C4,197113,197757,644,9.7223824254793,12.131255268603871
6738,C4_01010C_A,4227,C4,199443,200198,755,625.9733389321344,781.0680585887
6740,C4_01020C_A,1743,C4,202398,206000,3602,54.10335772557463,67.50831377888126
6742,C4_01030W_A,3,C4,206759,207076,317,1.0581141756436463,1.320278570242377
6744,C4_01050C_A,3166,C4,208446,208604,158,2240.3938084131382,2795.486538446825
6746,C4_01060W_A,3206,C4,209074,214572,5498,65.19725675609244,81.35090041799856
6748,C4_01070W_A,39,C4,217108,218946,1838,2.372409422104171,2.9602110924748835
6750,C4_01080W_A,1519,C4,219421,222327,2906,58.443027322603285,72.92320463166095
6752,C4_01090C_A,183,C4,222373,223518,1145,17.86965398639405,22.29714123386624
6754,C4_01100C_A,3095,C4,223819,225525,1706,202.83932970625557,253.09595729647322
6756,C4_01110W_A,2,C4,227751,227822,71,3.1495041660003364,3.929843256026606
6758,C4_01120C_A,287,C4,227963,228964,1001,32.05666652876566,39.99920880522185
6760,C4_01130C_A,204,C4,229219,229929,710,32.124942493203434,40.08440121147139
6762,C4_01140C_A,332,C4,230555,231097,542,68.48718837726932,85.45596423529442
6764,C4_01150W_A,736,C4,231131,232915,1784,46.12681886169103,57.555462216066786
6766,C4_01160W_A,474,C4,233630,233860,230,230.42046348385938,287.51074986591175
6768,C4_01170C_A,129,C4,234375,236723,2348,6.1427403442072155,7.664700677586815
6770,C4_01180W_A,3,C4,240271,240573,302,1.1106695154934962,1.3858553204199784
6772,C4_01190W_A,3035,C4,241362,243827,2465,137.6614412191851,171.76922394014062
6774,C4_01200C_A,175,C4,244110,245339,1229,15.920500106816185,19.86505388776671
6776,C4_01210C_A,2,C4,245658,245739,81,2.76067649118548,3.444677421949247
6778,C4_01220C_A,485,C4,246083,248236,2153,25.186524838881,31.426881681671198
6780,C4_01230C_A,196,C4,248784,249194,410,53.44939021226912,66.69231554983689
6782,C4_01240C_A,433,C4,249999,250601,602,80.41960679015644,100.34482659470594
6784,C4_01250W_A,171,C4,250907,251518,611,31.29143214354344,39.044375590359266
6786,C4_01260W_A,1094,C4,253002,254807,1805,67.76581345980891,84.55585735972592
6788,C4_01270W_A,12730,C4,255598,256733,1135,1254.0160133727243,1564.7181630372365
6790,C4_01280C_A,678,C4,256997,258274,1277,59.36211101915591,74.07000573947093
6792,C4_01290W_A,2222,C4,258895,261285,2390,103.94813310387971,129.702914593571
6794,C4_01300W_A,2979,C4,263831,265333,1502,221.7538204549152,276.69680999964424
6796,C4_01310W_A,117,C4,266046,267944,1898,6.8922368564185446,8.599896714386992
6798,C4_01320C_A,343,C4,267976,270813,2837,13.517778455164999,16.867020235110317
6800,C4_01330W_A,7,C4,272019,272348,329,2.3788808062342963,2.968285863594564
6802,C4_01340W_A,19,C4,273215,273544,329,6.456962188350234,8.05677591547096
6804,C4_01350W_A,2,C4,274641,274952,311,0.7190186359679225,0.8971667883533408
6806,C4_01360W_A,499,C4,278189,278608,419,133.15487243105719,166.14608200210813
6808,C4_01370W_A,1248,C4,280487,281395,908,153.67360415250982,191.74865155837307
6810,C4_01380W_A,602,C4,283161,286751,3590,18.748761429413147,23.39406134388429
6812,C4_01390W_A,71,C4,287625,288733,1108,7.164553475093726,8.939684049472076
6814,C4_01400W_A,99,C4,291217,291654,437,25.32936474006449,31.605112410310085
6816,C4_01410W_A,926,C4,292031,293929,1898,54.548814778150195,68.06413980788336
6818,C4_01420W_A,1460,C4,294718,301869,7151,22.82740888320479,28.483257720578802
6820,C4_01430C_A,148,C4,302002,303258,1256,13.174757076565102,16.43900992608582
6822,C4_01440W_A,685,C4,303565,304920,1355,56.522559082445156,70.52691024238153
6824,C4_01450W_A,1514,C4,305252,307093,1841,91.94807192287894,114.72964990856164
6826,C4_01460C_A,205,C4,307183,307857,674,34.00670113956595,42.43239509752764
6828,C4_01470W_A,112,C4,308173,309534,1361,9.200902692150873,11.480570746481842
6830,C4_01480C_A,9,C4,309391,309812,421,2.3901819027009683,2.9823869840866997
6832,C4_01490W_A,1408,C4,309930,312554,2624,59.99421350356739,74.8587215355312
6834,C4_01500W_A,523,C4,312956,314143,1187,49.263074219077716,61.46877406319964
6836,C4_01510W_A,1032,C4,314498,315304,806,143.15785933695824,178.6274659153731
6838,C4_01520C_A,5012,C4,315673,316191,518,1081.8121201540075,1349.8480524551926
6840,C4_01530C_A,3076,C4,317140,318105,965,356.3933221957562,444.6953615249671
6842,C4_01550C_A,777,C4,320143,321435,1292,67.24020755640115,83.9000243441253
6844,C4_01560C_A,339,C4,321752,324649,2897,13.083433857691077,16.325059946376317
6846,C4_01570C_A,13,C4,325276,325380,104,13.975924736626494,17.438679448618064
6848,C4_01580C_A,12,C4,325943,326036,93,14.426761018453155,18.001217495347678
6850,C4_01590C_A,7,C4,326188,326271,83,9.429539581338355,11.76585601352544
6852,C4_01600C_A,8,C4,326439,326531,92,9.7223824254793,12.131255268603871
6854,C4_01610C_A,12,C4,326607,326699,92,14.58357363821895,18.196882902905806
6856,C4_01620C_A,2,C4,326687,326779,92,2.430595606369825,3.0328138171509678
6858,C4_01630C_A,3,C4,326950,327037,87,3.855427513552136,4.810670192722225
6860,C4_01640C_A,2,C4,327198,327290,92,2.430595606369825,3.0328138171509678
6862,C4_01650C_A,430,C4,327629,329125,1496,32.13715313769728,40.0996372347902
6864,C4_01660W_A,576,C4,329466,332810,3344,19.25869054616474,24.030333402880395
6866,C4_01670C_A,237,C4,332863,334044,1181,22.437217020020178,27.996389699051523
6868,C4_01680W_A,153,C4,334467,334859,392,43.63911193273171,54.4513868497666
6870,C4_01690C_A,455,C4,334947,336305,1358,37.46124156209164,46.742852130316464
6872,C4_01700C_A,2169,C4,337230,337508,278,872.3390144961975,1088.4746970950382
6874,C4_01710C_A,2438,C4,340471,340899,428,636.8841964092597,794.6822522566512
6876,C4_01720C_A,4781,C4,340871,342028,1157,462.0148395215991,576.4862675460187
6878,C4_01730C_A,593,C4,342883,345000,2117,31.318746788170092,39.07845786690794
6880,C4_01740W_A,140,C4,345376,345705,329,47.57761612468593,59.36571727189128
6882,C4_01750C_A,12543,C4,345920,346999,1079,1299.7221425134837,1621.7487030510945
6884,C4_01760W_A,85,C4,348098,348634,536,17.73065078527242,22.123697807948293
6886,C4_01770W_A,879,C4,349059,349838,779,126.16008054936776,157.41822064529168
6888,C4_01780C_A,465,C4,349990,350946,956,54.38330546051313,67.85762295905774
6890,C4_01790W_A,502,C4,352073,355570,3497,16.050132611464683,20.02680488008297
6892,C4_01800W_A,34,C4,356483,357208,725,5.243381418430905,6.542511462102225
6894,C4_01820C_A,1116,C4,357858,358832,974,128.10786041950857,159.84859354955034
6896,C4_01830C_A,565,C4,359054,360847,1793,35.2321136695771,43.9614228152558
6898,C4_01840C_A,2468,C4,361141,361872,731,377.4838002735342,471.0113365711561
6900,C4_01850C_A,157,C4,362365,364284,1919,9.147348342471535,11.413747466109582
6902,C4_01860C_A,125,C4,364597,365901,1304,10.717733693731974,13.373220436056798
6904,C4_01870C_A,1135,C4,366373,367671,1298,97.76686949812678,121.99014591175039
6906,C4_01880W_A,640,C4,367892,369211,1319,54.25074651366766,67.69222045255837
6908,C4_01890C_A,362,C4,369339,369896,557,72.66477205973129,90.66860984416142
6910,C4_01900C_A,15362,C4,370410,371408,998,1721.0273010345188,2147.438827171709
6912,C4_01910W_A,328,C4,372264,373781,1517,24.174572517407984,30.164202289501517
6914,C4_01920W_A,547,C4,374223,374501,278,219.99513182545877,274.50237865882247
6916,C4_01930C_A,612,C4,374618,375325,707,96.78377299932578,120.76347182522494
6918,C4_01940W_A,164,C4,379679,381481,1802,10.1755900413174,12.696752184565426
6920,C4_01950W_A,847,C4,382179,383054,875,108.22956116043557,135.04513365009828
6922,C4_01960C_A,771,C4,383106,384434,1328,64.91227693939173,80.99531237882246
6924,C4_01970W_A,236,C4,385301,386614,1313,20.096379210015854,25.075572581105032
6926,C4_01980C_A,2100,C4,386687,387364,677,346.817630096492,432.74714141326956
6928,C4_01990W_A,81,C4,387813,388049,236,38.3745730056524,47.88247577417163
6930,C4_02000C_A,3341,C4,388211,391741,3530,105.82110945058156,132.03995022738346
6932,C4_02010C_A,899,C4,394832,396466,1634,61.51459651518833,76.75580330138379
6934,C4_02020W_A,4239,C4,398110,400008,1898,249.71104302870268,311.5808732674056
6936,C4_02030W_A,402,C4,405052,408387,3335,13.477233569112684,16.816429717168123
6938,C4_02040W_A,358,C4,408951,410384,1433,27.93234364668407,34.85302019598195
6940,C4_02050W_A,495,C4,410516,411604,1088,50.868255475221424,63.47166416960251
6942,C4_02060C_A,3816,C4,411719,413545,1826,233.65664313238423,291.5487438156693
6944,C4_02070W_A,276,C4,414417,415787,1370,22.52470205727832,28.1055505274078
6946,C4_02080W_A,96,C4,416114,417043,929,11.553832290343538,14.416475582926452
6948,C4_02090C_A,268,C4,417123,417845,722,41.50191500737839,51.78466584187968
6950,C4_02100C_A,50,C4,418036,419232,1196,4.674222319941971,5.832334263751861
6952,C4_02110W_A,315,C4,419443,419976,533,66.07754284483819,82.44929120172142
6954,C4_02120W_A,626,C4,421020,421946,926,75.5846987916042,94.31199425343333
6956,C4_02130W_A,547,C4,422279,423034,755,81.00482999665898,101.07504803596377
6958,C4_02140C_A,827,C4,423169,423444,275,336.235338390985,419.54292084384406
6960,C4_02150C_A,255,C4,423674,426985,3311,8.610959366571443,10.744459702561416
6962,C4_02160C_A,358,C4,427566,429880,2314,17.29777374489986,21.583568686621497
6964,C4_02170C_A,400,C4,430108,431778,1670,26.78021506419448,33.415433673998685
6966,C4_02180C_A,442,C4,432066,434558,2492,19.83100717042989,24.744450453576835
6968,C4_02190C_A,146,C4,435121,436770,1649,9.899260213692994,12.351957305024802
6970,C4_02200C_A,151,C4,437154,437594,440,38.370266095101826,47.87710175893323
6972,C4_02210W_A,36,C4,437882,438676,794,5.069353053083666,6.325364837785897
6974,C4_02220C_A,71,C4,438733,441150,2417,3.284371224825754,4.098125745475821
6976,C4_02230C_A,59,C4,442010,442921,911,7.24109382622141,9.035188473927253
6978,C4_02240C_A,54,C4,443684,444265,581,10.391737497801454,12.966453565925995
6980,C4_02250C_A,5976,C4,444629,445555,926,721.5561661000426,900.3330314033827
6982,C4_02260C_A,546,C4,446282,447397,1115,54.7505284749637,68.31583123907059
6984,C4_02270C_A,6746,C4,447754,449142,1388,543.4097306817425,678.0480205209076
6986,C4_02280W_A,1026,C4,450086,450940,854,134.32598388551554,167.6073547005352
6988,C4_02290W_A,1590,C4,451427,452587,1160,153.2532436636974,191.22414016070843
6990,C4_02300W_A,1687,C4,453463,455604,2141,88.09858955885622,109.9263978694766
6992,C4_02310W_A,689,C4,457216,460641,3425,22.492057561543138,28.06481784548402
6994,C4_02320C_A,447,C4,460935,461644,709,70.4907007872727,87.95587829091423
6996,C4_02330C_A,99,C4,462582,463040,458,24.167974653729658,30.155969701540407
6998,C4_02340W_A,1378,C4,463583,463966,383,402.2730921581475,501.9425645993878
7000,C4_02360W_A,5698,C4,464869,468336,3467,183.7549908261846,229.28317392148998
7002,C4_02370C_A,9333,C4,471021,471362,341,3060.112740573257,3818.303701910906
7004,C4_02380W_A,3,C4,479420,479728,308,1.089033096360506,1.3588581388533556
7006,C4_02390W_A,25579,C4,480535,481176,641,4461.655898136276,5567.101174617179
7008,C4_02400C_A,228,C4,483122,485536,2414,10.560102203648189,13.176533270206853
7010,C4_02410C_A,2241,C4,486083,486613,530,472.7554314683769,589.8880097260842
7012,C4_02420C_A,164,C4,487547,488344,797,23.006792038210737,28.707085867737643
7014,C4_02430W_A,800,C4,488934,493196,4262,20.986841462789666,26.18666083321342
7016,C4_02440C_A,555,C4,493509,495056,1547,40.11189775735076,50.05025000120504
7018,C4_02450W_A,119,C4,496166,497164,998,13.331743836942307,16.634892620325047
7020,C4_02460W_A,48,C4,497492,498130,638,8.411841847750114,10.496007693212126
7022,C4_02470C_A,861,C4,498333,499070,737,130.61895466198547,162.98185080336665
7024,C4_02480C_A,332,C4,499700,500026,326,113.86520276220848,142.0770939126674
7026,C4_02490W_A,684,C4,501463,504297,2834,26.985271756817276,33.6712963806768
7028,C4_02500C_A,2826,C4,504516,508772,4256,74.24053252952345,92.6347897026215
7030,C4_02510W_A,131,C4,512431,513978,1547,9.467853344527839,11.813662612897046
7032,C4_02520C_A,136,C4,514049,515524,1475,10.309021093864153,12.863242874641664
7034,C4_02530W_A,205,C4,517316,520240,2924,7.838753956247417,9.780928281714647
7036,C4_02540W_A,452,C4,523880,526963,3083,16.39213228921226,20.453540345832927
7038,C4_02550C_A,1075,C4,527399,529291,1892,63.52693062102952,79.26672476644573
7040,C4_02560C_A,39,C4,529895,531271,1376,3.1689596786536818,3.954119177302933
7042,C4_02570C_A,51,C4,531726,533546,1820,3.133064446452533,3.9093303379319613
7044,C4_02580W_A,7,C4,533914,534252,338,2.3155378261866377,2.889248666043229
7046,C4_02590C_A,750,C4,534274,536604,2330,35.9895057595532,44.90647068313664
7048,C4_02600C_A,642,C4,536885,538603,1718,41.78134426502542,52.13332808387798
7050,C4_02610C_A,126,C4,539025,541505,2480,5.68053715101593,7.087979388793148
7052,C4_02620C_A,7042,C4,543678,545906,2228,353.38765527943906,440.9449934548237
7054,C4_02630C_A,648,C4,547040,547480,440,164.6618041697085,205.45935059462738
7056,C4_02640C_A,792,C4,547908,549077,1169,75.74975118157867,94.51794096359627
7058,C4_02650C_A,1,C4,549182,549268,86,1.3000860220117667,1.6222027394063316
7060,C4_02660W_A,116,C4,550263,551270,1007,12.87950164408082,16.070600326035315
7062,C4_02670W_A,242,C4,551536,553089,1553,17.422659555768764,21.739396917272746
7064,C4_02680C_A,18,C4,553127,553465,338,5.954240124479927,7.429496569825447
7066,C4_02690W_A,166,C4,553837,555657,1820,10.19781761002197,12.724486982288346
7068,C4_02700W_A,189,C4,555825,557594,1769,11.945504919038587,14.905191252860662
7070,C4_02710C_A,798,C4,557744,558505,761,117.24350002447245,146.29241734556862
7072,C4_02720C_A,1638,C4,558858,559796,938,195.24575452958803,243.62095468517174
7074,C4_02730C_A,5,C4,566829,567131,302,1.851115859155827,2.309758867366631
7076,C4_02740W_A,1452,C4,571822,573321,1499,108.30176233532579,135.13522379929782
7078,C4_02750W_A,171,C4,577303,577749,446,42.867858833419376,53.489043689931634
7080,C4_02760C_A,655,C4,578111,579133,1022,71.65738318974837,89.41162457021395
7082,C4_02770C_A,386,C4,579389,580426,1037,41.6177970942166,51.92925953455408
7084,C4_02780W_A,2760,C4,580679,582313,1634,188.85460109223558,235.64629267165657
7086,C4_02790C_A,1416,C4,582403,584097,1694,93.45884026948342,116.61473482523343
7088,C4_02800W_A,600,C4,584380,585738,1358,49.399439422538414,61.638925886131595
7090,C4_02820W_A,68,C4,586325,588797,2472,3.0756080326556687,3.83763819581239
7092,C4_02830C_A,2031,C4,588794,591091,2297,98.85974101902796,123.35379350507021
7094,C4_02840C_A,207,C4,591385,592176,791,29.259331686287574,36.50879035007777
7096,C4_02850W_A,1401,C4,592423,594816,2393,65.45848911329283,81.67685719185593
7098,C4_02860W_A,1552,C4,595171,595815,644,269.44888436328347,336.2090745870215
7100,C4_02870C_A,3413,C4,595985,597268,1283,297.4268503576382,371.119020783373
7102,C4_02880C_A,288,C4,597479,598246,767,41.982438843790675,52.38424700080316
7104,C4_02890C_A,1221,C4,598659,598856,197,692.9788468394294,864.6752327619353
7106,C4_02900C_A,6295,C4,599268,600629,1361,517.1400218490155,645.26957900985
7108,C4_02910W_A,8,C4,602743,603063,320,2.7951849473252985,3.487735889723613
7110,C4_02920W_A,2277,C4,603218,604786,1568,162.36316645560473,202.59118930869047
7112,C4_02930W_A,430,C4,605437,605955,518,92.81309091504853,115.80899093290762
7114,C4_02940W_A,12198,C4,606493,608439,1946,700.8358887456114,874.4789801202185
7116,C4_02950C_A,51,C4,608655,608981,326,17.491341388170582,21.825095751644692
7118,C4_02960W_A,1516,C4,609369,615065,5696,29.75772738865978,37.130671410259815
7120,C4_02970C_A,1968,C4,615198,620561,5363,41.02870763629452,51.19421391740496
7122,C4_02980W_A,2134,C4,621466,622695,1229,194.1391270168328,242.2401428371095
7124,C4_02990C_A,379,C4,622851,623510,659,64.30197845440293,80.23380286526552
7126,C4_03000C_A,295,C4,624273,624995,722,45.68307808647995,57.00177769908397
7128,C4_03010W_A,1,C4,627397,627468,71,1.5747520830001682,1.964921628013303
7130,C4_03020W_A,2289,C4,627762,630455,2693,95.03421231975653,118.58043002714221
7132,C4_03030C_A,882,C4,630579,633098,2519,39.1481242324877,48.84768645869355
7134,C4_03040W_A,255,C4,633412,633630,218,130.78388285650482,163.1876425467011
7136,C4_03050C_A,1903,C4,633876,635618,1742,122.1409174456956,152.40324680009266
7138,C4_03070W_A,2838,C4,639668,640696,1028,308.66672686806214,385.14375311422623
7140,C4_03080W_A,1572,C4,641743,644179,2436,72.15157203933283,90.02825646380164
7142,C4_03090W_A,451,C4,644883,645710,827,60.97356281710809,76.0807200128343
7144,C4_03100W_A,111,C4,646818,647795,977,12.702785226329913,15.850099642142109
7146,C4_03110W_A,3813,C4,649167,654407,5240,81.359085527873,101.51707593523767
7148,C4_03120C_A,793,C4,654505,657207,2702,32.8139402402511,40.94410896448297
7150,C4_03130W_A,590,C4,657550,659415,1865,35.37070496347295,44.134352277467706
7152,C4_03140C_A,144,C4,659489,660385,896,17.969046089948353,22.42115929108037
7154,C4_03150W_A,874,C4,660576,663860,3284,29.75629286190391,37.12888145698462
7156,C4_03160C_A,211,C4,664007,665035,1028,22.948794703721322,28.634718783333945
7158,C4_03170W_A,294,C4,665604,666623,1019,32.258464161477434,40.251004968743565
7160,C4_03180W_A,8225,C4,668228,670270,2042,450.3505620323327,561.9319822326487
7162,C4_03190W_A,536,C4,671287,672630,1343,44.62305679125421,55.679119490449935
7164,C4_03200C_A,192,C4,672797,673672,875,24.53373759480948,30.612356152088392
7166,C4_03230C_A,2,C4,674267,678610,4343,0.05148855532719868,0.0642456530457953
7168,C4_03250C_A,1,C4,679262,680179,917,0.12192736956707954,0.1521367890828184
7170,C4_03270W_A,847,C4,680862,681752,890,106.40546743301249,132.76909207172585
7172,C4_03280W_A,3682,C4,682502,686239,3737,110.16185149640621,137.45617924498092
7174,C4_03290W_A,1060,C4,686644,689340,2696,43.95988196090232,54.85163268704792
7176,C4_03300C_A,101,C4,690179,690361,182,62.046962567001145,77.42007139826042
7178,C4_03310C_A,57,C4,692297,692497,200,31.865108399508408,39.760189142849185
7180,C4_03320W_A,528,C4,697717,698832,1115,52.9455659977671,66.06366097844187
7182,C4_03330W_A,258,C4,699714,700799,1085,26.586459591149385,33.17367224142644
7184,C4_03340C_A,1056,C4,701061,702284,1223,96.54015713411334,120.4594963057444
7186,C4_03350C_A,347,C4,702676,704019,1343,28.888434154039572,36.04599713280994
7188,C4_03360C_A,1313,C4,704421,706550,2129,68.95402227972038,86.03846356424808
7190,C4_03370C_A,210,C4,707397,707855,458,51.265400780638664,63.96720845781299
7192,C4_03380C_A,567,C4,708487,709644,1157,54.792389460101795,68.36806394030384
7194,C4_03390W_A,1361,C4,710440,711150,710,214.32375849632294,267.42583357261054
7196,C4_03400W_A,550,C4,711401,711927,526,116.9088761238718,145.87488512151992
7198,C4_03410W_A,1180,C4,712320,713195,875,150.78026230143325,188.13843885137663
7200,C4_03420C_A,55,C4,713275,713581,306,20.09610092848254,25.075225350954078
7202,C4_03430W_A,398,C4,717205,717996,791,56.257072517596406,70.19564521415919
7204,C4_03440C_A,1347,C4,718927,721134,2207,68.23949477203765,85.14690065170288
7206,C4_03450C_A,617,C4,721912,723741,1829,37.717421815193205,47.062505061989484
7208,C4_03460C_A,21,C4,723995,725866,1871,1.254920019109167,1.5658461503836638
7210,C4_03470C_A,2,C4,726514,727329,815,0.2743739825595385,0.342354443163054
7212,C4_03480C_A,1,C4,730527,731114,587,0.1904725688126268,0.23766513728951366
7214,C4_03490C_A,11,C4,733160,733684,524,2.3471018641662815,2.9286331898442555
7216,C4_03500C_A,1,C4,734839,735390,551,0.20291723755537558,0.2531931680380118
7218,C4_03510C_A,4,C4,738442,741168,2726,0.1640607452575377,0.2047093699030734
7220,C4_03520C_A,46,C4,745166,747331,2165,2.3755844356021014,2.964172765400207
7222,C4_03530W_A,179,C4,750746,752716,1970,10.15914935170007,12.676238056051302
7224,C4_03540C_A,383,C4,752869,754629,1760,24.330814427854303,30.35915558554872
7226,C4_03550W_A,750,C4,755288,758260,2972,28.215191258330737,35.205947742835924
7228,C4_03560W_A,657,C4,758441,760756,2315,31.731084412833194,39.59295860990779
7230,C4_03570W_A,7,C4,762835,764739,1904,0.4110566099007792,0.5129023367240607
7232,C4_03580W_A,56,C4,765642,766715,1073,5.835241642132962,7.281014345741745
7234,C4_03590C_A,1262,C4,766847,769381,2534,55.68308450709592,69.47944266505445
7236,C4_03600C_A,339,C4,770572,771981,1409,26.900431430611107,33.565435532045555
7238,C4_03610C_A,1,C4,772391,772477,86,1.3000860220117667,1.6222027394063316
7240,C4_03620C_A,156,C4,772928,774148,1220,14.296683665008086,17.838911435963396
7242,C4_03630C_A,1,C4,780195,780265,70,1.597248541328742,1.9929919369849218
7244,C4_03640C_A,1,C4,780937,781008,71,1.5747520830001682,1.964921628013303
7246,C4_03650W_A,1,C4,782464,782535,71,1.5747520830001682,1.964921628013303
7248,C4_03660W_A,19,C4,782619,782690,71,29.920289577003196,37.33351093225276
7250,C4_03670W_A,582,C4,782815,785400,2585,25.172884167788375,31.409861320218845
7252,C4_03680C_A,269,C4,785391,787022,1631,18.44033723679964,23.009220216692874
7254,C4_03690C_A,50,C4,787445,787858,413,13.536004587531712,16.88976217783832
7256,C4_03700W_A,579,C4,788604,790349,1745,37.09827127796786,46.2899502613174
7258,C4_03710C_A,163,C4,790413,791915,1502,12.133559158828861,15.139838882155763
7260,C4_03720C_A,491,C4,792424,793434,1010,54.35389343115729,67.82092363779381
7262,C4_03730C_A,216,C4,793991,795340,1349,17.902444733054544,22.338056402677548
7264,C4_03740W_A,395,C4,795553,796467,914,48.3193896802404,60.29127686830753
7266,C4_03750C_A,187,C4,796578,797762,1184,17.658769768575368,22.03400714115931
7268,C4_03760W_A,6,C4,798718,799368,650,1.0320682882431873,1.2877794054364107
7270,C4_03770W_A,199,C4,800107,800601,494,45.03982222815664,56.19914510566793
7272,C4_03780C_A,1700,C4,800718,802052,1334,142.48319071823113,177.78563755712568
7274,C4_03790W_A,517,C4,802327,803634,1307,44.226797789355146,55.18468110136519
7276,C4_03800C_A,564,C4,803672,806206,2534,24.885308765453328,31.051034598328613
7278,C4_03810W_A,354,C4,807342,809537,2195,18.031808133998283,22.499471616622486
7280,C4_03820C_A,118,C4,809585,810853,1268,10.404789393829187,12.98273927405004
7282,C4_03830W_A,349,C4,811967,816289,4322,9.028408575812394,11.26533850544693
7284,C4_03840C_A,181,C4,816382,817305,923,21.92539438638696,27.35775497464676
7286,C4_03850W_A,607,C4,817941,819719,1778,38.17046710970656,47.62779943897038
7288,C4_03860C_A,192,C4,819831,820904,1073,20.006542773027302,24.96347775682884
7290,C4_03870C_A,17,C4,821114,821753,639,2.9745317123336514,3.711518630691794
7292,C4_03880W_A,243,C4,822133,823599,1466,18.53287700409407,23.12468816378821
7294,C4_03890W_A,4443,C4,826096,828363,2267,219.1267176174028,273.4188012005648
7296,C4_03900C_A,249,C4,828649,830406,1757,15.845214613181545,19.771115231444043
7298,C4_03910W_A,767,C4,832645,834441,1796,47.74848228504463,59.578918205300916
7300,C4_03920W_A,341,C4,835077,836783,1706,22.348372029025246,27.885531967075078
7302,C4_03930C_A,194,C4,836883,837323,440,49.296898161918904,61.5109784187619
7304,C4_03940C_A,8857,C4,837701,841234,3533,280.29383615579025,349.7410334025705
7306,C4_03950C_A,88,C4,844510,844815,305,32.25918365437722,40.25190272730202
7308,C4_03960W_A,62,C4,845566,845781,215,32.242133345891816,40.23062793727701
7310,C4_03970W_A,9,C4,847183,847515,332,3.030923436858758,3.781882290061749
7312,C4_03990C_A,132,C4,849660,850721,1061,13.910062697339846,17.3564990553635
7314,C4_04000W_A,424,C4,854022,855179,1157,40.973497585684584,51.12532471020957
7316,C4_04010W_A,422,C4,858485,861013,2528,18.664051388786014,23.28836306112919
7318,C4_04020C_A,1,C4,861270,861698,428,0.2612322380677849,0.3259566252078143
7320,C4_04030W_A,36,C4,864733,866274,1541,2.611983338188469,3.259143206490592
7322,C4_04040W_A,4,C4,866778,867194,416,1.0750711335866532,1.3414368806629278
7324,C4_04050C_A,27,C4,867681,868295,614,4.916611959464695,6.134779740881926
7326,C4_04060W_A,1,C4,869126,869491,365,0.3063216380630464,0.38221763175053286
7328,C4_04070C_A,4,C4,871065,871898,833,0.5368902659928545,0.6699132561293853
7330,C4_04080C_A,240,C4,874032,875090,1058,25.362736762119912,31.646752874618794
7332,C4_04090C_A,886,C4,876709,878454,1745,56.76868454625134,70.83401715289675
7334,C4_04100C_A,348,C4,878813,879406,593,65.61378493552809,81.87062999148851
7336,C4_04110W_A,44,C4,880335,880472,137,35.90894530870457,44.805950116157355
7338,C4_04120C_A,287,C4,880641,882536,1895,16.93336316374376,21.128869664394237
7340,C4_04130W_A,625,C4,882875,883537,662,105.55834393222426,131.71208042762888
7342,C4_04140W_A,437,C4,884123,885214,1091,44.78444810196721,55.880498031502064
7344,C4_04150C_A,3098,C4,885458,886597,1139,304.1082692471914,379.45586607072
7346,C4_04160W_A,544,C4,888267,889790,1523,39.936457290740975,49.83134140537479
7348,C4_04170C_A,457,C4,890261,893062,2801,18.242049566978384,22.76180366445828
7350,C4_04180C_A,197,C4,895669,896631,962,22.896109547737375,28.568980053037492
7352,C4_04190C_A,20,C4,897092,899638,2546,0.8782984909113272,1.0959107273287079
7354,C4_04200C_A,1,C4,897092,898435,1343,0.08325197162547426,0.10387895427322749
7356,C4_04210C_A,132,C4,901264,901704,440,33.542219367903584,41.852830676683354
7358,C4_04220W_A,98,C4,902114,902629,515,21.275970861194505,26.54742657809041
7360,C4_04230W_A,201,C4,903067,904563,1496,15.022250652737567,18.744249033006582
7362,C4_04240C_A,1996,C4,904889,907018,2129,104.82271779917889,130.7941913741349
7364,C4_04250W_A,495,C4,908843,910558,1715,32.27093991664193,40.2665717880627
7366,C4_04260C_A,2182,C4,910696,913320,2624,92.97398711987503,116.00975169781894
7368,C4_04270W_A,144,C4,913732,914373,641,25.117418559428586,31.34065323682997
7370,C4_04280C_A,138,C4,914401,915228,827,18.65709904381578,23.27968816357236
7372,C4_04290W_A,793,C4,915401,918079,2678,33.10801588094043,41.31104646080396
7374,C4_04300C_A,95,C4,918145,918480,335,31.706575521898905,39.56237725656636
7376,C4_04310W_A,1481,C4,918716,919537,821,201.68910630883155,251.66074799905826
7378,C4_04320W_A,503,C4,923039,925159,2120,26.527887330275952,33.100587783603345
7380,C4_04330C_A,2026,C4,925694,926599,905,250.3003183770632,312.31615083226694
7382,C4_04340C_A,346,C4,927322,927855,533,72.58041214067943,90.56334843109718
7384,C4_04350W_A,418,C4,928087,928719,632,73.94856379632752,92.27048113319431
7386,C4_04360W_A,185,C4,929018,930820,1802,11.47856193685195,14.322555817954903
7388,C4_04370C_A,828,C4,930996,933335,2339,39.579532045922996,49.385982329049185
7390,C4_04380C_A,191,C4,935018,935302,284,75.19441196325803,93.82500773763522
7392,C4_04390W_A,2647,C4,936830,937776,946,312.847972751377,390.36096829168724
7394,C4_04400C_A,8,C4,940284,940559,275,3.252578847796711,4.058456308042022
7396,C4_04410C_A,2308,C4,944103,946157,2054,125.63362918065802,156.76133268709052
7398,C4_04420W_A,628,C4,947592,949115,1523,46.10311613710539,57.52588676944003
7400,C4_04430W_A,438,C4,949398,950015,617,79.37056771011221,99.03587161743548
7402,C4_04440W_A,1456,C4,950318,951124,806,201.97465425834417,252.01704493486753
7404,C4_04450C_A,622,C4,951265,953769,2504,27.77324340633124,34.6545003739311
7406,C4_04460C_A,2062,C4,954686,958912,4226,54.55439054789178,68.07109706209266
7408,C4_04470W_A,596,C4,960912,962273,1361,48.961946468945705,61.09303718663551
7410,C4_04480C_A,7211,C4,962661,963667,1006,801.4345389726732,1000.0025248825833
7412,C4_04490C_A,1,C4,963317,963411,94,1.1894404031171484,1.484142931797282
7414,C4_04500C_A,561,C4,964068,964820,752,83.40950826859003,104.0755230922844
7416,C4_04510W_A,1777,C4,965102,969301,4199,47.31644345222249,59.03983497060119
7418,C4_04520W_A,898,C4,969500,970330,830,120.96752205774064,150.9391242877978
7420,C4_04530C_A,6061,C4,970514,972160,1646,411.70391168259135,513.7100176820126
7422,C4_04540C_A,43,C4,973176,973508,332,14.48107864276962,18.068993163628356
7424,C4_04550C_A,790,C4,974467,975477,1010,87.45331122324697,109.12124169828333
7426,C4_04560C_A,1788,C4,976498,977346,848,235.74484367064312,294.15432881253867
7428,C4_04570W_A,316,C4,979296,980141,845,41.81199731857015,52.171575912552036
7430,C4_04580W_A,5042,C4,982197,987134,4937,114.18531500436828,142.47651898712948
7432,C4_04590W_A,4849,C4,987763,988899,1136,477.2483031542385,595.4940608897816
7434,C4_04600C_A,563,C4,989215,990402,1187,53.03080456088099,66.17001873342524
7436,C4_04620C_A,1,C4,996059,997609,1550,0.07213380509226576,0.09000608747673838
7438,C4_04630C_A,84,C4,998774,999139,365,25.731017597295903,32.10628106704476
7440,C4_04640C_A,204,C4,999156,999992,836,27.283144940400046,34.042972320747225
7442,C4_04650W_A,263,C4,1000502,1001221,719,40.897560008153185,51.03057240596996
7444,C4_04660C_A,2825,C4,1001323,1004172,2849,110.86553143129474,138.3342069283146
7446,C4_04670C_A,859,C4,1005037,1006539,1502,63.943112376895655,79.78602208448957
7448,C4_04680C_A,2,C4,1006665,1006750,85,2.6307623033649867,3.282574955033989
7450,C4_04690C_A,2,C4,1006761,1006843,82,2.727009704707608,3.4026691607059636
7452,C4_04700W_A,5394,C4,1007560,1009182,1622,371.8181900338511,463.94198247026304
7454,C4_04710W_A,1251,C4,1009525,1011219,1694,82.56850930587837,103.02615343669989
7456,C4_04720W_A,694,C4,1011677,1012648,971,79.91177563105077,99.71117229529092
7458,C4_04730W_A,2305,C4,1013014,1015230,2216,116.29785746542983,145.11247700023335
7460,C4_04740W_A,1,C4,1015422,1015508,86,1.3000860220117667,1.6222027394063316
7462,C4_04750W_A,1073,C4,1015865,1017364,1499,80.03291390206927,99.86232447427449
7464,C4_04760C_A,379,C4,1017566,1018333,767,55.24772333957175,68.93621393508471
7466,C4_04770C_A,1230,C4,1018785,1020554,1769,77.74058756834636,97.0020383122678
7468,C4_04780W_A,1500,C4,1022584,1025082,2498,67.13814925521133,83.77267949696429
7470,C4_04790W_A,17,C4,1027532,1030078,2546,0.7465537172746282,0.9315241182294017
7472,C4_04800W_A,2116,C4,1033241,1034341,1100,215.07677631055753,268.36542336927874
7474,C4_04810C_A,503,C4,1034791,1035768,977,57.56307179138692,71.82522630628361
7476,C4_04820C_A,1242,C4,1036182,1036958,776,178.94946930814544,223.2870090225117
7478,C4_04830W_A,736,C4,1037422,1039257,1835,44.84482008133885,55.95582811632869
7480,C4_04840C_A,487,C4,1039532,1041073,1541,35.33433015827178,44.08896504335885
7482,C4_04850C_A,547,C4,1042165,1044021,1856,32.95185702989092,41.11619680342277
7484,C4_04860W_A,210,C4,1048293,1049468,1175,19.982598772368092,24.93360125419434
7486,C4_04870C_A,3294,C4,1049786,1052143,2357,156.25522641475663,194.96991125582656
7488,C4_04880W_A,235,C4,1052921,1053868,947,27.74523601357741,34.61955371003375
7490,C4_04890C_A,3952,C4,1054051,1054518,467,946.1730973729834,1180.6023328640445
7492,C4_04900W_A,2682,C4,1055341,1055842,501,598.5378066847467,746.8349426138706
7494,C4_04910C_A,175,C4,1055978,1056721,743,26.33417850777536,32.8588845599802
7496,C4_04920W_A,587,C4,1056993,1058111,1118,58.70388422468516,73.24869292550127
7498,C4_04930C_A,178,C4,1058295,1059131,836,23.805881369564744,29.70416212300493
7500,C4_04940W_A,69,C4,1059519,1060398,879,8.776689936994112,10.951252623022947
7502,C4_04950W_A,28,C4,1060449,1060895,446,7.019298522431242,8.758439902444946
7504,C4_04970C_A,608,C4,1062625,1062888,263,258.4748970302329,322.51610965048764
7506,C4_04980W_A,317,C4,1063814,1065475,1661,21.338317358268988,26.625220398371706
7508,C4_04990C_A,172,C4,1065570,1066970,1400,13.736337455427183,17.139730658070327
7510,C4_05000W_A,117,C4,1068053,1069351,1298,10.078170688353158,12.575195657863256
7512,C4_05010W_A,636,C4,1069560,1071119,1559,45.612254688874664,56.913406693116556
7514,C4_05020W_A,19,C4,1071272,1071643,371,5.725985336838886,7.14468807598368
7516,C4_05030C_A,2559,C4,1071853,1076304,4451,64.28108991422548,80.20773886140395
7518,C4_05040W_A,11,C4,1077190,1077411,221,5.565074103272088,6.943908558725744
7520,C4_05050C_A,336,C4,1077531,1078781,1250,30.053828553641615,37.50013628630828
7522,C4_05060W_A,812,C4,1080133,1082154,2021,44.92212127121509,56.05228188927409
7524,C4_05070C_A,357,C4,1082286,1083653,1367,29.199152192981177,36.4337004427602
7526,C4_05080C_A,445,C4,1083917,1085980,2063,24.117446467469858,30.09292236407189
7528,C4_05090C_A,335,C4,1086508,1091751,5243,7.14390202062922,8.913915873030025
7530,C4_05100C_A,4185,C4,1092126,1096076,3950,118.45923042588733,147.80936403537538
7532,C4_05110C_A,6736,C4,1097227,1099170,1943,387.61432434757,483.65185698771495
7534,C4_05120C_A,7,C4,1104280,1104594,314,2.492521609079884,3.110082958989209
7536,C4_05130C_A,665,C4,1104766,1106391,1625,45.755027445447965,57.091553641014215
7538,C4_05140C_A,3375,C4,1108501,1113084,4583,82.33689022232497,102.7371470898293
7540,C4_05150W_A,1028,C4,1115386,1117143,1757,65.4171912544202,81.62532714025895
7542,C4_05160C_A,270,C4,1117383,1118930,1547,19.513896206278748,24.34877027085651
7544,C4_05170C_A,380,C4,1119301,1120516,1215,34.96856888834941,43.6325806780238
7546,C4_05180C_A,1625,C4,1120763,1125010,4247,42.780085136836455,53.379522682372226
7548,C4_05190C_A,450,C4,1125094,1126632,1538,32.71347792708412,40.8187555364272
7550,C4_05200C_A,21,C4,1127004,1127477,473,4.963964811317656,6.193865005005993
7552,C4_05210W_A,364,C4,1128701,1129393,692,58.81198386279819,73.38357594562977
7554,C4_05220C_A,162,C4,1129531,1131927,2396,7.559598688926517,9.432607915446164
7556,C4_05230C_A,222,C4,1132118,1134427,2309,10.749780135231118,13.413206886420824
7558,C4_05240C_A,2002,C4,1134817,1137282,2465,90.80665743683971,113.30543206858698
7560,C4_05250W_A,301,C4,1139061,1139768,707,47.601169399995186,59.39510624083777
7562,C4_05260W_A,725,C4,1143093,1144082,989,81.96194486595921,102.26930313648612
7564,C4_05270C_A,133,C4,1144171,1144818,647,22.98359183890354,28.678137454914406
7566,C4_05280W_A,2150,C4,1144988,1151416,6428,37.396687223082715,46.66230344060838
7568,C4_05290W_A,1172,C4,1151631,1154099,2468,53.094923148545384,66.25002370755388
7570,C4_05300W_A,968,C4,1154633,1156483,1850,58.502465492127335,72.99736954059367
7572,C4_05310W_A,78,C4,1156768,1158231,1463,5.961023264289086,7.437960338986789
7574,C4_05320W_A,1590,C4,1158925,1160073,1148,154.85519394589633,193.2229987686601
7576,C4_05330C_A,433,C4,1160202,1161677,1475,32.822103923846896,40.954295328822354
7578,C4_05340W_A,241,C4,1161917,1164274,2357,11.432152266531979,14.264647423392288
7580,C4_05350W_A,293,C4,1167102,1168889,1787,18.33215869202714,22.874238739541543
7582,C4_05360C_A,78,C4,1169089,1170171,1082,8.060052713174613,10.05705727905515
7584,C4_05370W_A,1193,C4,1171023,1173812,2789,47.82582491443644,59.67542368505227
7586,C4_05380C_A,57,C4,1174198,1174446,248,25.697668064119686,32.06466866358805
7588,C4_05390W_A,355,C4,1174822,1175916,1094,36.281194014642814,45.270429281604486
7590,C4_05400C_A,631,C4,1176257,1177441,1184,59.58654397845484,74.35004548701349
7592,C4_05420C_A,304,C4,1179358,1183830,4472,7.600502897914944,9.483646784221632
7594,C4_05430C_A,1511,C4,1184110,1185966,1856,91.02423395276996,113.57691658130129
7596,C4_05440C_A,1130,C4,1186514,1187842,1328,95.13731899028878,118.70908299360488
7598,C4_05450C_A,2025,C4,1188801,1189685,884,256.11988770740857,319.5776098049917
7600,C4_05460C_A,731,C4,1190491,1192344,1853,44.10750559082123,55.03583238829921
7602,C4_05530W_A,379,C4,1204629,1206167,1538,27.552018076366405,34.37846299623535
7604,C4_05540W_A,962,C4,1210137,1211771,1634,65.82540806185894,82.134686068889
7606,C4_05550C_A,703,C4,1211998,1212963,965,81.45139970858799,101.63226240313782
7608,C4_05560C_A,852,C4,1213411,1214982,1571,60.63647549640114,75.66011401768345
7610,C4_05570C_A,280,C4,1215386,1216962,1576,19.86425850891075,24.78594033306121
7612,C4_05580C_A,1,C4,1217919,1218905,986,0.11339492686918047,0.1414902997859478
7614,C4_05590W_A,1642,C4,1221251,1229458,8207,22.36965362986787,27.91208641855086
7616,C4_05600W_A,701,C4,1230574,1233402,2828,27.714634343352675,34.58136999570371
7618,C4_05610C_A,3847,C4,1233748,1236879,3131,137.37561791581504,171.41258342723395
7620,C4_05620C_A,158,C4,1237338,1237799,461,38.320106002377194,47.81451371595061
7622,C4_05630W_A,1031,C4,1238032,1238988,956,120.57889877373988,150.45421348556673
7624,C4_05640C_A,294,C4,1239058,1239897,839,39.17923120446425,48.88650067121536
7626,C4_05650W_A,1089,C4,1240101,1241087,986,123.48707536053753,154.08293646689714
7628,C4_05660C_A,795,C4,1241123,1243357,2234,39.78821903533773,49.646374795528594
7630,C4_05670W_A,6486,C4,1245541,1247604,2063,351.51855682698766,438.61279652442755
7632,C4_05680W_A,929,C4,1249405,1251384,1979,52.48563549399096,65.48977547353685
7634,C4_05690W_A,3847,C4,1251904,1254192,2288,187.99084776853888,234.56853090501292
7636,C4_05700W_A,310,C4,1256166,1259081,2915,11.890323618124771,14.836337918549846
7638,C4_05720W_A,11,C4,1262625,1262957,332,3.704461978382926,4.622300576742138
7640,C4_05730W_A,375,C4,1263841,1264554,713,58.80473241217318,73.37452783429761
7642,C4_05740C_A,2478,C4,1264732,1269063,4331,63.97107642089208,79.82091465929452
7644,C4_05750C_A,200,C4,1269674,1270375,701,31.899400254782297,39.802977343493446
7646,C4_05760W_A,560,C4,1270621,1271970,1349,46.413745604215485,57.91347956249735
7648,C4_05770C_A,337,C4,1272201,1274483,2282,16.5114343076008,20.602401311776646
7650,C4_05780C_A,37,C4,1276925,1279141,2216,1.8668202716793512,2.329354294580752
7652,C4_05790W_A,554,C4,1282526,1286320,3794,16.32611977668124,20.37117219722595
7654,C4_05800C_A,301,C4,1287292,1287657,365,92.20281305697698,115.04750715691041
7656,C4_05810W_A,5760,C4,1288330,1289715,1385,464.9896114539703,580.1980859150327
7658,C4_05820W_A,148,C4,1290067,1290333,266,62.208627399119436,77.62179122993905
7660,C4_05830W_A,55,C4,1290546,1290887,341,18.033451273066444,22.501521869184597
7662,C4_05840W_A,501,C4,1291227,1293410,2183,25.659874642418224,32.01751132847512
7664,C4_05850C_A,657,C4,1293694,1294932,1238,59.335589996533805,74.0369137172347
7666,C4_05860W_A,153,C4,1295759,1296151,392,43.63911193273171,54.4513868497666
7668,C4_05870C_A,14,C4,1296699,1298390,1691,0.9256673982863199,1.155016024982391
7670,C4_05880W_A,312,C4,1301849,1303915,2066,16.884757087424845,21.068220669772842
7672,C4_05890W_A,45,C4,1304386,1304892,506,9.943345662422011,12.406965615617596
7674,C4_05900C_A,1015,C4,1305122,1306300,1178,96.33659495874969,120.20549840643352
7676,C4_05910C_A,463,C4,1309161,1312463,3302,15.677415270885685,19.561740968407417
7678,C4_05920C_A,192,C4,1312804,1315008,2204,9.740027402658027,12.153272065824567
7680,C4_05940W_A,186,C4,1320918,1323974,3056,6.805031416263161,8.491084757704083
7682,C4_05950C_A,1,C4,1324904,1324975,71,1.5747520830001682,1.964921628013303
7684,C4_05960W_A,703,C4,1325490,1326404,914,85.99628087394683,107.30320921119035
7686,C4_05970W_A,801,C4,1326856,1328934,2078,43.09803932257102,53.776255008058016
7688,C4_05980C_A,459,C4,1329067,1331142,2075,24.732335244767462,30.86015948690387
7690,C4_05990W_A,2,C4,1331478,1331559,81,2.76067649118548,3.444677421949247
7692,C4_06000W_A,308,C4,1331712,1333082,1370,25.136261716093195,31.364165081310155
7694,C4_06010C_A,154,C4,1333108,1334418,1310,13.143770439331174,16.40034586312783
7696,C4_06020C_A,826,C4,1334460,1337801,3341,27.64229591727862,34.49110858918532
7698,C4_06030W_A,1857,C4,1338043,1338714,671,309.4282233790212,386.0939223378092
7700,C4_06040W_A,204,C4,1339119,1340288,1169,19.511299546770264,24.34553024819904
7702,C4_06050W_A,130,C4,1340632,1341225,593,24.51089667131797,30.58385603130318
7704,C4_06060W_A,2241,C4,1341803,1351054,9251,27.084680432195412,33.795335115644214
7706,C4_06070C_A,313,C4,1351194,1352273,1079,32.43347130724072,40.469372881686404
7708,C4_06080W_A,60,C4,1352454,1352630,176,38.11615837261771,47.56003485986745
7710,C4_06090C_A,595,C4,1352664,1355066,2402,27.69583752970113,34.55791597644546
7712,C4_06100W_A,864,C4,1355313,1357805,2492,38.764683699663856,48.36924251558911
7714,C4_06110C_A,2810,C4,1357947,1360055,2108,149.04117081563737,185.96846015414332
7716,C4_06120W_A,9848,C4,1362406,1363776,1370,803.7074850002787,1002.8386289634492
7718,C4_06130W_A,3338,C4,1364530,1376010,11480,32.509851408264275,40.56467735155895
7720,C4_06140C_A,105,C4,1376152,1377579,1427,8.226893327796954,10.26523527458947
7722,C4_06150C_A,21,C4,1378116,1378936,820,2.8633601899429895,3.572802618741262
7724,C4_06160W_A,228,C4,1379310,1380818,1508,16.904566790190138,21.09293853732052
7726,C4_06170C_A,446,C4,1380823,1381377,554,90.0110098561071,112.31265031167734
7728,C4_06180C_A,5,C4,1382072,1382211,139,4.021848845072372,5.018325021185054
7730,C4_06190C_A,1072,C4,1382397,1385960,3563,33.63949776629492,41.97421132510484
7732,C4_06200W_A,24,C4,1386049,1386258,209,12.839127030776492,16.02022226858693
7734,C4_06210C_A,1973,C4,1386346,1387926,1580,139.61771901450163,174.21020026391616
7736,C4_06220C_A,39,C4,1388385,1389065,680,6.412483114452156,8.001276452895347
7738,C4_06230C_A,670,C4,1389377,1391464,2087,35.8940855717863,44.78740864618727
7740,C4_06240W_A,151,C4,1391701,1393017,1316,12.828964347906386,16.007541621527828
7742,C4_06250C_A,1528,C4,1393150,1395522,2372,72.02432714187279,89.86948464582933
7744,C4_06260W_A,183,C4,1396271,1396981,710,28.81796311890308,35.958065792643445
7746,C4_06270C_A,1806,C4,1397074,1398126,1052,191.94311843610228,239.50003866315
7748,C4_06280C_A,175,C4,1398542,1399618,1076,18.184288690777965,22.689731624595993
7750,C4_06290W_A,45,C4,1399953,1400249,296,16.99774630130249,21.209204734805756
7752,C4_06300C_A,65,C4,1400697,1401380,683,10.640528349993817,13.276886256634544
7754,C4_06310C_A,171,C4,1402334,1403224,890,21.482095550230383,26.80462189405563
7756,C4_06320C_A,74,C4,1403991,1404659,668,12.385849467189948,15.454638074224391
7758,C4_06340W_A,975,C4,1407066,1409819,2753,39.59760731772127,49.408536033135086
7760,C4_06350C_A,781,C4,1410147,1411982,1835,47.5866908743555,59.37704043322379
7762,C4_06360C_A,59,C4,1412344,1413132,788,8.371366085898103,10.445503426075794
7764,C4_06370C_A,315,C4,1413404,1415089,1685,20.901679724806385,26.080398937992594
7766,C4_06380W_A,32,C4,1417018,1417860,842,4.249212271468387,5.302021305043022
7768,C4_06390W_A,1977,C4,1418728,1419573,845,261.5896161354848,326.4025493009979
7770,C4_06400C_A,694,C4,1419739,1420542,803,96.63055309807011,120.5722892885772
7772,C4_06410W_A,174,C4,1420866,1423403,2537,7.668303994238896,9.56824666632887
7774,C4_06420W_A,1170,C4,1426455,1429091,2636,49.626197092118346,61.921866327414676
7776,C4_06430C_A,295,C4,1429792,1431423,1631,20.2226746648918,25.233159717191064
7778,C4_06440C_A,286,C4,1431997,1433226,1229,26.01864588885388,32.46517378229303
7780,C4_06450W_A,192,C4,1433543,1433956,413,51.97825761612178,64.85668676289914
7782,C4_06460C_A,378,C4,1434027,1434701,674,62.70503917441917,78.24119681397778
7784,C4_06470W_A,3119,C4,1436216,1436827,611,570.7484026649825,712.1602775808803
7786,C4_06480C_A,793,C4,1437628,1438893,1265,70.08953875822804,87.45532207275336
7788,C4_06490C_A,150,C4,1442052,1443683,1631,10.282715931300915,12.8304201951819
7790,C4_06500W_A,2356,C4,1444145,1447327,3182,82.7838558881006,103.29485551463019
7792,C4_06510C_A,195,C4,1447546,1448538,992,21.978268739049728,27.423729778068726
7794,C4_06520W_A,3,C4,1449260,1449321,61,5.498724486541571,6.861119783062845
7796,C4_06530C_A,364,C4,1449989,1451764,1775,22.92839032848245,28.60925890387369
7798,C4_06540W_A,2960,C4,1457328,1460318,2990,110.68558453622589,138.10967536564405
7800,C4_06550C_A,1692,C4,1461105,1465031,3926,48.18596974910245,60.124800055143695
7802,C4_06560W_A,43,C4,1466574,1467071,497,9.673477081286748,12.070232857796004
7804,C4_06570C_A,15569,C4,1468068,1469771,1703,1022.1546551945409,1275.4095142009849
7806,C4_06580W_A,914,C4,1471030,1472064,1034,98.83168440446123,123.31878542388326
7808,C4_06590W_A,348,C4,1472403,1473227,824,47.21962920724291,58.91903347688433
7810,C4_06600W_A,2813,C4,1473575,1477960,4385,71.72501944653196,89.49601877119747
7812,C4_06610C_A,10112,C4,1478187,1480112,1925,587.3228090878633,732.8412533378737
7814,C4_06620C_A,23,C4,1481276,1481707,431,5.966520073176971,7.444819068551563
7816,C4_06630C_A,1,C4,1482004,1482513,509,0.2196608995933437,0.27408533514527406
7818,C4_06640C_A,1,C4,1482851,1483333,482,0.23196555579463057,0.28943866304760274
7820,C4_06650W_A,1224,C4,1484245,1486263,2018,67.81578544154938,84.61821068427557
7822,C4_06660W_A,1,C4,1486939,1488489,1550,0.07213380509226576,0.09000608747673838
7824,C4_06670W_A,170,C4,1489544,1490743,1199,15.852591861394524,19.780320308691053
7826,C4_06680C_A,1818,C4,1490891,1493611,2720,74.73009167996166,93.24564481643422
7828,C4_06690C_A,987,C4,1494219,1494736,517,213.45048688665918,266.3361952152577
7830,C4_06700W_A,12,C4,1494984,1495313,329,4.078081382115937,5.088490051876397
7832,C4_06710W_A,559,C4,1495684,1496802,1118,55.903698946505976,69.75471779447226
7834,C4_06720W_A,4092,C4,1497789,1498739,950,481.59565492442624,600.9185372946957
7836,C4_06730C_A,1311,C4,1498921,1500297,1376,106.52579842858913,132.91923696010628
7838,C4_06740C_A,1734,C4,1500722,1502503,1781,108.85683770156245,135.82782779967982
7840,C4_06750C_A,9,C4,1502546,1502986,440,2.286969502357063,2.853602091592047
7842,C4_06760W_A,4186,C4,1507097,1509049,1952,239.76729896523975,299.1734105406361
7844,C4_06770W_A,454,C4,1509593,1511473,1880,27.000297150759266,33.6900445517983
7846,C4_06780C_A,814,C4,1511588,1512886,1298,70.11650376341427,87.48896808120249
7848,C4_06790W_A,676,C4,1513766,1514587,821,92.06065892286976,114.87013210490437
7850,C4_06800W_A,1607,C4,1514782,1516158,1376,130.57738983580683,162.92998763912342
7852,C4_06810C_A,1223,C4,1516294,1518216,1922,71.1448738934202,88.77213305165408
7854,C4_06820C_A,1198,C4,1518979,1520136,1157,115.76945780106162,144.45315802554498
7856,C4_06830C_A,3020,C4,1527753,1529432,1679,201.10681455443483,250.93418432317594
7858,C4_06840W_A,141,C4,1529634,1530410,776,20.31551946251892,25.34900827067162
7860,C4_06850C_A,1538,C4,1530448,1531563,1115,154.22401610713217,192.43543671371896
7862,C4_06860C_A,183,C4,1531811,1532457,646,31.67299352077583,39.520474787580255
7864,C4_06870W_A,2655,C4,1532681,1533973,1292,229.7590103761198,286.68541136892236
7866,C4_06880C_A,499,C4,1534066,1534347,281,198.54765675662975,247.74095501381962
7868,C4_06890W_A,55,C4,1535338,1536519,1181,5.2069490974730375,6.497052461805206
7870,C4_06900W_A,8,C4,1536828,1537565,737,1.213648823804743,1.5143493686723963
7872,C4_06910W_A,187,C4,1538056,1539795,1739,12.022992182859825,15.001877202491446
7874,C4_06920C_A,14,C4,1539950,1540393,443,3.5334166377024085,4.408876068273641
7876,C4_06930C_A,315,C4,1541258,1541980,722,48.78023592285147,60.866305000716785
7878,C4_06940C_A,291,C4,1542377,1543543,1166,27.903904619954094,34.81753495401617
7880,C4_06950W_A,176,C4,1543701,1544444,743,26.484659527819787,33.04664961460866
7882,C4_06960W_A,117,C4,1544730,1545158,428,30.564171853930837,38.136925149314266
7884,C4_06970C_A,130,C4,1545215,1546621,1406,10.337810615996839,12.899165452747358
7886,C4_06980W_A,133,C4,1547130,1548029,899,16.54102771943336,20.63932695587277
7888,C4_06990W_A,1747,C4,1548591,1550669,2078,93.99784606308559,117.28728776414151
7890,C4_07000W_A,76,C4,1550811,1551437,626,13.574061086052568,16.937247771181763
7892,C4_07010C_A,152,C4,1551459,1551986,527,32.248054041248224,40.23801557783599
7894,C4_07020C_A,11,C4,1552509,1552955,446,2.7575815623837028,3.440815675960515
7896,C4_07030W_A,441,C4,1553710,1554468,758,65.04889508023518,81.1657798083437
7898,C4_07040W_A,292,C4,1554645,1556204,1559,20.94147542319403,26.13005464526735
7900,C4_07050W_A,486,C4,1556544,1557434,890,61.054376826970575,76.18155696205284
7902,C4_07060W_A,3138,C4,1557803,1562149,4346,80.72977786200448,100.73184741788032
7904,C4_07070W_A,303,C4,1562275,1562916,641,52.8512348854643,65.94595785249639
7906,C4_07080C_A,672,C4,1562962,1566078,3116,24.112506862677805,30.086758894663255
7908,C4_07090C_A,889,C4,1566664,1567773,1109,89.62739109728369,111.83398398428464
7910,C4_07100C_A,1545,C4,1568024,1573987,5963,28.96904741651911,36.14658359633058
7912,C4_07110C_A,10378,C4,1574155,1575360,1205,962.9354152146706,1201.5177780432084
7914,C4_07120C_A,1668,C4,1575583,1578204,2621,71.15404032260356,88.78357060753889
7916,C4_07130W_A,1792,C4,1578444,1582748,4304,46.55177904839159,58.08571295896574
7918,C4_07140W_A,953,C4,1583035,1583619,584,182.45282567130204,227.65837691141115
7920,C4_07150W_A,202,C4,1583826,1584365,539,41.90184485044233,52.283684580643396
7922,C4_07160W_A,58,C4,1584493,1584672,179,36.228095406674264,45.204174660104925
7924,C4_07170C_A,80,C4,1584704,1584946,242,36.96112327041717,46.11882168229571
7926,C4_07180W_A,10639,C4,1585323,1585904,581,2047.3647266501791,2554.631471997901
7928,C4_07190W_A,1647,C4,1586083,1588440,2357,78.12761320737832,97.48495562791328
7930,C4_07200C_A,433,C4,1588433,1589635,1202,40.27670822601845,50.255894850260376
7932,C4_07210W_A,326,C4,1589707,1590588,881,41.37254450978649,51.6232417729806
7934,C4_07220C_A,1425,C4,1590581,1593721,3140,50.740618470554786,63.312403093708895
7936,C4_07230C_A,1849,C4,1594317,1596377,2060,100.35528092435878,125.21987689512544
7938,C4_07240W_A,784,C4,1596552,1596950,398,220.24371846261647,274.81255653701635
7940,C4_07250C_A,55,C4,1597159,1597812,653,9.417162150253686,11.750411879620135
7942,C4_07260W_A,6,C4,1602903,1603258,355,1.8897024996002019,2.3579059536159632
7944,C5_00010W_A,9,C5,1918,2427,509,1.9769480963400936,2.4667680163074666
7946,C5_00030W_A,2311,C5,3999,4808,809,319.3904777883197,398.52448163912334
7948,C5_00040C_A,1486,C5,4830,6473,1643,101.1234286482141,126.17834527399363
7950,C5_00050W_A,308,C5,6532,7230,698,49.33621568918005,61.56003748050847
7952,C5_00060C_A,549,C5,7209,8807,1598,38.41192831243026,47.92908644451222
7954,C5_00070W_A,1444,C5,8946,10154,1208,133.65056503105072,166.76459022387078
7956,C5_00080C_A,1445,C5,10151,11086,935,172.7932512892003,215.60549136473244
7958,C5_00090C_A,840,C5,11157,11819,662,141.87041424490943,177.0210360947332
7960,C5_00100C_A,746,C5,11839,12441,602,138.55202463153972,172.8804633710176
7962,C5_00110C_A,8116,C5,12554,14674,2120,428.0324723111722,534.0842354905064
7964,C5_00120W_A,106,C5,14763,15059,296,40.03913573195698,49.95946004198689
7966,C5_00130C_A,538,C5,15077,15475,398,151.1366333327649,188.58310639912597
7968,C5_00140C_A,279,C5,15563,15979,416,74.98621156766907,93.56522242623922
7970,C5_00150C_A,3546,C5,16398,18029,1631,243.08340461595364,303.3111334141001
7972,C5_00160W_A,527,C5,18148,18882,734,80.27588377332057,100.16549394465089
7974,C5_00170W_A,634,C5,19011,20093,1082,65.51376179682956,81.74582455026878
7976,C5_00180W_A,1947,C5,21297,23504,2207,98.63570625178716,123.07425060791797
7978,C5_00190C_A,19706,C5,23548,29661,6113,360.4247640895948,449.7256564233176
7980,C5_00200C_A,3575,C5,30720,32849,2129,187.74610026656538,234.26314336800218
7982,C5_00210C_A,2491,C5,33839,35884,2045,136.19179860708692,169.93545430418618
7984,C5_00220W_A,1368,C5,36656,39271,2615,58.490447540206624,72.9823739524574
7986,C5_00230C_A,146,C5,39266,40126,860,18.981255921371798,23.68415999533244
7988,C5_00240W_A,862,C5,40891,42570,1679,57.402011306596954,71.62426055846943
7990,C5_00250C_A,212,C5,42567,43190,623,38.04681918670711,47.47351580233746
7992,C5_00260W_A,2900,C5,43421,44635,1214,267.0852173721043,333.2597719999498
7994,C5_00270W_A,3423,C5,45823,46218,395,968.9030961715948,1208.9640456226762
7996,C5_00280C_A,511,C5,46404,47366,962,59.39041613651674,74.10532389391959
7998,C5_00290W_A,371,C5,47854,48873,1019,40.70710953710248,50.79293484150973
8000,C5_00300C_A,2090,C5,48904,53010,4106,56.91121811894666,71.01186565535656
8002,C5_00310C_A,848,C5,53247,53780,533,177.88494073785014,221.95872679066593
8004,C5_00320W_A,523,C5,54029,54322,293,199.57429726295305,249.02196181917398
8006,C5_00330C_A,1236,C5,54415,63318,8903,15.522177220685474,19.36804025473834
8008,C5_00340W_A,356,C5,63667,64644,977,40.740464329490536,50.83455380723055
8010,C5_00350C_A,1792,C5,64733,66052,1319,151.90209023826944,189.53821726716342
8012,C5_00360C_A,2,C5,66383,66464,81,2.76067649118548,3.444677421949247
8014,C5_00370W_A,2614,C5,67605,68261,656,445.52521050660556,555.9110741303368
8016,C5_00380W_A,848,C5,69038,71404,2366,40.072981155229975,50.00169120009507
8018,C5_00390C_A,986,C5,71613,72101,488,225.90593098874956,281.8776710874986
8020,C5_00400C_A,1255,C5,74018,76453,2435,57.625578790854206,71.90322039594471
8022,C5_00410W_A,18,C5,77014,77355,341,5.901856780276291,7.3641344299149605
8024,C5_00420C_A,654,C5,77777,78136,359,203.68255772153154,254.1481082873808
8026,C5_00430W_A,172,C5,78890,79492,602,31.944970826574846,39.85983873969843
8028,C5_00440C_A,650,C5,79518,80225,707,102.79322295680022,128.26185733071276
8030,C5_00450C_A,358,C5,80483,81598,1115,35.89869815757693,44.793164072504155
8032,C5_00460C_A,386,C5,82117,83979,1862,23.178117930559942,28.920860438954126
8034,C5_00470C_A,23,C5,84369,86237,1868,1.3766435500745582,1.7177285966518865
8036,C5_00480C_A,1192,C5,87345,88250,905,147.26455059499472,183.75165438897443
8038,C5_00490C_A,543,C5,89881,93594,3713,16.35104149095219,20.402268657365166
8040,C5_00500W_A,1414,C5,95043,98102,3059,51.68213815649522,64.48719905942058
8042,C5_00510W_A,24,C5,103156,104601,1445,1.8570086847282261,2.3171117329651683
8044,C5_00520W_A,3,C5,105031,105504,473,0.7091378301882365,0.884837857857999
8046,C5_00530W_A,10,C5,105626,107950,2324,0.4810989582315488,0.6002987762002776
8048,C5_00540C_A,5,C5,109830,110891,1061,0.526896314293176,0.6574431460364963
8050,C5_00550C_A,401,C5,121532,121855,323,138.80732679596838,173.19902065376704
8052,C5_00560W_A,597,C5,122290,122799,509,131.1375570572262,163.62894508172863
8054,C5_00570W_A,2938,C5,125110,130260,5150,63.78449223488721,79.58810131268329
8056,C5_00580W_A,714,C5,130820,132904,2084,38.306373366415805,47.79737860388982
8058,C5_00590W_A,24970,C5,134735,135640,905,3084.8958291585727,3849.2271896750767
8060,C5_00600C_A,131,C5,137588,138895,1307,11.2064033083279,13.982965617560621
8062,C5_00610C_A,330,C5,139506,141368,1862,19.815489422499432,24.725087940038502
8064,C5_00620W_A,23,C5,141650,142261,611,4.208789118722217,5.251582681744228
8066,C5_00630C_A,1310,C5,142316,144415,2099,69.77974808949294,87.06877590353375
8068,C5_00640C_A,333,C5,144757,146283,1526,24.3983378102051,30.443408945687104
8070,C5_00650C_A,422,C5,146706,147779,1073,43.97271380321625,54.867643819696724
8072,C5_00660C_A,9420,C5,148115,149701,1586,664.076726451559,828.6121584160512
8074,C5_00670C_A,475,C5,151171,153228,2057,25.818431696247288,32.21535338101538
8076,C5_00680W_A,412,C5,156800,158155,1355,33.99605013425899,42.4191051384835
8078,C5_00690C_A,143,C5,158181,159323,1142,14.000400962084683,17.469220043099007
8080,C5_00700C_A,853,C5,159620,160765,1145,83.29407022073292,103.93148345621806
8082,C5_00710W_A,52,C5,164508,166652,2144,2.7117465906887226,3.3836243706273854
8084,C5_00730W_A,1356,C5,171023,174772,3749,40.44033916855807,50.460067927076224
8086,C5_00740W_A,51,C5,175545,176033,488,11.68478953390084,14.579879539008546
8088,C5_00750C_A,2232,C5,176142,178124,1982,125.91024828314968,157.10648851388706
8090,C5_00760W_A,618,C5,180036,181850,1814,38.090943714377836,47.52857287429312
8092,C5_00770C_A,619,C5,181901,184267,2366,29.251386008357734,36.49887600572978
8094,C5_00780C_A,210,C5,184660,185712,1052,22.318967260011892,27.848841705017442
8096,C5_00790C_A,2537,C5,186133,188229,2096,135.33175975886036,168.86232733261082
8098,C5_00800C_A,1475,C5,189505,190827,1322,124.74728584885976,155.65538388327775
8100,C5_00810C_A,12,C5,190881,191756,875,1.5333585996755925,1.9132722595055245
8102,C5_00820W_A,1687,C5,194339,195190,851,221.64404259167,276.5598329477666
8104,C5_00830C_A,1088,C5,195364,196608,1244,97.78653449163747,122.01468321605437
8106,C5_00840W_A,203,C5,196711,197904,1193,19.025064352289544,23.7388226526033
8108,C5_00850C_A,53,C5,197983,198300,317,18.69335043637108,23.32492140761533
8110,C5_00860W_A,356,C5,198637,199125,488,81.5644132170333,101.77327678209886
8112,C5_00870C_A,30,C5,199539,201137,1598,2.0990124760890856,2.619075761995204
8114,C5_00880C_A,604,C5,202590,204197,1607,42.02344015393853,52.43540702907435
8116,C5_00890C_A,289,C5,206335,207939,1604,20.14484912162123,25.136051674067932
8118,C5_00900C_A,1066,C5,210200,211276,1076,110.76829568211035,138.21287949611045
8120,C5_00910C_A,71,C5,211600,211956,356,22.298666433718676,27.823511030379382
8122,C5_00920W_A,152,C5,212567,213013,446,38.104763407483894,47.545816613272564
8124,C5_00930C_A,3355,C5,213091,213870,779,481.5325031207383,600.8397386404479
8126,C5_00940C_A,627,C5,214536,215582,1046,67.02030447315343,83.6256368205241
8128,C5_00950C_A,885,C5,215856,217277,1421,69.63374182640082,86.8865942971259
8130,C5_00960W_A,2,C5,217451,217544,93,2.404460169742192,3.00020291589128
8132,C5_00970W_A,3,C5,217558,217651,93,3.6066902546132886,4.5003043738369195
8134,C5_00980W_A,412,C5,218210,219694,1484,31.040867878652914,38.731730096122064
8136,C5_00990W_A,3,C5,220201,220272,71,4.724256249000505,5.894764884039908
8138,C5_01000C_A,810,C5,220477,221181,704,128.64203450758475,160.51511765205262
8140,C5_01010W_A,251,C5,221837,222652,815,34.43393481122209,42.96548261696328
8142,C5_01020C_A,53,C5,222660,222935,275,21.54833486665321,26.887273040778396
8144,C5_01030W_A,11,C5,223245,223308,63,19.52192661624018,24.35879034092682
8146,C5_01040W_A,54,C5,223535,223858,323,18.69225847127754,23.323558891030974
8148,C5_01050C_A,1425,C5,223927,224533,606,262.9134356395083,328.0543658650923
8150,C5_01060C_A,574,C5,224788,225603,815,78.74533299458756,98.2557251877965
8152,C5_01070C_A,386,C5,225952,227454,1502,28.73345911231865,35.85262459209892
8154,C5_01080C_A,3222,C5,229537,231060,1523,236.5354143212636,295.14077575021616
8156,C5_01090C_A,2086,C5,234850,236442,1592,146.50140201307974,182.79942376792604
8158,C5_01100C_A,864,C5,244200,245597,1397,69.14931408701669,86.28214198199574
8160,C5_01110W_A,731,C5,253333,254304,971,84.17220170936328,105.0271858038295
8162,C5_01120W_A,15,C5,254730,255237,507,3.307911180266626,4.12749809434747
8164,C5_01130W_A,1206,C5,261873,262667,794,169.8233272783028,211.89972206582758
8166,C5_01140C_A,3128,C5,262791,265052,2261,154.68091137078346,193.00553495011872
8168,C5_01150C_A,1,C5,265331,265415,84,1.331040451107285,1.6608266141541013
8170,C5_01160C_A,5,C5,265434,265534,100,5.590369894650597,6.975471779447226
8172,C5_01170W_A,167,C5,266063,266791,728,25.648125615567302,32.00285129581557
8174,C5_01180W_A,1306,C5,266959,268119,1160,125.87970831747724,157.06838179238065
8176,C5_01190W_A,675,C5,268261,269373,1112,67.86869926059629,84.68423473249779
8178,C5_01200W_A,186,C5,269467,269937,470,44.24718299595792,55.21011706285889
8180,C5_01210W_A,7821,C5,270287,272368,2081,420.2045453730161,524.3168167905502
8182,C5_01220W_A,724,C5,273044,274345,1301,62.220258320169606,77.636303894232
8184,C5_01230C_A,830,C5,274465,275364,899,103.22596245962171,128.8018148374015
8186,C5_01240W_A,975,C5,276990,278405,1415,77.0404331771637,96.1284096814282
8188,C5_01250W_A,1197,C5,280816,283287,2471,54.161657336274914,67.58105803317143
8190,C5_01260W_A,72,C5,283848,286220,2372,3.393816462182488,4.23468775818044
8192,C5_01270W_A,752,C5,286734,288617,1883,44.65170643417152,55.714867532069185
8194,C5_01280C_A,516,C5,288699,290108,1409,40.94578943420452,51.090751429308284
8196,C5_01290C_A,1265,C5,290422,291162,740,191.13021396575692,238.48572435137135
8198,C5_01300C_A,469,C5,291456,292550,1094,47.93205631793657,59.807975586119724
8200,C5_01310W_A,295,C5,293743,294381,638,51.69777802263092,64.50671394786619
8202,C5_01320W_A,1803,C5,294646,296502,1856,108.6146219833516,135.5255993355964
8204,C5_01330W_A,1,C5,296701,297147,446,0.25068923294397294,0.3128014250873195
8206,C5_01340W_A,1233,C5,297628,299091,1463,94.23002160087746,117.57698843552193
8208,C5_01350W_A,600,C5,299565,301415,1850,36.261858776111985,45.24630343425227
8210,C5_01360W_A,18,C5,303368,305500,2132,0.9439648977834031,1.1778470171674489
8212,C5_01380W_A,53,C5,308742,310874,2132,2.7794521990289085,3.4681051061041552
8214,C5_01390C_A,157,C5,311113,311721,608,28.871318205925785,36.02464043990837
8216,C5_01400W_A,353,C5,313333,315318,1985,19.883129197094824,24.80948653042691
8218,C5_01410C_A,664,C5,315377,317962,2585,28.719579187992238,35.83530569866892
8220,C5_01420W_A,373,C5,318343,318662,319,130.7340420504497,163.12545289867177
8222,C5_01430C_A,480,C5,319484,320866,1382,38.83324962998968,48.4547967313266
8224,C5_01440C_A,403,C5,321017,322234,1217,37.0241424411535,46.1974548416965
8226,C5_01450W_A,907,C5,322718,324214,1496,67.78697185091032,84.58225807431327
8228,C5_01460W_A,765,C5,324412,328203,3791,22.56203096495757,28.152128257858756
8230,C5_01470C_A,169,C5,328259,329767,1508,12.530139419044442,15.634678126347229
8232,C5_01480W_A,196,C5,330456,330884,428,51.20151866128584,63.8874985407316
8234,C5_01490C_A,679,C5,330986,332797,1811,41.92005696816958,52.30640903638505
8236,C5_01500C_A,571,C5,333128,336385,3257,19.6014811780503,24.458055794070404
8238,C5_01510W_A,291,C5,338274,338594,320,101.67485245895773,126.86639298869642
8240,C5_01520C_A,1631,C5,338743,340293,1550,117.65023610548548,146.7999286745603
8242,C5_01530C_A,472,C5,340759,342204,1445,36.52117079965511,45.56986408164831
8244,C5_01540W_A,604,C5,342887,343737,850,79.4490215616226,99.13376364202645
8246,C5_01550C_A,913,C5,343387,343875,488,209.18064400885225,261.00843174734905
8248,C5_01560C_A,502,C5,344089,344778,689,81.46199382045283,101.64548137249659
8250,C5_01570C_A,148,C5,345209,347536,2327,7.111085040036858,8.872967970418474
8252,C5_01580C_A,34279,C5,347886,351038,3152,1215.9409239766994,1517.2093726375092
8254,C5_01590W_A,95,C5,353407,355008,1601,6.634417738810827,8.278198863803702
8256,C5_01600C_A,421,C5,355185,357080,1895,24.839532724516115,30.993916824773425
8258,C5_01610W_A,258,C5,357144,358613,1469,19.636697519671262,24.501997537064454
8260,C5_01620C_A,87,C5,358644,359429,785,12.391393142282853,15.461555281832066
8262,C5_01640W_A,1633,C5,360948,362516,1568,116.4422708924034,145.29267112037397
8264,C5_01650C_A,1281,C5,362665,368511,5846,24.499705217404774,30.569891719028043
8266,C5_01670W_A,93,C5,375462,377102,1640,6.34029756344519,7.911205798641366
8268,C5_01680C_A,347,C5,377647,379728,2081,18.64352093650896,23.26274586706571
8270,C5_01690C_A,1156,C5,382476,384125,1649,78.38044388376096,97.80042907266213
8272,C5_01700W_A,1343,C5,384426,385058,632,237.59072052265043,296.4575506265071
8274,C5_01710C_A,187,C5,385279,387495,2216,9.435010562271316,11.772682515854074
8276,C5_01720C_A,184,C5,387749,390304,2555,8.05188305765722,10.046863463156866
8278,C5_01730W_A,103,C5,390706,393267,2561,4.496744233885291,5.610883196275394
8280,C5_01740C_A,561,C5,393493,394455,962,65.20161145320135,81.35633405966513
8282,C5_01750C_A,83,C5,394560,395220,660,14.060627310787867,17.544368414973324
8284,C5_01760C_A,1187,C5,395335,398205,2870,46.24229313554188,57.699547053685414
8286,C5_01770C_A,3762,C5,398770,400071,1301,323.3047124315995,403.4085293509679
8288,C5_01780W_A,1972,C5,400477,402144,1667,132.26406037493675,165.03455727738367
8290,C5_01790C_A,59,C5,402452,402754,302,21.84316713803876,27.255154634926242
8291,C5_01800C_A,1351,C5,402802,404601,1799,83.96431047996616,104.7677862594019
8293,C5_01810W_A,294,C5,407947,409146,1199,27.415658866176404,34.208318651500996
8295,C5_01820W_A,1866,C5,409928,411697,1769,117.93815967685714,147.1591898298307
8297,C5_01830C_A,700,C5,411944,414976,3032,25.81305360326793,32.20864278108878
8299,C5_01840C_A,1441,C5,416400,419345,2945,54.707796388397355,68.26251160735791
8301,C5_01850C_A,1242,C5,420926,423694,2768,50.16791480604078,62.59780310746715
8303,C5_01860W_A,5,C5,424381,424716,335,1.6687671327315214,2.082230381924545
8305,C5_01870W_A,2374,C5,424739,427087,2348,113.04546959029402,141.05425898132634
8307,C5_01880C_A,226,C5,427195,427842,647,39.05482523001654,48.731271163989895
8309,C5_01890W_A,393,C5,428107,428781,674,65.19333437975325,81.34600621135785
8311,C5_01900C_A,90,C5,428854,429018,164,61.35771835592119,76.56005611588418
8313,C5_01910W_A,2527,C5,429592,430119,527,536.1238984357518,668.9570089815232
8315,C5_01920C_A,194,C5,430841,432214,1373,15.79798630097911,19.712185363623625
8317,C5_01930W_A,340,C5,432413,433954,1541,24.668731527335538,30.780796950188925
8319,C5_01940W_A,693,C5,434181,435950,1769,43.800184703141475,54.652367927155765
8321,C5_01950C_A,496,C5,435968,437557,1589,34.90023244489234,43.54731280812869
8323,C5_01960C_A,2506,C5,438134,440017,1883,148.79943660110885,185.66683249383695
8325,C5_01970C_A,1207,C5,440800,443334,2534,53.256325673585415,66.45141624145857
8327,C5_01980C_A,749,C5,444832,445512,680,123.15256032627346,153.6655400825286
8329,C5_01990W_A,159,C5,446199,446600,401,44.33260913962319,55.3167088744194
8331,C5_02000C_A,7774,C5,446964,448538,1574,552.2177326685355,689.0383432455238
8333,C5_02010C_A,1181,C5,451345,453531,2186,60.404637196544876,75.37083414023031
8335,C5_02020C_A,806,C5,453808,454866,1058,85.17652429278604,106.28034507059478
8337,C5_02030W_A,1532,C5,455201,456193,992,172.6702959396112,215.4520718974425
8339,C5_02040W_A,1329,C5,456436,457821,1385,107.28666555943167,133.86862086477058
8341,C5_02050W_A,1088,C5,458157,463166,5009,24.28557574517808,30.30270830919777
8343,C5_02060W_A,213,C5,463382,464368,986,24.153119423135443,30.13743385440688
8345,C5_02070C_A,646,C5,464404,465366,962,75.08064349156521,93.68305134143259
8347,C5_02080C_A,6,C5,466337,466720,383,1.7515519252168974,2.1855264060931257
8349,C5_02090W_A,1,C5,467461,467754,293,0.38159521465191787,0.4761414183923021
8351,C5_02110W_A,2,C5,473498,473881,383,0.5838506417389657,0.7285088020310418
8353,C5_02120C_A,931,C5,474334,476817,2483,41.92214556520101,52.3090151161125
8355,C5_02130W_A,1,C5,474758,475336,578,0.1934384046591902,0.24136580551720507
8357,C5_02140C_A,379,C5,477228,477779,551,76.90563303348735,95.96021068640647
8359,C5_02150C_A,641,C5,477990,479684,1694,42.30728574345966,52.78957981848491
8361,C5_02160W_A,131,C5,480236,482263,2027,7.225835778976106,9.016150005994932
8363,C5_02170C_A,5337,C5,482348,483952,1604,372.0175078273097,464.19068437543444
8365,C5_02180C_A,1565,C5,484150,487104,2954,59.23445419856592,73.91071993794793
8367,C5_02190C_A,769,C5,487795,488164,369,233.00782921335008,290.73917606476516
8369,C5_02200W_A,37,C5,488648,489742,1094,3.781420221244463,4.7183264321672285
8371,C5_02210W_A,748,C5,489943,490926,983,85.07826411390941,106.15773939016327
8373,C5_02220C_A,383,C5,491075,491653,578,74.08690898446986,92.44310351308953
8375,C5_02230W_A,1950,C5,492351,493187,836,260.7947678126475,325.410764830672
8377,C5_02240W_A,181,C5,498691,499884,1193,16.963234718051268,21.16614236512905
8379,C5_02260C_A,550,C5,501453,502862,1409,43.643767807776136,54.45719629092937
8381,C5_02270W_A,2901,C5,503291,504823,1532,211.71883896059248,264.17550433650655
8383,C5_02280C_A,235,C5,504892,506283,1391,18.889100291055218,23.569171361180416
8385,C5_02290W_A,240,C5,508123,509403,1280,20.96388710493974,26.158019172927094
8387,C5_02300C_A,1391,C5,509606,511327,1721,90.36844303845416,112.7586431750272
8389,C5_02310C_A,160,C5,511587,513602,2015,8.878006780586556,11.07767230482934
8391,C5_02320C_A,138,C5,514002,515186,1184,13.031605497665243,16.26039029668441
8393,C5_02330W_A,255,C5,515646,515960,314,90.79900147362436,113.29587922032118
8395,C5_02340C_A,1584,C5,517861,521547,3686,48.04745476465842,59.951965809247994
8397,C5_02350C_A,105,C5,523617,524495,878,13.371044167159743,16.683930224190405
8399,C5_02360C_A,44,C5,524833,525309,476,10.335137620362449,12.895830180490668
8401,C5_02370C_A,534,C5,525672,527018,1346,44.35746692040741,55.347725560547076
8403,C5_02380W_A,10495,C5,529671,531464,1793,654.4443061278083,816.5931547718756
8405,C5_02390C_A,321,C5,531715,532662,947,37.89881174620574,47.288837195407794
8407,C5_02400W_A,969,C5,533214,534119,905,119.71421940146804,149.3752962272787
8409,C5_02410C_A,143,C5,534199,534717,518,30.865748839190555,38.51322256605998
8411,C5_02430W_A,283,C5,535546,537645,2099,15.07455626666145,18.809514183740493
8413,C5_02440C_A,278,C5,537707,538597,890,34.924108555345306,43.57710459969278
8415,C5_02450W_A,521,C5,538877,541222,2345,24.840790747232077,30.995486542362514
8417,C5_02460C_A,1194,C5,541501,542742,1241,107.57295171978747,134.22583891474596
8419,C5_02470W_A,1701,C5,547644,553208,5564,34.18123361179248,42.65017072911478
8421,C5_02480W_A,1181,C5,553739,554719,980,134.73932337923173,168.1231055413709
8423,C5_02490C_A,1186,C5,555200,556462,1262,105.07414730674498,131.10791648850096
8425,C5_02500C_A,877,C5,557609,559051,1442,67.9993675119081,84.84727809396972
8427,C5_02510C_A,851,C5,559298,560461,1163,81.81263594750918,102.08300059001873
8429,C5_02520W_A,268,C5,562888,563793,905,33.10981506665989,41.31329142302446
8431,C5_02530W_A,389,C5,565049,566509,1460,29.789779301631263,37.170664687739325
8433,C5_02540C_A,129,C5,566644,568018,1374,10.497201112226012,13.09804744612361
8435,C5_02550C_A,1086,C5,568081,570480,2399,50.6139366868741,63.15433390979314
8437,C5_02560C_A,466,C5,570689,572443,1754,29.704816087881166,37.06465050424638
8439,C5_02570W_A,102,C5,573167,575461,2294,4.971383864466966,6.203122245018457
8441,C5_02580W_A,229,C5,575960,576265,305,83.94719382786798,104.74642868809276
8443,C5_02590C_A,432,C5,576552,579308,2756,17.525687913563555,21.86795216778811
8445,C5_02600W_A,192,C5,580917,582386,1469,14.613356293708845,18.234044678745637
8447,C5_02610C_A,310,C5,582629,586153,3524,9.835497544504458,12.272396433760726
8449,C5_02620C_A,1181,C5,586676,588685,2009,65.72649920938133,82.01127099579067
8451,C5_02630C_A,414,C5,589400,591802,2402,19.270717205539942,24.045339855879693
8453,C5_02640W_A,111,C5,594501,595151,650,19.09326333249896,23.823919000573603
8455,C5_02650C_A,2347,C5,595462,598119,2657,98.76250013357134,123.2324596640018
8457,C5_02660C_A,759,C5,600804,601811,1007,84.27191161945984,105.15160040914488
8459,C5_02670W_A,451,C5,602727,604307,1580,31.91464332262556,39.821997120641754
8461,C5_02680W_A,215,C5,604742,605716,974,24.680277768991346,30.795203954438474
8463,C5_02690W_A,656,C5,606039,607136,1097,66.86021241368809,83.42587944060857
8465,C5_02700W_A,1336,C5,607797,610301,2504,59.654426351862604,74.43474678387774
8467,C5_02710W_A,3794,C5,611323,612285,962,440.9535006300284,550.2066513767728
8469,C5_02720W_A,288,C5,612652,613482,830,38.7958199917921,48.408093312790385
8471,C5_02730C_A,575,C5,613567,614718,1151,55.855129268880866,69.69411421689234
8473,C5_02740W_A,645,C5,614913,616580,1667,43.26081082243114,53.979355701781174
8475,C5_02750C_A,747,C5,616642,619695,3053,27.356739674444785,34.134801305254356
8477,C5_02760W_A,407,C5,620204,621007,803,56.66950304166359,70.71026187384858
8479,C5_02770W_A,671,C5,621344,622543,1199,62.57111258232779,78.07408780665702
8481,C5_02780W_A,763,C5,623507,625951,2444,34.90550106070708,43.55388680620486
8483,C5_02790C_A,1262,C5,626060,627808,1748,80.72135934838734,100.72134308538213
8485,C5_02800C_A,12,C5,628354,629076,722,1.8582947018229132,2.3187163809796876
8487,C5_02810W_A,111,C5,629164,629673,509,24.38235985486115,30.423472201125424
8489,C5_02820C_A,350,C5,629720,630532,812,48.1928439194017,60.13337740902781
8491,C5_02830W_A,576,C5,630777,631655,878,73.3497280027049,91.52327437270164
8493,C5_02840C_A,2294,C5,631817,636205,4388,58.45172533422274,72.93405771217837
8495,C5_02850W_A,312,C5,637935,638080,145,240.57867684565332,300.1858200258668
8497,C5_02860C_A,1202,C5,638962,639987,1025,131.11462660234184,163.60033324674276
8499,C5_02870C_A,8,C5,640712,641194,482,1.8557244463570446,2.315509304380822
8501,C5_02890W_A,2387,C5,641753,642208,455,586.5588104848781,731.8879620896935
8503,C5_02900W_A,2109,C5,642638,644950,2312,101.99039885655804,127.26012095894635
8505,C5_02910C_A,402,C5,645248,647530,2282,19.696132319452587,24.576158241347805
8507,C5_02920W_A,432,C5,648510,649700,1190,40.5889041090598,50.64544216338154
8509,C5_02930C_A,1154,C5,649786,650901,1115,115.71814992693791,144.3891378203067
8511,C5_02940C_A,3707,C5,651905,653617,1712,242.09697662931967,302.0803024113419
8513,C5_02950C_A,21,C5,654469,654849,380,6.178829883561187,7.7097319667574595
8515,C5_02960C_A,27,C5,654930,655382,452,6.678760493609121,8.333528232082967
8517,C5_02970W_A,1047,C5,656966,659482,2516,46.527164385526035,58.05499962703693
8519,C5_02980C_A,25,C5,659648,660151,503,5.557027728280912,6.933868568038992
8521,C5_02990W_A,263,C5,660366,660920,554,53.0782412380183,66.22920859186354
8523,C5_03000C_A,437,C5,661022,664453,3431,14.240697429101202,17.76905373138116
8525,C5_03010W_A,423,C5,664894,666915,2021,23.4015483962118,29.199649309313966
8527,C5_03020W_A,448,C5,668022,671636,3614,13.859909866095558,17.293920073006955
8529,C5_03030W_A,742,C5,672427,674499,2072,40.03913573195698,49.95946004198689
8531,C5_03040W_A,662,C5,674318,675910,1592,46.492774751993664,58.01208942203596
8533,C5_03050C_A,60,C5,676465,677187,722,9.291473509114567,11.593581904898437
8535,C5_03060C_A,18,C5,679515,681047,1532,1.3136639439126732,1.639144804569844
8537,C5_03070W_A,15973,C5,682963,683640,677,2637.960955014889,3291.5571856162637
8539,C5_03080C_A,347,C5,684022,686037,2015,19.254177205397095,24.02470181109863
8541,C5_03090W_A,937,C5,687505,688824,1319,79.42648356766657,99.10564150632372
8543,C5_03100C_A,335,C5,688982,689980,998,37.53053937290481,46.82931956141925
8545,C5_03110C_A,75,C5,690600,691057,457,18.349135321610277,22.89542159555982
8547,C5_03120W_A,123,C5,691292,692740,1448,9.497451616602534,11.850594321436585
8549,C5_03130W_A,71,C5,697356,698426,1070,7.418995561125092,9.257168155901926
8551,C5_03140C_A,5284,C5,699595,705870,6275,94.14984708632274,117.47694942661082
8553,C5_03150W_A,1897,C5,709951,711870,1919,110.52560385776115,137.91005696312024
8555,C5_03160W_A,320,C5,712905,716690,3785,9.452673005485819,11.794721106595045
8557,C5_03170C_A,556,C5,716852,719299,2447,25.404541572748116,31.69891548322564
8559,C5_03210C_A,51,C5,726044,728167,2123,2.6859054604538906,3.3513806947885874
8561,C5_03240W_A,297,C5,731795,732916,1121,29.622477407872033,36.961911123921965
8563,C5_03250W_A,195,C5,734682,736340,1658,13.149844746162442,16.40792517481555
8565,C5_03260C_A,587,C5,736879,740160,3281,20.003335130508386,24.95947537053046
8567,C5_03270W_A,70,C5,741739,742398,659,11.876354859652254,14.81890818091975
8569,C5_03280W_A,2090,C5,742816,744072,1256,186.04893439203423,232.14547801026595
8571,C5_03290C_A,290,C5,744290,744577,287,112.97611633788664,140.96772237210422
8573,C5_03300C_A,368,C5,745130,747427,2297,17.91254785573722,22.350662732577963
8575,C5_03310C_A,212,C5,748851,749972,1121,21.144664008312695,26.383586391486382
8577,C5_03320C_A,71,C5,754145,755731,1586,5.005249212108353,6.245378264070025
8579,C5_03330C_A,770,C5,756011,759739,3728,23.093266195713305,28.814985355012677
8581,C5_03340W_A,1,C5,760485,760805,320,0.3493981184156623,0.4359669862154516
8583,C5_03350W_A,3559,C5,761964,763088,1124,354.0236024032292,441.738506460012
8585,C5_03360W_A,629,C5,763489,763962,473,148.68256506280025,185.52100419756044
8587,C5_03370C_A,64,C5,764152,764667,515,13.8945115828209,17.337094908140678
8589,C5_03380W_A,164,C5,764896,766140,1244,14.73988203734241,18.39191916124349
8591,C5_03390C_A,427,C5,766244,766900,656,72.7770714943843,90.80873322634041
8593,C5_03400C_A,477,C5,767218,767744,526,101.39187983833973,126.51330945993638
8595,C5_03410C_A,727,C5,768110,768631,521,156.0153133747019,194.67055599455404
8597,C5_03420W_A,1,C5,769601,769694,93,1.202230084871096,1.50010145794564
8599,C5_03430W_A,28,C5,772001,772828,827,3.7854983567162446,4.723414989710334
8601,C5_03440W_A,121,C5,775455,775670,215,62.92416346536952,78.51461258726646
8603,C5_03450W_A,7,C5,776792,776872,80,9.783147315638544,12.207075614032645
8605,C5_03460C_A,120,C5,777303,778316,1013,13.244706561857289,16.526290494248116
8607,C5_03470C_A,782,C5,778703,780199,1496,58.44477617134716,72.92538678513009
8609,C5_03480C_A,434,C5,780649,782214,1565,31.006013217614814,38.68823964575203
8611,C5_03490C_A,2560,C5,782698,784329,1631,175.4916852275356,218.97250466443776
8613,C5_03500W_A,4665,C5,785559,787265,1706,305.73359388681166,381.4838904000153
8615,C5_03510C_A,2298,C5,787678,789219,1541,166.73160308769724,208.0419746809828
8617,C5_03520W_A,129,C5,791003,792178,1175,12.275024960168972,15.316355056147952
8619,C5_03530C_A,126,C5,792460,793005,545,25.849049788109184,32.25355758570093
8621,C5_03540C_A,6700,C5,793426,793743,317,2363.1216589374762,2948.622140207976
8623,C5_03550W_A,4833,C5,794502,796880,2378,227.23513625606677,283.53620782227455
8625,C5_03560W_A,291,C5,797418,797924,506,64.300301950329,80.23171098099378
8627,C5_03570W_A,584,C5,798357,798866,509,128.28196536251275,160.06583572484007
8629,C5_03580C_A,324,C5,798967,800349,1382,26.21244350024303,32.70698779364545
8631,C5_03590W_A,623,C5,801071,802807,1736,40.12442908257283,50.06588615893573
8633,C5_03600W_A,2708,C5,803133,804599,1466,206.53099146949273,257.70228620386206
8635,C5_03610W_A,650,C5,805339,807027,1688,43.05379658202474,53.72105043413147
8637,C5_03620W_A,1064,C5,807684,808682,998,119.20147430677827,148.73551048761217
8639,C5_03630C_A,170,C5,808679,809257,578,32.88452879206234,41.032186937924855
8641,C5_03640W_A,28,C5,809368,810267,899,3.4823216251438645,4.345121464394268
8643,C5_03650C_A,65,C5,810545,811666,1121,6.4830337761336105,8.08930714833309
8645,C5_03670C_A,139,C5,813516,814376,860,18.071195705963557,22.548618077748007
8647,C5_03680W_A,609,C5,816570,818933,2363,28.81536407822441,35.95482279884351
8649,C5_03690W_A,222,C5,819887,821131,1244,19.952767148109846,24.89637837680521
8651,C5_03700C_A,45,C5,821296,822195,899,5.596588326124069,6.983230924919358
8653,C5_03710C_A,185,C5,822508,823392,884,23.398607025121283,29.195979167369607
8655,C5_03720C_A,9,C5,823474,823827,353,2.8506135440144695,3.5568977912195483
8657,C5_03730W_A,10,C5,824224,825066,842,1.327878834833871,1.6568816578259444
8659,C5_03740W_A,108,C5,825581,826402,821,14.707915922588661,18.352032939836793
8661,C5_03750W_A,961,C5,829497,829922,425,252.81625735337525,315.4554531787662
8663,C5_03760C_A,681,C5,830628,833507,2879,26.446973937179973,32.999626827395346
8665,C5_03770C_A,45,C5,833913,835052,1139,4.417324763112852,5.511786305094384
8667,C5_03780C_A,116,C5,836229,836855,626,20.718303762922343,25.85158870338269
8669,C5_03790W_A,426,C5,837646,838218,572,83.26914598325716,103.90038384771043
8671,C5_03800W_A,1076,C5,838556,839140,584,206.0013015973987,257.0413573522334
8673,C5_03810C_A,235,C5,839331,840098,767,34.25650391767641,42.74409043468313
8675,C5_03820C_A,797,C5,840571,842865,2294,38.845028823335014,48.46949440470304
8677,C5_03830C_A,334,C5,843215,843910,695,53.73190057016689,67.04482228303232
8679,C5_03840W_A,117,C5,844113,845093,980,13.348434238247345,16.655718330516844
8681,C5_03850W_A,277,C5,845502,845894,392,79.006758205011,98.58192259728986
8683,C5_03860W_A,305,C5,846256,846864,608,56.08759269304053,69.98417410300671
8685,C5_03870C_A,670,C5,847034,847642,608,123.20881017815461,153.7357267180803
8687,C5_03880C_A,193,C5,848550,850904,2354,9.166876717651363,11.438114302746937
8689,C5_03890C_A,3,C5,855432,855689,257,1.3051447224865207,1.6285148123223094
8691,C5_03900W_A,3041,C5,856564,856818,254,1338.6074684749974,1670.268478842442
8693,C5_03910C_A,3,C5,857664,858137,473,0.7091378301882365,0.884837857857999
8695,C5_03920C_A,364,C5,858499,859104,605,67.26924435215926,83.93625546177819
8697,C5_03930C_A,292,C5,859535,861340,1805,18.08740176440969,22.568839441535623
8699,C5_03940C_A,289,C5,863687,865150,1463,22.086355427942895,27.558596640604897
8701,C5_03950W_A,642,C5,868673,871177,2504,28.666273740939964,35.76879299045622
8703,C5_03960W_A,1032,C5,872141,872530,389,296.62014042567694,370.11243580408933
8705,C5_03970W_A,79,C5,873670,875154,1484,5.952011073819369,7.426715236877774
8707,C5_03980W_A,917,C5,876481,878958,2477,41.39175771816389,51.647215355293554
8709,C5_03990W_A,355,C5,879343,881022,1679,23.640039459213366,29.497230276399822
8711,C5_04000W_A,282,C5,881262,882376,1114,28.30312944867986,35.31567400007392
8713,C5_04010C_A,44,C5,882395,883033,638,7.710855027104272,9.62134038544445
8715,C5_04020C_A,8,C5,889328,889642,314,2.8485961246627247,3.554380524559096
8717,C5_04030W_A,832,C5,891519,892661,1142,81.45687832485635,101.63909843257603
8719,C5_04040C_A,17,C5,896436,896792,356,5.33911731511574,6.661967429809148
8721,C5_04050W_A,1830,C5,899279,902074,2795,73.20484370097026,91.34249271118729
8723,C5_04060C_A,1012,C5,902120,909097,6977,16.2174411162001,20.235566692849623
8725,C5_04070C_A,264,C5,909565,909873,308,95.83491247972454,119.57951621909528
8727,C5_04080C_A,706,C5,910835,911500,665,118.700786334536,148.11076921172153
8729,C5_04090C_A,962,C5,912034,912363,329,326.92619079962765,407.9272858254244
8731,C5_04100W_A,1376,C5,913806,915161,1355,113.54020627364166,141.6715744430905
8733,C5_04110W_A,852,C5,916837,918357,1520,62.670988818977754,78.19870994853994
8735,C5_04120C_A,217,C5,918450,919472,1022,23.739926949886097,29.621866460666297
8737,C5_04130C_A,4019,C5,919760,921511,1751,256.62703148601656,320.21040641460195
8739,C5_04140W_A,7,C5,924645,925907,1262,0.6201678171561676,0.7738241276724339
8741,C5_04150C_A,157,C5,926574,927257,683,25.70096847613891,32.068786804486514
8743,C5_04160W_A,179,C5,927500,927886,386,51.8485083493501,64.69479007881105
8745,C5_04170W_A,939,C5,928229,929836,1607,65.33114288832496,81.5179589408954
8747,C5_04180W_A,191,C5,930400,931917,1517,14.077266313490627,17.565129991752407
8749,C5_04190W_A,89,C5,933743,934489,746,13.338952295547001,16.64388708768909
8751,C5_04200W_A,4,C5,936262,936849,587,0.7618902752505072,0.9506605491580546
8753,C5_04210C_A,2,C5,937203,937973,770,0.2904088256961349,0.3623621703608948
8755,C5_04220W_A,5,C5,939282,939923,641,0.8721325888690479,1.0882171262788183
8757,C5_04230W_A,2,C5,940661,941251,590,0.37900812845088794,0.4729133409794729
8759,C5_04240C_A,2,C5,942315,942626,311,0.7190186359679225,0.8971667883533408
8761,C5_04250W_A,275,C5,943001,943615,614,50.07660329084411,62.48386773120478
8763,C5_04260W_A,503,C5,944238,945479,1241,45.317583513444816,56.5457261089759
8765,C5_04270C_A,14148,C5,945967,947319,1352,1170.0081844603055,1459.8960759707004
8767,C5_04280C_A,2062,C5,947806,949854,2048,112.57170627704622,140.4631133712908
8769,C5_04290C_A,1022,C5,952051,953346,1295,88.23718968853916,110.09933835668053
8771,C5_04300C_A,1843,C5,954129,955433,1304,158.0222655803842,197.1747621092214
8773,C5_04310W_A,178,C5,956328,957911,1583,12.57215213200008,15.687100148346255
8775,C5_04320C_A,908,C5,958126,960237,2111,48.09148142437463,60.006900764927344
8777,C5_04330W_A,433,C5,960735,961004,269,179.97250292815679,224.56351527885866
8779,C5_04340W_A,434,C5,961458,962357,899,53.975985189729904,67.34938269811114
8781,C5_04350C_A,889,C5,962394,963245,851,116.79997265204186,145.7389991052546
8783,C5_04360C_A,1065,C5,963406,964269,863,137.9778432862778,172.16401958542977
8785,C5_04370C_A,306,C5,965156,965782,626,54.65345647805377,68.1947081313371
8787,C5_04380C_A,20,C5,966890,968029,1139,1.9632554502723782,2.4496828022641703
8789,C5_04390C_A,33,C5,970181,970636,455,8.109107979053615,10.11826675700037
8791,C5_04400W_A,136,C5,971596,972795,1199,12.682073489115618,15.824256246952839
8793,C5_04410C_A,678,C5,973063,974205,1142,66.37952344261129,82.82609223231556
8795,C5_04420W_A,769,C5,974657,975694,1037,82.91213980687192,103.45492378775153
8797,C5_04430C_A,796,C5,975716,976726,1010,88.11751358696783,109.95001062257408
8799,C5_04440C_A,826,C5,977029,977940,911,101.37531356709975,126.49263863498153
8801,C5_04460C_A,10,C5,979414,979596,182,6.143263620495162,7.6653536037881596
8803,C5_04470C_A,4485,C5,979898,980725,827,606.3557189240129,756.5898653161017
8805,C5_04480C_A,38,C5,981163,981432,269,15.79435360570429,19.707652611077663
8807,C5_04490C_A,2295,C5,981844,982797,953,269.2528627119228,335.9644854948873
8809,C5_04500W_A,1,C5,983105,983407,302,0.3702231718311654,0.4619517734733262
8811,C5_04510W_A,1050,C5,984134,987622,3488,33.6576169116005,41.99681977304809
8813,C5_04520W_A,299,C5,987850,989031,1181,28.306868729898877,35.320339746904665
8815,C5_04530W_A,864,C5,989261,990049,788,122.59085251213493,152.96466034117773
8817,C5_04540C_A,132,C5,990125,991027,902,16.36205822824565,20.41601496423578
8819,C5_04550W_A,522,C5,991257,992165,908,64.27694019840554,80.20256098835797
8821,C5_04560C_A,620,C5,992382,992483,101,686.3424425115586,856.3945551004515
8823,C5_04570C_A,3237,C5,993708,995429,1721,210.29665716425316,262.40095467833436
8825,C5_04580C_A,202,C5,996127,996717,590,38.279820973539685,47.76424743892676
8827,C5_04590C_A,5076,C5,997099,997750,651,871.7885586865264,1087.787857218867
8829,C5_04600C_A,2660,C5,998235,1000577,2342,126.98876105696489,158.4522197551633
8831,C5_04610W_A,310,C5,1002086,1003516,1430,24.237967375408186,30.243304218582374
8833,C5_04620C_A,440,C5,1003656,1004540,884,55.65074103272087,69.43908558725744
8835,C5_04630W_A,136,C5,1004884,1005222,338,44.98759205162611,56.1339740831256
8837,C5_04640C_A,2567,C5,1005350,1009294,3944,72.77119431829657,90.80139988763197
8839,C5_04650C_A,566,C5,1010220,1011953,1733,36.516438088542856,45.56395876707594
8841,C5_04660C_A,559,C5,1012145,1012900,755,82.78190122144859,103.29241654863573
8843,C5_04670W_A,1343,C5,1013409,1015016,1607,93.43953663367459,116.5906484106736
8845,C5_04680W_A,1868,C5,1015777,1018989,3212,65.02372953429213,81.13437910340856
8847,C5_04690C_A,48,C5,1019083,1019319,236,22.740487707053276,28.374800458768377
8849,C5_04700C_A,3621,C5,1020159,1022405,2246,180.2558271463029,224.91703751895284
8851,C5_04710W_A,321,C5,1022682,1024034,1352,26.54598722163967,33.12317220713845
8853,C5_04720C_A,598,C5,1024374,1025190,816,81.937284240222,102.23853245366277
8855,C5_04730C_A,4588,C5,1025651,1029475,3824,134.14548680259904,167.38213663234242
8857,C5_04740C_A,634,C5,1031038,1032462,1424,49.7794173203438,62.11304927204411
8859,C5_04750C_A,2324,C5,1032682,1034379,1697,153.1174971734589,191.05476034691046
8861,C5_04760W_A,2,C5,1035099,1035171,72,3.1057610525836647,3.8752620996929035
8863,C5_04770W_A,479,C5,1035440,1036315,875,61.2065641037174,76.3714510252622
8865,C5_04780W_A,683,C5,1036647,1038047,1400,54.54603768637654,68.06067464803506
8867,C5_04790C_A,186,C5,1038042,1038692,650,31.994116935538802,39.92116156852874
8869,C5_04800W_A,306,C5,1039131,1040645,1514,22.597796403739537,28.19675514545378
8871,C5_04810W_A,6776,C5,1041193,1044156,2963,255.68914212725244,319.0401402466041
8873,C5_04820W_A,1,C5,1051679,1051990,311,0.35950931798396124,0.4485833941766704
8875,C5_04830W_A,484,C5,1053827,1055971,2144,25.240102882564265,31.49373452660874
8877,C5_04840C_A,231,C5,1058090,1058830,740,34.90203907200779,43.54956705546782
8879,C5_04850W_A,50,C5,1059037,1059795,758,7.375158172362266,9.202469366025364
8881,C5_04860C_A,92,C5,1059960,1060479,519,19.819423133250673,24.729996289369737
8883,C5_04870W_A,360,C5,1061084,1061869,785,51.27473024392905,63.978849442063726
8885,C5_04880C_A,1850,C5,1062043,1063830,1787,115.74912484727034,144.4277872633169
8887,C5_04890C_A,294,C5,1064216,1065337,1121,29.32326046435817,36.58855848630659
8889,C5_04900C_A,625,C5,1065586,1066695,1109,63.011382942409796,78.6234420586928
8891,C5_04910W_A,213,C5,1066921,1067634,713,33.40108801011437,41.67673180988104
8893,C5_04920C_A,1878,C5,1067875,1073664,5789,36.271254662821974,45.258027299367384
8895,C5_04930C_A,80,C5,1074184,1075950,1766,5.064887786772908,6.319793231662265
8897,C5_04940W_A,344,C5,1078889,1080637,1748,22.003286541874207,27.45494613420876
8899,C5_04950C_A,543,C5,1080794,1083001,2207,27.508571389173305,34.32425171037466
8901,C5_04960W_A,3725,C5,1088502,1091030,2528,164.7478469744737,205.5667118547541
8903,C5_04970C_A,172,C5,1091679,1094261,2582,7.4480528418272876,9.29342483396532
8905,C5_04980W_A,96,C5,1095645,1097372,1727,6.215118817445945,7.7550120535834814
8907,C5_04990W_A,55,C5,1097648,1098139,491,12.524250273147977,15.627329852122095
8909,C5_05000C_A,1089,C5,1098208,1100409,2201,55.3195167221672,69.02579525504797
8911,C5_05010W_A,60,C5,1100839,1101153,314,21.364470934970438,26.65785393419322
8913,C5_05020C_A,684,C5,1101230,1102420,1190,64.26576483934468,80.18861675868743
8915,C5_05030C_A,441,C5,1102463,1104616,2153,22.901561760714475,28.57578313735463
8917,C5_05040W_A,222,C5,1104724,1106172,1448,17.14174194216067,21.388877555763592
8919,C5_05050W_A,23632,C5,1107880,1108932,1052,2511.6277823266714,3133.9229865379625
8921,C5_05060C_A,49,C5,1109074,1109559,485,11.296005147953784,14.094767719295424
8923,C5_05070W_A,447,C5,1109829,1112132,2303,21.701218783402666,27.078036347485106
8925,C5_05080W_A,890,C5,1119031,1121088,2057,48.37558780981071,60.36139896653408
8927,C5_05090W_A,103,C5,1121545,1122810,1265,9.103685362039709,11.359266296965442
8929,C5_05100C_A,426,C5,1122899,1124587,1688,28.216795913757757,35.20794997683078
8931,C5_05110C_A,701,C5,1125159,1127513,2354,33.29523616100313,41.544653503759605
8933,C5_05120W_A,3065,C5,1127776,1129365,1589,215.6637347653125,269.09780999377904
8935,C5_05130C_A,238,C5,1129420,1130145,725,36.703669929016336,45.797580234715575
8937,C5_05140W_A,385,C5,1130266,1131324,1058,40.686056889234024,50.76666606970098
8939,C5_05150C_A,297,C5,1131319,1132620,1301,25.52405624459996,31.84804179086589
8941,C5_05160C_A,688,C5,1132798,1133319,521,147.64585364758585,184.22743125756972
8943,C5_05170W_A,716,C5,1133822,1135915,2093,38.24849349803944,47.72515808967237
8945,C5_05180W_A,11,C5,1137147,1138370,1223,1.0056266368136806,1.2547864198515042
8947,C5_05190W_A,687,C5,1139258,1140172,914,84.03903977297506,104.86103090766397
8949,C5_05200C_A,1561,C5,1140239,1141543,1304,133.8430583673249,167.0047768054773
8951,C5_05210W_A,718,C5,1141882,1143330,1448,55.44040862374487,69.17664002269485
8953,C5_05220W_A,665,C5,1143525,1144814,1289,57.68186159724821,71.97344815100706
8955,C5_05230C_A,8298,C5,1144905,1146224,1319,703.3948352662723,877.6719458052021
8957,C5_05240C_A,77,C5,1146493,1147437,944,9.119883090849491,11.379477267318569
8959,C5_05250C_A,1670,C5,1147626,1148381,755,247.3090787832185,308.5837846801819
8961,C5_05260W_A,128,C5,1148532,1149152,620,23.082817629525046,28.801947992556283
8963,C5_05270C_A,1085,C5,1149197,1150108,911,133.16248816017338,166.1555846476452
8965,C5_05280C_A,444,C5,1150249,1150743,494,100.49085964473137,125.38904737144001
8967,C5_05290C_A,1061,C5,1150915,1151262,347,341.86642410514605,426.56919642613866
8969,C5_05300W_A,690,C5,1151677,1152390,713,108.20070763839864,135.0091312151076
8971,C5_05310W_A,1455,C5,1152535,1153125,590,275.728413448021,344.04445556256655
8973,C5_05320C_A,2312,C5,1153178,1154074,896,288.50301777750406,359.9841686179014
8975,C5_05330C_A,726,C5,1154306,1155292,986,82.32471690702504,102.72195764459809
8977,C5_05340W_A,1555,C5,1155735,1156982,1247,139.4230182226412,173.96725929495486
8979,C5_05350W_A,1036,C5,1157179,1158453,1274,90.9203015833284,113.44723333606477
8981,C5_05360C_A,2091,C5,1158484,1161177,2693,86.81369067741849,108.3231451230906
8983,C5_05370C_A,1057,C5,1161357,1164347,2990,39.52522393742931,49.318218534285734
8985,C5_05380W_A,2174,C5,1164505,1165881,1376,176.64918824084882,220.4167972168353
8987,C5_05390C_A,1985,C5,1165900,1167255,1355,163.79164931190311,204.3736012133246
8989,C5_05400W_A,1225,C5,1168093,1169409,1316,104.0760352727505,129.8625065322622
8991,C5_05410C_A,4857,C5,1169457,1171226,1769,306.9805153003726,383.0397561647843
8993,C5_05430W_A,1069,C5,1172085,1172609,524,228.09562661761404,284.60989817668263
8995,C5_05440C_A,8009,C5,1172634,1174892,2258,396.5746012954529,494.83218318505607
8997,C5_05450C_A,624,C5,1175166,1175846,680,102.5997298312345,128.02042324632555
8999,C5_05460C_A,78,C5,1175896,1176357,461,18.917520684717857,23.604633353443976
9001,C5_05470W_A,1276,C5,1176356,1178194,1838,77.62036981038263,96.85203471789619
9003,C5_05480W_A,2313,C5,1178288,1179400,1112,232.56340946630993,290.18464435002574
9005,C5_05490C_A,3390,C5,1179397,1180902,1505,251.84523512113657,314.2438449478551
9007,C5_05500C_A,1061,C5,1182110,1182868,758,156.50085641752727,195.27639994705822
9009,C5_05510C_A,1,C5,1188747,1189058,311,0.35950931798396124,0.4485833941766704
9011,C6_00010W_A,1,C6,5,346,341,0.32788093223757164,0.40911857943972
9013,C6_00020W_A,145,C6,3622,4008,386,42.000188327685834,52.40639419791957
9015,C6_00030W_A,97,C6,5545,6069,524,20.697170984011752,25.82521994680843
9017,C6_00060W_A,1,C6,6928,7038,110,1.0164308899364722,1.268267596263132
9019,C6_00070C_A,997,C6,7276,9894,2618,42.57905870868331,53.12868880144296
9021,C6_00080C_A,598,C6,10260,11345,1085,61.622879207392764,76.89091473012795
9023,C6_00090W_A,233,C6,11580,11948,368,70.79109703552115,88.33070242452193
9025,C6_00100C_A,1868,C6,11950,12543,593,352.20273063093816,439.46648512672573
9027,C6_00110C_A,308,C6,12648,13433,785,43.86838031980596,54.73746007821008
9029,C6_00120W_A,95,C6,13533,13778,245,43.353888978922996,54.09549543244787
9031,C6_00130C_A,4862,C6,13792,16029,2237,243.00740659625575,303.21630569219855
9033,C6_00140C_A,70,C6,16129,16587,458,17.088466926879555,21.322402819270994
9035,C6_00150W_A,6192,C6,17283,18128,845,819.303441128438,1022.2987280079816
9037,C6_00160W_A,620,C6,18356,18682,326,212.63983648364237,265.32469345136684
9039,C6_00170C_A,2381,C6,18679,20661,1982,134.3155471156718,167.5943320571528
9041,C6_00180C_A,33,C6,20920,21525,605,6.098585339618833,7.609605577578792
9043,C6_00190W_A,776,C6,21616,22845,1229,70.5960461879392,88.08732466803983
9045,C6_00200C_A,689,C6,22858,23190,332,232.03402755507605,289.5240997613939
9047,C6_00210W_A,906,C6,23379,24626,1247,81.23296109949385,101.35970220014734
9049,C6_00220C_A,1,C6,24672,24754,82,1.363504852353804,1.7013345803529818
9051,C6_00230W_A,247,C6,24834,25922,1088,25.382745661373118,31.67171929271075
9053,C6_00240C_A,376,C6,25917,26810,893,47.076799112847134,58.74081498481874
9055,C6_00250W_A,672,C6,26954,28600,1646,45.64676268779103,56.95646459038318
9057,C6_00260W_A,1014,C6,28770,29879,1109,102.22966768576566,127.5586723960232
9059,C6_00270W_A,212,C6,30052,30744,692,34.25313345855279,42.739884891410746
9061,C6_00280W_A,3046,C6,32516,35077,2561,132.98138773218054,165.9296137461636
9063,C6_00290W_A,1973,C6,39723,41777,2054,107.39824539577047,134.00784635685858
9065,C6_00300C_A,2403,C6,43796,46627,2831,94.90398344645274,118.41793490647602
9067,C6_00310W_A,1704,C6,47121,49541,2420,78.72719256598859,98.23309018328986
9069,C6_00320C_A,1399,C6,49594,53874,4280,36.54639010568311,45.60133186657321
9071,C6_00330C_A,5760,C6,54332,56071,1739,370.33387686242025,462.0899074136402
9073,C6_00340C_A,3399,C6,57603,59954,2351,161.64753102439286,201.69824396717243
9075,C6_00350W_A,1459,C6,60860,63445,2585,63.105219932651615,78.74052863608127
9077,C6_00360C_A,414,C6,63637,64182,545,84.93259216093017,105.97597492444592
9079,C6_00370C_A,4734,C6,64428,65978,1550,341.48143330678613,426.08881811487953
9081,C6_00380C_A,218,C6,66443,67438,995,24.496495216760405,30.56588639034161
9083,C6_00390W_A,769,C6,67494,68984,1490,57.7046234763263,72.00184964288479
9085,C6_00400C_A,210,C6,69031,70365,1334,17.600864735781492,21.961755227644936
9087,C6_00410C_A,1661,C6,70595,73825,3230,57.4960024459111,71.74153947778231
9089,C6_00420W_A,275,C6,74105,74448,343,89.64149976844982,111.85158830017416
9091,C6_00430C_A,447,C6,74582,76120,1538,32.49538807423689,40.54663049951768
9093,C6_00440C_A,2128,C6,76654,78531,1877,126.75873346634492,158.1651992185796
9095,C6_00450C_A,2,C6,78916,79317,401,0.5576428822594112,0.6958076587977282
9097,C6_00460C_A,154,C6,80175,82049,1874,9.188014554708559,11.464489370703017
9099,C6_00470C_A,9,C6,83656,85536,1880,0.5352481814027169,0.667864319308777
9101,C6_00480C_A,1005,C6,87450,89309,1859,60.44455883941744,75.42064699671288
9103,C6_00490W_A,267,C6,92659,94050,1391,21.461233096645714,26.778590440149664
9105,C6_00500C_A,192,C6,94193,95188,995,21.57489486980733,26.920413701585275
9107,C6_00510C_A,877,C6,95673,97367,1694,57.883759121706895,72.22536895602381
9109,C6_00520W_A,66,C6,97678,97992,314,23.50091802846748,29.323639327612543
9111,C6_00530C_A,68,C6,98053,98313,260,29.24193483355697,36.487083154031644
9113,C6_00540W_A,496,C6,98512,100356,1844,30.074007242371977,37.525314561885295
9115,C6_00550W_A,2764,C6,100547,101452,905,341.4758538964475,426.08185631805816
9117,C6_00560W_A,411,C6,101799,103787,1988,23.115110932609614,28.842242468338124
9119,C6_00570C_A,1173,C6,103938,105929,1991,65.87146043621448,82.19214864180407
9121,C6_00580W_A,5,C6,107349,107708,359,1.5572060987884673,1.943028350820954
9123,C6_00590W_A,810,C6,107872,109443,1571,57.6473534648884,71.93039008723429
9125,C6_00600C_A,1704,C6,109686,110591,905,210.5191226626435,262.678539495648
9127,C6_00610C_A,17,C6,111167,111499,332,5.725077602955431,7.143555436783303
9129,C6_00620W_A,537,C6,112252,112774,522,115.0202541543054,143.51832741621303
9131,C6_00630W_A,58,C6,112915,113313,398,16.29354039646908,20.330520764218043
9133,C6_00640C_A,340,C6,113323,114414,1091,34.84373536537495,43.476817690413505
9135,C6_00650C_A,4964,C6,114676,115535,859,646.1139966716081,806.1988803999076
9137,C6_00660C_A,201,C6,115818,116422,604,37.20742876903212,46.42615323406928
9139,C6_00670W_A,518,C6,116838,118541,1703,34.00835708078696,42.434461324176894
9141,C6_00680C_A,189,C6,118692,119232,540,39.132589262554184,48.82830245613058
9143,C6_00690W_A,435,C6,119448,120974,1526,31.871702544862515,39.76841709121289
9145,C6_00700C_A,315,C6,121065,121958,893,39.43933968230544,49.21105510696251
9147,C6_00710W_A,378,C6,122466,124409,1943,21.751516419741904,27.14079601267165
9149,C6_00720C_A,2803,C6,124508,125947,1439,217.78744704246873,271.74770532023035
9151,C6_00730W_A,168,C6,126536,128452,1916,9.803571422769316,12.232560114270708
9153,C6_00740W_A,1329,C6,129790,131742,1952,76.12296711055987,94.98362699677625
9155,C6_00750C_A,5756,C6,131977,133230,1253,513.6180225635889,640.8749491220786
9157,C6_00760W_A,302,C6,134254,135108,854,39.53844749846558,49.33471844011855
9159,C6_00770C_A,375,C6,135141,136989,1848,22.68818950751054,28.30954455944491
9161,C6_00780W_A,994,C6,137336,140659,3323,33.44464444948958,41.731080040749575
9163,C6_00790C_A,5991,C6,140815,141570,755,887.2028089762047,1107.021229951479
9165,C6_00800C_A,3294,C6,142324,144471,2147,171.53869057269742,214.0400935398152
9167,C6_00810C_A,17,C6,149369,150541,1172,1.6217796622706513,2.023601028167284
9169,C6_00820W_A,2426,C6,158273,159529,1256,215.9591937009928,269.46647351813647
9171,C6_00830C_A,108,C6,159840,161719,1879,6.426396472828787,8.018637064186272
9173,C6_00840W_A,131,C6,165020,165511,491,29.830487014225184,37.22145837505444
9175,C6_00850W_A,1527,C6,167136,167621,485,352.02040532500877,439.23898586457375
9177,C6_00860W_A,55,C6,169118,169807,689,8.92511884487033,11.136457122484684
9179,C6_00870C_A,7373,C6,170116,171318,1202,685.8202534652055,855.7429855218701
9181,C6_00880W_A,883,C6,172250,173392,1142,86.4500283183271,107.86937970668828
9183,C6_00890W_A,3753,C6,174611,176875,2264,185.34150366275347,231.262770214359
9185,C6_00900C_A,183,C6,176941,177840,899,22.759459192904547,28.398472428005388
9187,C6_00910C_A,4159,C6,178343,181033,2690,172.86504380558986,215.6950716038737
9189,C6_00920W_A,3668,C6,182690,183145,455,901.3396383990502,1124.6606807477988
9191,C6_00930C_A,696,C6,183350,184084,734,106.01900399664349,132.2868762532771
9193,C6_00940C_A,189,C6,184756,185646,890,23.74336876604411,29.62616104079833
9195,C6_00950C_A,2832,C6,186531,188873,2342,135.20006440350548,168.69800238594829
9197,C6_00960W_A,1108,C6,191051,192766,1715,72.2347503588672,90.13204351752218
9199,C6_00970C_A,471,C6,192961,193944,983,53.572008553009795,66.84531450904666
9201,C6_00980C_A,47,C6,194243,195295,1052,4.995197434383613,6.232836000646761
9203,C6_00990W_A,133,C6,195918,196958,1040,14.29844607670249,17.841110512816943
9205,C6_01000C_A,428,C6,197030,198280,1250,38.282853038567296,47.7680307456546
9207,C6_01010W_A,30,C6,198680,199057,377,8.897140415889545,11.10154659858975
9209,C6_01020W_A,10,C6,199256,200110,854,1.3092201158432313,1.6335999483482964
9211,C6_01030W_A,325,C6,200518,201594,1076,33.770821854301936,42.13807301710685
9213,C6_01040C_A,911,C6,201650,204145,2495,40.824264320855264,50.939116561734856
9215,C6_01050W_A,882,C6,204367,205872,1505,65.52433550939304,81.7590180660791
9217,C6_01060C_A,888,C6,205994,207700,1706,58.19752012250563,72.61686916939198
9219,C6_01070C_A,198,C6,209410,210309,899,24.624988634945904,30.726216069645176
9221,C6_01080C_A,143,C6,211793,212791,998,16.020498896493695,19.989828947113292
9223,C6_01090C_A,79,C6,212992,213913,921,9.590428266610145,11.966607395794371
9225,C6_01100W_A,1134,C6,214553,216145,1592,79.64170176549972,99.3741833906175
9227,C6_01110W_A,1249,C6,218197,219507,1310,106.60109921249764,133.01319469510815
9229,C6_01120C_A,26,C6,219755,220552,797,3.6474182499602392,4.55112336927548
9231,C6_01130W_A,15,C6,220839,221612,773,2.1696131544568944,2.70716886653838
9233,C6_01140C_A,54,C6,221639,222187,548,11.017517310625266,13.747280149275555
9235,C6_01150W_A,449,C6,224375,226279,1904,26.36634540649284,32.89902131272904
9237,C6_01160W_A,147,C6,226945,227577,632,26.005834636507522,32.449188341099436
9239,C6_01170W_A,536,C6,228067,229164,1097,54.62968575264759,68.16504783561919
9241,C6_01180C_A,194,C6,229417,230640,1223,17.735597049259457,22.129869586471983
9243,C6_01190C_A,328,C6,232244,236857,4613,7.949886518297835,9.919595680289138
9245,C6_01200W_A,62,C6,237060,237734,674,10.284953515380922,12.833212175837625
9247,C6_01210W_A,490,C6,237854,238266,412,132.9748178824657,165.92141611306505
9249,C6_01220C_A,615,C6,238369,240150,1781,38.60839399449879,48.17422958293143
9251,C6_01250W_A,257,C6,242012,242335,323,88.96130420589496,111.00286361101777
9253,C6_01260W_A,532,C6,244222,244632,410,145.07691629044479,181.02199934955726
9255,C6_01280W_A,406,C6,245451,247826,2375,19.113180439815935,23.84877088383641
9257,C6_01290C_A,269,C6,247958,250051,2093,14.36989490359303,17.930261907991436
9259,C6_01300W_A,133,C6,251632,252873,1241,11.982581724230934,14.951454418476729
9261,C6_01310W_A,19,C6,253187,253984,797,2.665421028817098,3.3258209237013117
9263,C6_01320W_A,2384,C6,254510,265975,11465,23.248917276662926,29.00920143428205
9265,C6_01330C_A,61,C6,266126,266865,739,9.229027430952272,11.515663830751848
9267,C6_01340C_A,99,C6,267237,267944,707,15.656198573420344,19.53526750113933
9269,C6_01350W_A,577,C6,268142,270265,2123,30.387597072194012,37.91660119398068
9271,C6_01360W_A,5,C6,272338,272679,341,1.6394046611878583,2.0455928971986
9273,C6_01370W_A,248,C6,274059,275504,1445,19.18908974219167,23.94348790730674
9275,C6_01380C_A,17,C6,275554,276168,614,3.0956445670703636,3.8626390961108417
9277,C6_01390W_A,417,C6,276517,277704,1187,39.27858881329906,49.010475687101824
9279,C6_01400W_A,59,C6,278810,280840,2030,3.2495746185653718,4.054707733865875
9281,C6_01410C_A,258,C6,281102,282313,1211,23.820238362012454,29.722076285671083
9283,C6_01420C_A,1337,C6,282711,283952,1241,120.4564794383215,150.30146283837132
9285,C6_01430C_A,853,C6,284857,285648,791,120.5710624560546,150.4444355971804
9287,C6_01440C_A,40,C6,287462,288292,830,5.388308332193347,6.723346293443109
9289,C6_01450C_A,86,C6,289441,290394,953,10.089649757396671,12.589518846431508
9291,C6_01460C_A,673,C6,292746,293900,1154,65.20483429982411,81.36035541712276
9293,C6_01470W_A,133,C6,294635,296263,1628,9.134142456861541,11.397269615067334
9295,C6_01480W_A,55,C6,296921,297466,545,11.283315383698453,14.078933866774216
9297,C6_01490C_A,92,C6,297609,298052,443,23.219595047758688,28.97261416294107
9299,C6_01500C_A,157,C6,298211,301176,2965,5.920324272918339,7.387177533714768
9301,C6_01510W_A,130,C6,304773,305993,1220,11.913903054173405,14.865759529969496
9303,C6_01520W_A,343,C6,306695,308335,1640,23.384108217867745,29.17788805305364
9305,C6_01530C_A,8,C6,310350,310466,116,7.710855027104271,9.62134038544445
9307,C6_01540C_A,10,C6,310465,310526,61,18.329081621805237,22.87039927687615
9309,C6_01550C_A,1002,C6,314026,317713,3687,30.385411632437748,37.91387427722332
9311,C6_01560W_A,410,C6,319706,320740,1034,44.33368775254825,55.31805473062597
9313,C6_01570C_A,436,C6,321477,324401,2924,16.671691341092068,20.80236454062237
9315,C6_01590W_A,1983,C6,328457,329938,1481,149.70565160151432,186.79757648404927
9317,C6_01600W_A,63,C6,330122,330472,350,20.12533162074215,25.111698406010014
9319,C6_01610W_A,6372,C6,331191,332384,1193,597.1808376984678,745.1417632629962
9321,C6_01620W_A,376,C6,334854,336653,1799,23.368305507377702,29.15816997300897
9323,C6_01630W_A,3085,C6,337224,338591,1367,252.3232059253415,314.84024052077086
9325,C6_01640W_A,160,C6,339591,340175,584,30.632163806304643,38.22176317505329
9327,C6_01650C_A,985,C6,340292,347998,7706,14.291498432989458,17.83244148132758
9329,C6_01660C_A,1,C6,348429,348812,383,0.29192532086948286,0.3642544010155209
9331,C6_01670W_A,335,C6,350639,352531,1892,19.796764426088266,24.70172353186914
9333,C6_01680C_A,143,C6,352702,353787,1085,14.735905897420007,18.386957870247986
9335,C6_01690W_A,1160,C6,354147,356351,2204,58.84599889105892,73.42601873102342
9337,C6_01700W_A,6380,C6,356945,357782,837,852.247549053066,1063.405255743687
9339,C6_01710C_A,2532,C6,358106,360544,2438,116.1182655722339,144.8883883967217
9341,C6_01720C_A,1841,C6,364197,365009,812,253.49435901605298,316.30156517148623
9343,C6_01730W_A,13,C6,365969,366277,308,4.719143417562193,5.888385268364541
9345,C6_01740C_A,1567,C6,366437,368230,1793,97.71455242518111,121.92486646284219
9347,C6_01750C_A,188,C6,368561,369448,887,23.697622101337366,29.569079921895792
9349,C6_01760W_A,2390,C6,369850,372375,2525,105.82957661952418,132.05051527032768
9351,C6_01770W_A,282,C6,372715,373851,1136,27.755005462877964,34.631743693734464
9353,C6_01780C_A,184,C6,374139,375542,1403,14.66326529744419,18.296319421500918
9355,C6_01790C_A,355,C6,376564,378156,1592,24.931926037700528,31.109202031454334
9357,C6_01800W_A,1,C6,378683,378755,72,1.5528805262918324,1.9376310498464517
9359,C6_01810W_A,32,C6,378946,380427,1481,2.4158249375937757,3.014383483353291
9361,C6_01820C_A,654,C6,380495,381680,1185,61.70636136880154,76.9950809073162
9363,C6_01830W_A,603,C6,381840,382496,656,102.774178246168,128.238093994106
9365,C6_01840C_A,677,C6,382542,383525,983,77.00265348277628,96.08126947478681
9367,C6_01850W_A,1632,C6,383676,385970,2294,79.54214183147145,99.2499559202953
9369,C6_01860C_A,555,C6,386043,386584,541,114.70075014902335,143.11966127886174
9371,C6_01870C_A,201,C6,386807,388339,1532,14.669247373691515,18.303783651029924
9373,C6_01880W_A,164,C6,389289,389918,629,29.151690388639043,36.37447923145771
9375,C6_01890C_A,966,C6,390049,391773,1724,62.648460768358206,78.17060021979141
9377,C6_01900C_A,493,C6,392015,392737,722,76.34494066655803,95.26059798524881
9379,C6_01910W_A,4114,C6,393707,394456,749,614.1196728062099,766.2774606313989
9381,C6_01920C_A,760,C6,394669,396216,1547,54.92800413619203,68.53727928092944
9383,C6_01930W_A,2273,C6,397028,397942,914,278.050563906801,346.9419552447165
9385,C6_01940W_A,88,C6,398675,398908,233,42.22768675787576,52.690258934880326
9387,C6_01950C_A,1003,C6,399034,400629,1595,70.30897811077806,87.72913096909802
9389,C6_01960W_A,499,C6,400918,402603,1685,33.110914865645675,41.31466371447081
9391,C6_01970C_A,8120,C6,402753,403626,873,1039.9496802878086,1297.6135360621186
9393,C6_01980C_A,2133,C6,403985,404632,647,368.60151422843046,459.92832474686037
9395,C6_01990W_A,50,C6,405913,407730,1817,3.0767032992023102,3.839004831836668
9397,C6_02000W_A,277,C6,409352,411181,1829,16.933105093692898,21.128547653437742
9399,C6_02010C_A,18605,C6,411489,412604,1115,1865.6292715690468,2327.8682054998317
9401,C6_02020C_A,2312,C6,414633,415973,1340,192.90948054376392,240.7058321504774
9403,C6_02030C_A,1264,C6,416245,417378,1133,124.7348198912331,155.63982928899017
9405,C6_02040W_A,4332,C6,417949,418854,905,535.1929808536219,667.795441957246
9407,C6_02050W_A,604,C6,419022,420419,1397,48.34049271823852,60.31760851519147
9409,C6_02060W_A,2365,C6,422258,424654,2396,110.36080802043958,137.70443037055668
9411,C6_02070C_A,2682,C6,424970,425898,928,323.13301847958843,403.19429552753144
9413,C6_02080W_A,1,C6,425509,425817,308,0.3630110321201686,0.4529527129511185
9415,C6_02090C_A,1396,C6,426472,429609,3137,49.75553951502859,62.08325536568904
9417,C6_02100W_A,139,C6,434385,434888,503,30.89707416924187,38.55230923829679
9419,C6_02110W_A,94,C6,436350,437441,1091,9.63326801278013,12.020061361467263
9421,C6_02120W_A,6093,C6,437978,442957,4979,136.82315231213533,170.72323579904375
9423,C6_02130C_A,35,C6,443134,444234,1100,3.5575081147776526,4.438936586920962
9425,C6_02140W_A,597,C6,444603,447512,2909,22.94569148921558,28.630846698728046
9427,C6_02150C_A,70,C6,447639,449000,1361,5.750564182594295,7.175356716551151
9429,C6_02160W_A,114,C6,449471,451141,1670,7.6323612932954275,9.523398597089624
9431,C6_02170C_A,111,C6,451184,452335,1151,10.78246843277526,13.453994222739219
9433,C6_02180W_A,208,C6,453038,453583,545,42.67144726925961,53.243968077982494
9435,C6_02190C_A,433,C6,454198,455418,1220,39.68246171120834,49.514414434436866
9437,C6_02200C_A,353,C6,458121,458522,401,98.4239687187861,122.81005177779903
9439,C6_02210W_A,647,C6,460066,460428,362,199.83255921762077,249.34421222664946
9441,C6_02220W_A,774,C6,461384,462114,730,118.54647393039899,147.91822348745626
9443,C6_02230W_A,1187,C6,463058,465112,2054,64.61313597809405,80.62205454920989
9445,C6_02240C_A,7827,C6,465254,465907,653,1340.1477845461018,1672.1904323961235
9447,C6_02250W_A,125,C6,466317,467456,1139,12.270346564202365,15.310517514151066
9449,C6_02260C_A,2119,C6,467667,470486,2819,84.04394329027751,104.86714934834104
9451,C6_02270C_A,172,C6,470964,472793,1829,10.514419047347214,13.119531394914409
9453,C6_02280W_A,477,C6,474133,475320,1187,44.93018432600396,56.06234269244021
9455,C6_02290C_A,979,C6,475632,478013,2381,45.97204642472016,57.362342478612625
9457,C6_02300C_A,102,C6,478575,478916,341,33.44385508823232,41.73009510285144
9459,C6_02310W_A,523,C6,479401,481050,1649,35.46104857370846,44.24707993512309
9461,C6_02320C_A,547,C6,481253,482839,1586,38.56156787356717,48.11580155558175
9463,C6_02330W_A,226,C6,486452,487012,560,45.122271292536965,56.30202221982403
9465,C6_02340W_A,1966,C6,489805,491106,1301,168.9572207975876,210.81902411058024
9467,C6_02350C_A,699,C6,491416,493362,1946,40.16103346722269,50.111559854405044
9469,C6_02360W_A,146,C6,493517,494062,545,29.952073563999534,37.373169900891554
9471,C6_02370C_A,360,C6,494226,495677,1451,27.739947099575677,34.61295438457617
9473,C6_02380W_A,1822,C6,496005,497672,1667,122.20340669530161,152.48121874208573
9475,C6_02390W_A,1,C6,497760,497843,83,1.3470770830483365,1.6808365733607773
9477,C6_02400W_A,2,C6,498068,498158,90,2.484608842066932,3.100209679754322
9479,C6_02410W_A,867,C6,499151,500542,1391,69.68872320146755,86.95519817082307
9481,C6_02420W_A,581,C6,501489,502706,1217,53.37723761367292,66.60228601247063
9483,C6_02430W_A,2332,C6,503335,507153,3818,68.29095125366786,85.21110628428984
9485,C6_02440C_A,239,C6,507225,508085,860,31.072055926081223,38.77064547181132
9487,C6_02450W_A,546,C6,508862,509665,803,76.02346108291971,94.8594667889959
9489,C6_02460C_A,1031,C6,509769,510749,980,117.62594615070952,146.7696205022467
9491,C6_02470W_A,606,C6,511041,512948,1907,35.529776152682345,44.332835850498356
9493,C6_02480W_A,1100,C6,514254,515363,1109,110.90003397864125,138.37725802329933
9495,C6_02490C_A,1179,C6,515648,516388,740,178.1363812376501,222.27246562076434
9497,C6_02500C_A,1445,C6,517713,518897,1184,136.45413002990057,170.26278245441284
9499,C6_02510C_A,2,C6,519240,519686,446,0.5013784658879459,0.625602850174639
9501,C6_02520W_A,2769,C6,520747,521556,809,382.6881146671818,477.5051015399102
9503,C6_02530C_A,171,C6,521838,522290,452,42.298816459524424,52.77901213652547
9505,C6_02540C_A,75,C6,522595,523275,680,12.331698297023376,15.387070101721822
9507,C6_02550W_A,18,C6,523443,524150,707,2.8465815588036993,3.551866818388969
9509,C6_02560W_A,2052,C6,524474,525520,1046,219.33917827577488,273.6839023217152
9511,C6_02570C_A,298,C6,525572,526570,998,33.38537532276308,41.65712605762071
9513,C6_02580W_A,535,C6,526774,528267,1493,40.06494164284085,49.99165977232774
9515,C6_02590C_A,390,C6,528273,529094,821,53.11191860934794,66.27123006052175
9517,C6_02600W_A,2774,C6,529546,532056,2510,123.56721982279488,154.1829379775825
9519,C6_02610C_A,1040,C6,532206,533732,1526,76.19901298082073,95.07851442496873
9521,C6_02620C_A,13,C6,534068,534433,365,3.9821812948196036,4.968829212756927
9523,C6_02630C_A,877,C6,534981,537278,2297,42.68832736272159,53.26503047954042
9525,C6_02640C_A,444,C6,537774,538826,1052,47.18867363545371,58.88040817632259
9527,C6_02650C_A,962,C6,539180,540637,1457,73.8220430837869,92.11261292832162
9529,C6_02660C_A,186,C6,541584,543302,1718,12.104875441269046,15.104048323366518
9531,C6_02670C_A,1395,C6,547501,548802,1301,119.88571872463619,149.5892871995216
9533,C6_02680W_A,206,C6,552562,553404,842,27.354303997577745,34.13176215121445
9535,C6_02690C_A,2544,C6,553947,555881,1934,147.07239929670237,183.51189459062815
9537,C6_02710C_A,149,C6,558152,559408,1256,13.26377570546081,16.55008431747829
9539,C6_02720C_A,244,C6,561383,563818,2435,11.203698187225838,13.979590260247418
9541,C6_02730W_A,6902,C6,564311,566254,1943,397.1665775901021,495.5708308980417
9543,C6_02740W_A,941,C6,566592,566915,323,325.7299115087438,406.43460956407677
9545,C6_02750C_A,228,C6,567103,568881,1778,14.337506591454853,17.889848883171737
9547,C6_02760W_A,41,C6,569269,569946,677,6.771201349502938,8.448872760925738
9549,C6_02770W_A,466,C6,570239,570931,692,75.29226505512077,93.9471054688557
9551,C6_02780C_A,606,C6,571363,572925,1562,43.377261922641,54.124659389820984
9553,C6_02790C_A,475,C6,573291,575498,2207,24.06366742146836,30.025818715336946
9555,C6_02800W_A,272,C6,576265,576792,527,57.70704407381262,72.00486998139071
9557,C6_02810C_A,1103,C6,577043,580438,3395,36.32505445537325,45.325156834935434
9559,C6_02820W_A,1,C6,582651,582959,308,0.3630110321201686,0.4529527129511185
9561,C6_02830W_A,1495,C6,583525,586143,2618,63.847234472900254,79.66638892493204
9563,C6_02840C_A,758,C6,586391,587995,1604,52.83666309407921,65.92777567108476
9565,C6_02850W_A,176,C6,588696,589763,1067,18.442457384414343,23.011865664155795
9567,C6_02860W_A,1071,C6,590320,593553,3233,37.03857814519511,46.21546721798935
9569,C6_02870W_A,620,C6,594266,594967,701,98.88814078982513,123.38922976482966
9571,C6_02880W_A,685,C6,596395,597093,698,109.72502515288421,136.9111223186633
9573,C6_02890C_A,256,C6,597534,598598,1064,26.901028064484077,33.566179991324994
9575,C6_02900C_A,277,C6,599811,601172,1361,22.755803979694573,28.39391157835241
9577,C6_02910W_A,210,C6,601321,602160,839,27.985165146045897,34.918929050868115
9579,C6_02920C_A,602,C6,602192,603142,950,70.85058266483495,88.4049265521522
9581,C6_02930W_A,2421,C6,603414,606363,2949,91.7889828073862,114.53114396772962
9583,C6_02940C_A,430,C6,606561,607859,1298,37.039430734973145,46.21653105026667
9585,C6_02950C_A,68,C6,608693,609775,1082,7.0267126217419715,8.767690961227567
9587,C6_02960W_A,146,C6,610396,611592,1196,13.648729174230557,17.030416050155434
9589,C6_02970C_A,366,C6,611719,613338,1619,25.27579223523309,31.538266476561887
9591,C6_02980C_A,1274,C6,614384,616048,1664,85.60253901183728,106.81191162278564
9593,C6_02990W_A,375,C6,617910,619601,1691,24.794662454097857,30.93792924059976
9595,C6_03000C_A,85,C6,620109,620915,806,11.791102755466522,14.712533529851468
9597,C6_03010W_A,948,C6,621127,629748,8621,12.294793318939256,15.34102133607695
9599,C6_03020W_A,95,C6,630448,632880,2432,4.367476480195779,5.449587327693145
9601,C6_03030W_A,201,C6,635173,636429,1256,17.89274440803774,22.325952669886817
9603,C6_03040C_A,550,C6,637254,640202,2948,20.85958915914402,26.02787977405681
9605,C6_03050C_A,179,C6,640436,641836,1400,14.295374444892241,17.837277836015048
9607,C6_03060W_A,45,C6,643530,645755,2225,2.2612732158137248,2.8215391467426985
9609,C6_03070C_A,191,C6,646161,646484,323,66.11521051877797,82.49629163309102
9611,C6_03080C_A,2522,C6,646612,647655,1043,270.35307525040855,337.3372929581189
9613,C6_03090W_A,62,C6,648469,650490,2021,3.4300141857331723,4.279854035880534
9615,C6_03100W_A,1435,C6,652168,653727,1559,102.91444257631312,128.413111013557
9617,C6_03110C_A,83,C6,653804,654937,1133,8.190656685895844,10.220020435906791
9619,C6_03120W_A,615,C6,655158,658325,3167,21.711888128892436,27.091349190780193
9621,C6_03130W_A,1033,C6,658611,658802,191,604.6965550967609,754.5196176093177
9623,C6_03140C_A,1289,C6,659079,661430,2351,61.30146145644083,76.48986068657996
9625,C6_03150C_A,856,C6,661783,663006,1223,78.2560364647737,97.64519776298977
9627,C6_03160C_A,2632,C6,663217,665157,1940,151.68921198680798,189.27259508768142
9629,C6_03170C_A,1323,C6,666383,668077,1694,87.32065372636058,108.95571622442361
9631,C6_03180C_A,3173,C6,669284,672274,2990,118.650459369407,148.04797295107724
9633,C6_03190C_A,5,C6,672825,673145,320,1.7469905920783115,2.179834931077258
9635,C6_03200W_A,951,C6,674165,675106,941,112.99557427869752,140.9920013231522
9637,C6_03210C_A,85,C6,675261,676253,992,9.58027098881655,11.95393349300432
9639,C6_03220W_A,204,C6,676467,677552,1085,21.02185176974603,26.230345493220902
9641,C6_03230W_A,121,C6,677961,678998,1037,13.045993389637845,16.27834301471773
9643,C6_03240W_A,55,C6,679400,680431,1031,5.9645071620908405,7.442307427150289
9645,C6_03250W_A,1691,C6,682709,685078,2369,79.80848874507521,99.58229446218031
9647,C6_03260W_A,3600,C6,685751,686608,857,469.6693493755461,586.0373023572932
9649,C6_03270C_A,159,C6,686774,687667,893,19.907476220592272,24.839865911133455
9651,C6_03280W_A,30,C6,688257,689066,809,4.146133420012804,5.173403050269884
9653,C6_03290W_A,976,C6,689317,690756,1439,75.83323164946466,94.62210502766493
9655,C6_03300C_A,363,C6,690878,692836,1958,20.72833781162581,25.864108845141402
9657,C6_03310W_A,515,C6,693653,695770,2117,27.199248896977398,33.93828971578008
9659,C6_03320W_A,861,C6,696248,697177,929,103.62343335401862,129.2977653843716
9661,C6_03330C_A,167,C6,697118,699883,2765,6.752924212706327,8.426067176619796
9663,C6_03340C_A,1286,C6,700203,702257,2054,70.00210014138918,87.34621916620382
9665,C6_03350C_A,535,C6,703285,704691,1406,42.544066765833136,53.08502705553721
9667,C6_03360C_A,51,C6,704980,705516,536,10.63839047116345,13.274218684768973
9669,C6_03370W_A,3013,C6,710076,711305,1229,274.1055246962124,342.0194706505206
9671,C6_03380W_A,2087,C6,712164,713270,1106,210.97833580715726,263.25152990427415
9673,C6_03390W_A,295,C6,714482,715531,1049,31.442499884116803,39.232872734736546
9675,C6_03400C_A,453,C6,715854,716237,383,132.24217035387574,165.00724366003098
9677,C6_03410C_A,606,C6,716494,717594,1100,61.595711930150216,76.85701633354579
9679,C6_03420W_A,33,C6,717849,720047,2198,1.6786370020333914,2.0945456662580386
9681,C6_03430C_A,992,C6,720171,724973,4802,23.09723838189668,28.819941712668253
9683,C6_03440W_A,1060,C6,725374,727680,2306,51.39455410520063,64.12836154565532
9685,C6_03450C_A,2228,C6,727787,730372,2585,96.36629884163659,120.24256189252162
9687,C6_03460W_A,1904,C6,730859,734344,3485,61.085017385450435,76.2197891998136
9689,C6_03470W_A,1898,C6,737336,739201,1865,113.7857593570706,141.97796715700625
9691,C6_03480W_A,664,C6,739894,741762,1868,39.74310074997855,49.59007774681967
9693,C6_03490C_A,158,C6,741928,743103,1175,15.034526695400755,18.75956665791764
9695,C6_03500C_A,305,C6,744962,746215,1253,27.2156874360484,33.95880116091626
9697,C6_03510C_A,12,C6,746965,747312,347,3.866538255666119,4.824533795583096
9699,C6_03520C_A,58,C6,748178,750613,2435,2.6631741592586007,3.3230173569440584
9701,C6_03530C_A,359,C6,751488,751889,401,100.0968973655643,124.89747475419222
9703,C6_03540W_A,1184,C6,752357,753754,1397,94.76017115628214,118.23849086421639
9705,C6_03550C_A,1150,C6,753856,755475,1619,79.4184728702679,99.09564603291302
9707,C6_03560W_A,1201,C6,756804,758795,1991,67.44383971346427,84.15410956420007
9709,C6_03570W_A,8,C6,759011,759733,722,1.2388631345486087,1.545810920653125
9711,C6_03580W_A,287,C6,759950,762031,2081,15.419857374000205,19.240369060080287
9713,C6_03590C_A,381,C6,762043,762732,689,61.8267323617381,77.14527570303028
9715,C6_03600C_A,140,C6,763188,764768,1580,9.906984623431438,12.361595558514072
9717,C6_03610W_A,160,C6,767669,769633,1964,9.10854565319853,11.36533080154334
9719,C6_03620C_A,875,C6,769693,771234,1541,63.48570613652528,79.21528626886857
9721,C6_03630W_A,243,C6,771818,772507,689,39.43279780551801,49.20289237752325
9723,C6_03640W_A,2271,C6,772812,775011,2199,115.4682131036972,144.077275226236
9725,C6_03650C_A,636,C6,775110,776588,1478,48.11197906627578,60.0324770193293
9727,C6_03660C_A,1200,C6,776892,778082,1190,112.74695585849945,140.68178378717093
9729,C6_03670C_A,36,C6,780255,780551,296,13.598197041041995,16.967363787844604
9731,C6_03690W_A,543,C6,782435,786478,4043,15.016427666560842,18.736983310610157
9733,C6_03700W_A,16590,C6,791291,795073,3782,490.4507485576595,611.9676193602827
9735,C6_03710W_A,694,C6,797842,803514,5672,13.680242266881223,17.06973700612262
9737,C6_03720W_A,5044,C6,804198,807107,2909,193.86611033769412,241.89948199059336
9739,C6_03730C_A,1338,C6,807280,808662,1382,108.24768334359624,135.0677458885729
9741,C6_03740W_A,47,C6,808828,809445,617,8.51693306478373,10.627136908720246
9743,C6_03750C_A,874,C6,809483,810148,665,146.94686580224428,183.35525820261276
9745,C6_03760C_A,8892,C6,810622,812034,1412,704.1015453715738,878.5537544312284
9747,C6_03770C_A,1499,C6,813339,814145,806,207.93956506405075,259.4598560146747
9749,C6_03780C_A,712,C6,815053,816966,1913,41.613626398235496,51.9240554831827
9751,C6_03790C_A,4793,C6,817349,818989,1640,326.7639378665892,407.7248321815921
9753,C6_03800C_A,1098,C6,822645,824495,1850,66.35920156028493,82.80073528468166
9755,C6_03810W_A,530,C6,826674,828011,1337,44.321556382420596,55.3029176231418
9757,C6_03820C_A,272,C6,828137,829087,950,32.012223396736054,39.94375418967674
9759,C6_03830W_A,1716,C6,830112,831827,1715,111.87259171102536,139.59078219861735
9761,C6_03840C_A,8847,C6,832295,836782,4487,220.4502003921276,275.0701976053916
9763,C6_03850C_A,275,C6,838281,839459,1178,26.101047895227747,32.56799217908297
9765,C6_03860C_A,170,C6,841828,842499,671,28.32676250642628,35.34516251880859
9767,C6_03870C_A,3,C6,843109,843181,72,4.658641578875498,5.812893149539354
9769,C6_03880W_A,156,C6,843973,844755,782,22.30428909374663,27.830526792679468
9771,C6_03890C_A,419,C6,844807,845961,1154,40.595580344169846,50.653772540526646
9773,C6_03900W_A,1306,C6,846169,848565,2396,60.94343140579032,76.04312307143636
9775,C6_03910C_A,112,C6,848580,849431,851,14.714957184509208,18.360818784913967
9777,C6_03920W_A,789,C6,849768,850778,1010,87.34261082929349,108.98311354423487
9779,C6_03930W_A,1086,C6,851234,853390,2156,56.318568697500446,70.27237803784496
9781,C6_03940C_A,1968,C6,853685,855274,1589,138.4751158297341,172.78449920644607
9783,C6_03950C_A,543,C6,855600,856616,1016,59.75533174793847,74.56065307558747
9785,C6_03960W_A,3874,C6,857389,859491,2102,206.06177899026085,257.11681896839724
9787,C6_03990C_A,201,C6,863059,864597,1538,14.61202014076424,18.232377472937483
9789,C6_04030W_A,302,C6,876301,877632,1331,25.36877097196815,31.6542821546666
9791,C6_04040C_A,2347,C6,877853,879175,1322,198.496189754084,247.67673625359512
9793,C6_04050W_A,243,C6,879657,880859,1202,22.60332586356232,28.203654615735037
9795,C6_04060W_A,307,C6,881371,884007,2636,13.021574792547293,16.247874326937012
9797,C6_04070C_A,43,C6,884108,885451,1343,3.579834779895394,4.466795033748782
9799,C6_04080W_A,3155,C6,886488,887828,1340,263.2480151883975,328.471842748597
9801,C6_04100W_A,2914,C6,890053,891459,1406,231.72600103857528,289.13975484081385
9803,C6_04110W_A,389,C6,892609,894141,1532,28.38973745455721,35.42374049875941
9805,C6_04120C_A,348,C6,894295,897546,3251,11.968309586825026,14.93364613502082
9807,C6_04130C_A,1921,C6,898452,904754,6302,34.08156321048492,42.525805421511016
9809,C6_04140C_A,1904,C6,907998,910160,2162,98.46497945804568,122.8612235713924
9811,C6_04150W_A,2,C6,911713,911964,251,0.8908956007411309,1.111628968836211
9813,C6_04160C_A,1716,C6,913551,916088,2537,75.62534283973532,94.36270850241576
9815,C6_04170C_A,318,C6,916379,919258,2879,12.349688270225009,15.409517373144965
9817,C6_04180W_A,927,C6,920228,923212,2984,34.73373252239346,43.33955991653873
9819,C6_04190C_A,52,C6,923628,924761,1133,5.131495755019083,6.402904369483773
9821,C6_04210C_A,505,C6,928032,930284,2252,25.072262849010226,31.284309490416064
9823,C6_04220C_A,370,C6,930975,932251,1276,32.42064045487024,40.45336298425507
9825,C6_04230W_A,100,C6,933892,935499,1607,6.957523204294459,8.681358779648072
9827,C6_04240W_A,58,C6,935982,936497,515,12.591901121931443,15.711742260502488
9829,C6_04250W_A,2008,C6,936924,937175,251,894.4591831440956,1116.075484711556
9831,C6_04260C_A,184,C6,937516,938199,683,30.12088025229019,37.58380109570393
9833,C6_04270W_A,2839,C6,939854,945904,6050,52.46631448235718,65.46566737801876
9835,C6_04280W_A,694,C6,946421,947119,698,111.1666678191265,138.70995458270414
9837,C6_04290W_A,1684,C6,948163,950031,1868,100.79424949241549,125.76760681572942
9839,C6_04300W_A,219,C6,950494,952914,2420,10.118107495276702,12.625027435528452
9841,C6_04310W_A,198,C6,953455,954192,737,30.03780838916739,37.48014687464181
9843,C6_04320C_A,52,C6,954379,954726,347,16.754999107886515,20.906313114193416
9845,C6_04330W_A,653,C6,954954,957020,2066,35.33893069900135,44.09470544026175
9847,C6_04340W_A,218,C6,957364,958923,1559,15.634389185809239,19.50805449543932
9849,C6_04350C_A,2101,C6,959560,961938,2378,98.78357568259803,123.25875701109017
9851,C6_04360C_A,613,C6,964395,965546,1151,59.5464247683895,74.29998611296524
9853,C6_04370W_A,191,C6,965838,968477,2639,8.09216104492811,10.097120953955438
9855,C6_04380W_A,1727,C6,971215,978303,7088,27.242011309428843,33.991647187091864
9857,C6_04400W_A,91,C6,983785,984099,314,32.402780918038495,40.43107846685972
9859,C6_04410C_A,382,C6,984319,985389,1070,39.916285976757536,49.80617233175402
9861,C6_04420W_A,796,C6,985842,986297,455,195.60151367656596,244.06485874461504
9863,C6_04430W_A,313,C6,987663,988814,1151,30.404618193321234,37.9378395650214
9865,C6_04440C_A,534,C6,988798,991299,2501,23.87251118547316,29.787300521589913
9867,C6_04450W_A,397,C6,991302,992492,1190,37.300451229853564,46.54222346958905
9869,C6_04460W_A,1,C6,992696,992810,114,0.9807666481843152,1.2237669788503904
9871,C6_04470C_A,1291,C6,992873,995203,2330,61.94993591411092,77.29900486923921
9873,C6_04480C_A,389,C6,995286,995987,701,62.04433349555156,77.41679093309475
9875,C6_04490W_A,170,C6,997774,999153,1379,13.783363046999298,17.19840757804247
9877,C6_04500C_A,1891,C6,999224,1003501,4277,49.433665984495114,61.68163261601452
9879,C6_04510C_A,580,C6,1003604,1005055,1451,44.692136993760805,55.765315397372724
9881,C6_04520W_A,9057,C6,1005227,1008493,3266,310.0549916463592,386.8759822807932
9883,C6_04530C_A,1302,C6,1008502,1011345,2843,51.204091472635085,63.890708806474066
9885,C6_04540C_A,735,C6,1012024,1013172,1148,71.58400474857471,89.32006546853155
9887,C6_04550C_A,697,C6,1013238,1015511,2273,34.2849785883983,42.77962015199926
9889,C6_04560W_A,1777,C6,1015669,1016658,989,200.8915531404269,250.66558851522186
9891,C6_04570W_A,3059,C6,1016757,1019129,2372,144.19006330300317,179.91541461491622
9893,C6_04580W_A,1425,C6,1019276,1020757,1481,107.57970425222284,134.23426449307624
9895,C6_04590C_A,362,C6,1021000,1021746,746,54.25506439312376,67.69760815442079
9897,C6_04600W_A,191,C6,1021987,1023228,1241,17.208068491188786,21.471637548338762
9899,C6_04610C_A,86,C6,1023237,1024922,1685,5.706490337566189,7.120362884658296
9901,C6_04620C_A,10,C6,1025130,1026875,1745,0.6407300738854552,0.7994810062403697
9903,C6_04650W_A,2545,C6,1028580,1031093,2513,113.23112918333283,141.28591865255225
9905,C7_00010C_A,2354,C7,117,1155,1038,253.55935899821782,316.38266991943675
9907,C7_00020C_A,4012,C7,1246,2040,794,564.9512346936574,704.9267702554728
9909,C7_00030W_A,1485,C7,2278,2769,491,338.1547573749954,421.9379060072965
9911,C7_00040C_A,366,C7,2747,3421,674,60.71440301015189,75.75734929607373
9913,C7_00050C_A,2999,C7,3464,5761,2297,145.97752994390197,182.14575417119923
9915,C7_00060C_A,1072,C7,5799,6467,668,179.42744093010302,223.8834056157912
9917,C7_00070C_A,2837,C7,6523,7476,953,332.8411204852832,415.3077321782115
9919,C7_00080C_A,3164,C7,7583,9430,1847,191.5314601697292,238.98638560011935
9921,C7_00090C_A,1123,C7,10024,13080,3056,41.08629183044909,51.26606549947142
9923,C7_00100W_A,772,C7,14047,15825,1778,48.54629424825941,60.5744006044236
9925,C7_00110W_A,11613,C7,15982,16662,680,1909.4401643110998,2382.533934550607
9927,C7_00120W_A,1017,C7,16744,17208,464,245.06061133015766,305.7782241249064
9929,C7_00130W_A,1377,C7,17255,18298,1043,147.61149271205895,184.1845568609555
9931,C7_00140C_A,1192,C7,18321,18851,530,251.46116658201927,313.76461740004123
9933,C7_00150W_A,3018,C7,19179,19871,692,487.6224376316619,608.4385500107436
9935,C7_00160C_A,1238,C7,19888,20349,461,300.2550077907783,374.6478986097903
9937,C7_00170W_A,1711,C7,21072,23375,2303,83.06663386667105,103.64769617572038
9939,C7_00180W_A,532,C7,23536,25842,2306,25.794247909402582,32.18517768140437
9941,C7_00190W_A,1050,C7,26062,27036,974,120.53158910437632,150.39518210307162
9943,C7_00200W_A,608,C7,27138,28232,1094,62.13793228423333,77.53358029074796
9945,C7_00210C_A,727,C7,28225,30591,2366,34.3550204007691,42.86701592272302
9947,C7_00220W_A,192,C7,30551,31618,1067,20.1190444193611,25.103853451806323
9949,C7_00230W_A,386,C7,31779,33545,1766,24.43808357117928,30.49300234277043
9951,C7_00240W_A,358,C7,33810,34454,644,62.15380193431409,77.5533818957176
9953,C7_00250C_A,1135,C7,34632,35195,563,225.40212541486423,281.2490397752256
9955,C7_00260C_A,1169,C7,35365,38295,2930,44.60848059280921,55.66093181006011
9957,C7_00270W_A,559,C7,38507,39679,1172,53.327931247605534,66.54076322032421
9959,C7_00280W_A,183,C7,41587,43167,1580,12.949844186342522,16.158371337200535
9961,C7_00290C_A,175,C7,43379,45102,1723,11.35594581037556,14.169559621628142
9963,C7_00300W_A,1893,C7,46309,47109,800,264.5642552643396,330.11420196233996
9965,C7_00310C_A,651,C7,47152,47988,836,87.06533017745308,108.63713225885512
9967,C7_00320C_A,2538,C7,48461,51214,2753,103.07561781782213,128.61421995086857
9969,C7_00330C_A,468,C7,51707,52855,1148,45.580019350112885,56.87318454322825
9971,C7_00340C_A,3626,C7,52951,55866,2915,139.0784304494207,173.53729449245722
9973,C7_00350C_A,3630,C7,56058,57377,1319,307.70345288220875,383.9418128793545
9975,C7_00360W_A,3292,C7,59071,60084,1013,363.34645001361827,453.3712358922066
9977,C7_00370W_A,196,C7,60279,61298,1019,21.505642774318293,26.834003312495707
9979,C7_00380W_A,422,C7,61437,62255,818,57.68058913306973,71.97186041385646
9981,C7_00390W_A,5351,C7,62478,63944,1466,408.1046290078492,509.21895623222514
9983,C7_00400W_A,1440,C7,64158,65279,1121,143.6241328866523,179.2092660553792
9985,C7_00410C_A,1452,C7,65303,68746,3443,47.15200166734051,58.834650152526116
9987,C7_00420C_A,170,C7,69078,69539,461,41.2304938000261,51.44599577032661
9989,C7_00430W_A,2973,C7,70601,72361,1760,188.86556473632075,235.6599727306432
9991,C7_00440C_A,3299,C7,72658,74332,1674,220.34205833276368,274.93526165348146
9993,C7_00450C_A,250,C7,74657,75454,797,35.07132932654076,43.76080162764884
9995,C7_00460W_A,57,C7,75620,76342,722,8.826899833658839,11.013902809653514
9997,C7_00470C_A,1034,C7,76425,77930,1505,76.81651124343811,95.84900757406552
9999,C7_00480W_A,42,C7,79446,80990,1544,3.041392947866906,3.7949457867459
10001,C7_00490C_A,167,C7,81174,81905,731,25.542866550113537,31.87151264480675
10003,C7_00500W_A,1,C7,81346,81816,470,0.23788808062342964,0.2968285863594564
10005,C7_00510W_A,1144,C7,82584,83879,1295,98.77039628540977,123.2423122113919
10007,C7_00520W_A,5497,C7,84177,87452,3275,187.66573014286618,234.16286028471083
10009,C7_00530C_A,113,C7,87578,88111,533,23.704007433227673,29.577047319982604
10011,C7_00540W_A,1,C7,88271,88384,113,0.989445999053203,1.2345967751234028
10013,C7_00550C_A,5020,C7,88681,91080,2399,233.9612911308545,291.9288731373495
10015,C7_00560C_A,273,C7,91359,92165,806,37.87024767343953,47.25319592528765
10017,C7_00570W_A,4581,C7,92423,95923,3500,146.33991135653937,182.59792126655853
10019,C7_00580C_A,337,C7,96043,96723,680,55.41043101462504,69.13923499040338
10021,C7_00590W_A,584,C7,96928,97902,974,67.03852193995789,83.64836795066078
10023,C7_00600C_A,857,C7,97943,99298,1355,70.71508486665036,88.23585704776785
10025,C7_00610C_A,1039,C7,99537,101327,1790,64.89826056471476,80.97782322732589
10027,C7_00620W_A,5602,C7,101629,103806,2177,287.71017133516443,358.99488202538686
10029,C7_00630C_A,181,C7,103977,105816,1839,11.004425785010964,13.730944992712864
10031,C7_00640C_A,2,C7,106320,106646,326,0.6859349563988463,0.855886107907635
10033,C7_00650W_A,8,C7,114110,114475,365,2.4505731045043713,3.057741054004263
10035,C7_00660W_A,2404,C7,115894,117909,2015,133.39205187831303,166.44202638006087
10037,C7_00670C_A,1646,C7,122844,126245,3401,54.11201909200167,67.51912113478467
10039,C7_00680W_A,88,C7,126561,127202,641,15.349533564095244,19.152621422507202
10041,C7_00690W_A,1182,C7,127379,128182,803,164.5782619047822,205.35510942233176
10043,C7_00700W_A,1495,C7,129228,129608,380,439.87384171066543,548.8594900144002
10045,C7_00710W_A,4791,C7,131585,131860,275,1947.8881574742552,2430.508021478666
10047,C7_00720W_A,2715,C7,132567,134273,1706,177.9349855096878,222.02117094020187
10049,C7_00730W_A,1824,C7,135510,136031,521,391.43319339127413,488.4169107758825
10051,C7_00740W_A,4908,C7,137282,143053,5771,95.08762932921549,118.64708193909888
10053,C7_00750W_A,270,C7,143529,143912,383,78.81983663476038,98.34868827419066
10055,C7_00760C_A,52,C7,144060,144569,509,11.422366778853872,14.252437427554252
10057,C7_00770W_A,1444,C7,145917,146819,902,178.99100061808122,223.3388303663369
10059,C7_00780W_A,1729,C7,148191,150485,2294,84.26983040846454,105.14900354545992
10061,C7_00790W_A,386,C7,150850,153243,2393,18.034958456624576,22.503402481125192
10063,C7_00800C_A,227,C7,153347,153889,542,46.82708361939799,58.429228558469376
10065,C7_00810W_A,771,C7,154466,155746,1280,67.34648732461892,84.0326365930283
10067,C7_00820W_A,390,C7,156150,157241,1091,39.96781409557714,49.870467350768436
10069,C7_00830C_A,2906,C7,157502,159808,2306,140.89865493369155,175.80850816195698
10071,C7_00840C_A,280,C7,160710,163940,3230,9.692282170292057,12.0936972027568
10073,C7_00850W_A,483,C7,165660,168671,3011,17.935228556069337,22.37896293240126
10075,C7_00860W_A,1870,C7,171720,172424,704,296.988400653313,370.5719382831339
10077,C7_00870W_A,135,C7,174289,176121,1832,8.239082268316928,10.28044421643423
10079,C7_00880C_A,707,C7,176562,179318,2756,28.682086469651466,35.788523570893965
10081,C7_00890C_A,1047,C7,188023,188811,788,148.55627613449684,185.36342520510775
10083,C7_00900W_A,23,C7,189687,189995,308,8.34925373876388,10.417912397875726
10085,C7_00910C_A,457,C7,190074,191255,1181,43.26501340991233,53.98459954627235
10087,C7_00920C_A,115,C7,191453,192481,1028,12.507636923829159,15.606600284755464
10089,C7_00930W_A,6917,C7,195079,197781,2702,286.2219730666039,357.137959277842
10091,C7_00940W_A,1662,C7,198460,200568,2108,88.1517529877542,109.99273337230824
10093,C7_00950W_A,1771,C7,200872,201708,836,236.85514553651217,295.53972539236923
10095,C7_00960W_A,13291,C7,202217,203082,865,1717.9562143306612,2143.606830534869
10097,C7_00970C_A,814,C7,205033,206040,1007,90.37857188173955,112.77128159821333
10099,C7_00980W_A,2966,C7,209134,211122,1988,166.81123850637496,208.141341024552
10101,C7_00990W_A,8496,C7,211801,212739,938,1012.7032542633577,1263.6163803450668
10103,C7_01000C_A,1,C7,211827,212249,422,0.2649464405047676,0.3305910795946552
10105,C7_01010W_A,597,C7,212898,214127,1229,54.31164893582435,67.76821240569558
10107,C7_01020C_A,1153,C7,214245,214766,521,247.43556577858496,308.7416108139213
10109,C7_01030C_A,3445,C7,214925,218578,3653,105.44114036173725,131.56583783299038
10111,C7_01040C_A,658,C7,218779,220611,1832,40.157897278166956,50.10764662528683
10113,C7_01050W_A,78,C7,221546,222589,1043,8.361435317022945,10.433112153343885
10115,C7_01060W_A,4,C7,222726,223154,428,1.0449289522711396,1.3038265008312573
10117,C7_01070C_A,1462,C7,223296,226653,3357,48.69300438474337,60.75746047990375
10119,C7_01100C_A,148,C7,230874,232412,1538,10.75909940712989,13.424835154202722
10121,C7_01130C_A,1,C7,236122,236562,440,0.25410772248411806,0.317066899065783
10123,C7_01150W_A,362,C7,244441,245340,899,45.021443867931396,56.17621321824017
10125,C7_01160C_A,441,C7,245475,245753,278,177.3635340676916,221.3081334342609
10127,C7_01170C_A,241,C7,246116,247258,1142,23.595081341695163,29.441133079628397
10129,C7_01180W_A,455,C7,248250,249536,1286,39.55860500880283,49.35987029002313
10131,C7_01190W_A,246,C7,249860,250768,908,30.291431587754335,37.79660920141008
10133,C7_01200C_A,1324,C7,250792,252975,2183,67.81172460391564,84.61314371038138
10135,C7_01210C_A,721,C7,253347,254183,836,96.42719363739427,120.31854432969975
10137,C7_01220W_A,800,C7,254404,255339,935,95.6640837587268,119.36636200123596
10139,C7_01230C_A,2677,C7,255373,256806,1433,208.86839089992532,260.618813029731
10141,C7_01250W_A,9576,C7,257912,259124,1212,883.3891437487479,1102.26266930671
10143,C7_01260W_A,1,C7,258488,258578,90,1.242304421033466,1.550104839877161
10145,C7_01270C_A,726,C7,259274,261082,1808,44.89611220703909,56.0198286712244
10147,C7_01280C_A,358,C7,261260,262552,1292,30.980687651469253,38.65663927309763
10149,C7_01290W_A,93,C7,263352,263858,506,20.549581035672155,25.641062272276365
10151,C7_01300C_A,40,C7,263896,264606,710,6.299008332000673,7.859686512053212
10153,C7_01310C_A,6,C7,264744,265073,329,2.0390406910579686,2.5442450259381983
10155,C7_01320W_A,1008,C7,266119,267939,1820,61.92409729459123,77.26676432618466
10157,C7_01330C_A,636,C7,268107,273401,5294,13.432093891189195,16.760105975551323
10159,C7_01340W_A,811,C7,273669,275717,2048,44.275292817984706,55.24519153448926
10161,C7_01350C_A,344,C7,275786,276745,959,40.106094760371334,50.04300922064328
10163,C7_01360C_A,20,C7,277182,277736,554,4.03636815498238,5.036441718012437
10165,C7_01370W_A,236,C7,278053,279501,1448,18.222752695269904,22.737725689910846
10167,C7_01380W_A,81,C7,281375,282502,1127,8.035846698610442,10.026853844458302
10169,C7_01390W_A,272,C7,285900,286292,392,77.58064343596747,96.8024655106962
10171,C7_01400C_A,812,C7,286775,289093,2318,39.166353360278556,48.87043213900903
10173,C7_01410C_A,941,C7,290111,291139,1028,102.34509865498468,127.70270319960777
10175,C7_01420W_A,518,C7,292252,293031,779,74.34689615992322,92.76750659187839
10177,C7_01430C_A,2741,C7,295832,296773,941,325.67914731641423,406.37126774633043
10179,C7_01440W_A,167,C7,302675,303043,368,50.738683282970094,63.30998843302645
10181,C7_01450C_A,4253,C7,303151,305370,2219,214.29331376249652,267.38784567813474
10183,C7_01460C_A,586,C7,305828,308848,3020,21.695077869306292,27.070373925536916
10185,C7_01470C_A,1853,C7,309229,310165,936,221.3452011706743,276.1869488742673
10187,C7_01480W_A,512,C7,310445,311785,1340,42.72043859792695,53.30509777726836
10189,C7_01490W_A,641,C7,312570,313262,692,103.56725729685067,129.22767082733154
10191,C7_01500W_A,177,C7,313805,315115,1310,15.106801089361156,18.849748167361206
10193,C7_01510W_A,757,C7,317084,318727,1643,51.51442495740113,64.27793228291601
10195,C7_01520W_A,1636,C7,320555,322387,1832,99.84547104419627,124.58375361545482
10197,C7_01530W_A,3,C7,322903,323229,326,1.0289024345982694,1.2838291618614526
10199,C7_01540W_A,74,C7,325170,326693,1523,5.4325327932257945,6.778528058819365
10201,C7_01550W_A,3263,C7,329715,336473,6758,53.98454266423468,67.36006042123793
10203,C7_01560C_A,54,C7,336677,337897,1220,4.948852037887415,6.17500780475656
10205,C7_01570C_A,190,C7,338747,339883,1136,18.700180985626996,23.333444332657972
10207,C7_01580W_A,2134,C7,340590,343976,3386,70.465737478939,87.92472993113041
10209,C7_01590C_A,565,C7,344244,345575,1331,47.461442381331146,59.22075966022062
10211,C7_01600W_A,2427,C7,345794,346918,1124,241.42042231880785,301.23612115157323
10213,C7_01610W_A,777,C7,347245,347582,337,257.7873832726121,321.65825356857533
10215,C7_01620C_A,503,C7,347813,349792,1979,28.417949034959584,35.45894194100005
10217,C7_01630W_A,328,C7,350989,352284,1295,28.31878494896364,35.3352083962732
10219,C7_01640W_A,7833,C7,352678,354111,1433,611.1565580571964,762.5801876958843
10221,C7_01650W_A,1539,C7,354542,356139,1597,107.74676603465583,134.44271845421767
10223,C7_01660C_A,2184,C7,356175,358622,2447,99.79050142964368,124.51516441612375
10225,C7_01670W_A,545,C7,359156,360895,1739,35.04027133507275,43.72204853132533
10227,C7_01680C_A,1428,C7,363741,364475,734,217.52174957932027,271.41617714034436
10229,C7_01690W_A,175,C7,369530,369886,356,54.961501773250255,68.57907648332946
10231,C7_01700W_A,1900,C7,370380,371207,827,256.87310277717376,320.5174457303441
10233,C7_01710W_A,657,C7,371481,372662,1181,62.199373764359734,77.61024486192764
10235,C7_01720W_A,361,C7,373129,373893,764,52.83045895206455,65.92003435550912
10237,C7_01730C_A,548,C7,373998,374338,340,180.20721778050162,224.8563844198282
10239,C7_01740C_A,287,C7,374590,375264,674,47.60938159539233,59.405353136538686
10241,C7_01750W_A,324,C7,375744,376628,884,40.979182033185374,51.132417568798665
10243,C7_01760C_A,1957,C7,377222,377785,563,388.64489818228134,484.9377716653009
10245,C7_01770W_A,5,C7,379039,379386,347,1.6110576065275497,2.01022241482629
10247,C7_01780W_A,3723,C7,380242,384336,4094,101.67536452263886,126.86703192419161
10249,C7_01790C_A,19346,C7,384487,385383,896,2414.091428167644,3012.220469758617
10251,C7_01800C_A,7092,C7,385958,388798,2840,279.2035443159299,348.3806046467586
10253,C7_01810W_A,3927,C7,390347,391843,1496,293.49441946915636,366.21226842097934
10255,C7_01820C_A,506,C7,392020,392511,491,115.22310251296139,143.77143463952328
10257,C7_01830W_A,206,C7,393003,393695,692,33.28370515312206,41.530265507691574
10259,C7_01840W_A,2138,C7,394415,399358,4943,48.360149038086085,60.34213499679615
10261,C7_01850C_A,1510,C7,399687,401742,2055,82.15531426688469,102.51058284151154
10263,C7_01860W_A,8,C7,401550,402020,470,1.9031046449874371,2.3746286908756513
10265,C7_01870W_A,1150,C7,402404,404011,1607,80.01151684938628,99.83562596595283
10267,C7_01880C_A,275,C7,404173,405123,950,32.365299390082406,40.38431030206288
10269,C7_01890C_A,604,C7,405642,405839,197,342.8003468394884,427.7345131762563
10271,C7_01900W_A,4941,C7,406702,408138,1436,384.70776670569086,480.0251540703167
10273,C7_01910C_A,291,C7,408386,409249,863,37.70098816554632,47.04199971770899
10275,C7_01920W_A,1770,C7,411053,411787,734,269.6172946466364,336.41921116135126
10277,C7_01930C_A,689,C7,412311,412922,611,126.08068273041775,157.3191507705119
10279,C7_01940C_A,16194,C7,413292,416609,3317,545.8574017122205,681.1021404664962
10281,C7_01950W_A,636,C7,418439,419293,854,83.2663993676295,103.89695671495164
10283,C7_01960W_A,1184,C7,419928,421982,2054,64.44983403375178,80.41829198505857
10285,C7_01970C_A,9410,C7,422229,423401,1172,897.7027424686369,1120.1226867678906
10287,C7_01990C_A,530,C7,429941,431671,1730,34.253133458552796,42.739884891410746
10289,C7_02000C_A,10,C7,432211,433887,1676,0.6671085793139138,0.8323952004113635
10291,C7_02010C_A,289,C7,435297,437282,1985,16.27825591490199,20.311449312445824
10293,C7_02020W_A,1035,C7,438032,439222,1190,97.24424942795576,121.33803851643493
10295,C7_02030W_A,50520,C7,439525,441648,2123,2660.626350237854,3319.8382882494006
10297,C7_02040C_A,14339,C7,449870,450904,1034,1550.489630936072,1934.6477726401115
10299,C7_02050C_A,1847,C7,455359,457362,2003,103.09948273010139,128.64399776973565
10301,C7_02060W_A,2011,C7,458219,460717,2498,90.00987876815334,112.3112389789301
10303,C7_02070W_A,102,C7,460994,461365,371,30.739500229345605,38.35569388159661
10305,C7_02080W_A,366,C7,461678,462148,470,87.06703750817526,108.63926260756104
10307,C7_02090C_A,331,C7,462241,463041,800,46.260310878233696,57.72202897492579
10309,C7_02100W_A,6971,C7,463552,464776,1224,636.7723616929627,794.542708734095
10311,C7_02110W_A,1213,C7,465064,467130,2066,65.64490495848185,81.90946048857198
10313,C7_02120C_A,731,C7,467306,467767,461,177.29112334011225,221.21778181240444
10315,C7_02130W_A,20,C7,468121,469158,1037,2.1563625437417926,2.690635209044253
10317,C7_02140W_A,151,C7,469496,470368,872,19.36114344248257,24.15817061230576
10319,C7_02150C_A,785,C7,470403,471722,1319,66.54193127067049,83.02873914884113
10321,C7_02160W_A,792,C7,472182,475838,3656,24.220858624525565,30.221956506138962
10323,C7_02170C_A,1267,C7,475895,476923,1028,137.80153028253514,171.94402226769716
10325,C7_02180C_A,380,C7,477161,477799,638,66.59374796135506,83.09339423792933
10327,C7_02190W_A,58,C7,479891,480038,147,44.114483522412876,55.0445392119645
10329,C7_02200W_A,1690,C7,480365,482479,2114,89.38245148495278,111.52835673856018
10331,C7_02210W_A,8,C7,483232,483624,392,2.2817836304696315,2.847131338549888
10333,C7_02220C_A,284,C7,483803,485029,1226,25.899919250909782,32.31703075632972
10335,C7_02230W_A,4,C7,486519,486872,353,1.2669393528953194,1.5808434627642436
10337,C7_02240W_A,307,C7,487109,487966,857,40.05235840508129,49.97595883991361
10339,C7_02250W_A,5,C7,489299,491008,1709,0.32711351051203025,0.4081610169366428
10341,C7_02260W_A,1729,C7,492273,492731,458,422.08513309392504,526.6633496359935
10343,C7_02270W_A,268,C7,493961,494419,458,65.42441623433886,81.63434222235182
10345,C7_02280W_A,1788,C7,495607,496065,458,436.48826950372353,544.6350891550934
10347,C7_02290W_A,47,C7,496851,497402,551,9.537110165102652,11.900078897786555
10349,C7_02300W_A,516,C7,497855,499960,2105,27.4074191509711,34.198037417527495
10351,C7_02310C_A,63,C7,500154,501344,1190,5.919215182571221,7.385793648826473
10353,C7_02320W_A,841,C7,502656,504995,2339,40.200949819590875,50.16136610957774
10355,C7_02330W_A,1620,C7,505458,510197,4739,38.22071841879708,47.69050129860521
10357,C7_02340C_A,171,C7,510339,511619,1280,14.936769562269564,18.637588660710556
10359,C7_02350C_A,947,C7,511805,514204,2399,44.13572563763331,55.07104439463545
10361,C7_02360W_A,54,C7,515708,516121,413,14.61888495453425,18.240943152065384
10363,C7_02370W_A,1796,C7,517530,518033,503,399.21687199970074,498.1291179279212
10365,C7_02380C_A,17407,C7,519130,519618,488,3988.1790473845476,4976.31300265729
10367,C7_02390W_A,1146,C7,520547,521104,557,230.03820105097253,287.03377591549446
10369,C7_02420C_A,1455,C7,523711,526224,2513,64.7352821067777,80.77446429841395
10371,C7_02430C_A,504,C7,526542,527896,1354,41.61811561157904,51.929656969592344
10373,C7_02450W_A,851,C7,529016,530869,1853,51.3481357835689,64.07044235628267
10375,C7_02460C_A,1044,C7,530886,532163,1277,91.40714440117813,114.05469910325613
10377,C7_02470C_A,542,C7,532246,533123,877,69.09875673661628,86.21905825451302
10379,C7_02480W_A,986,C7,533816,534331,515,214.06231907283453,267.0996184285423
10381,C7_02490W_A,1874,C7,534960,538232,3272,64.0363886465478,79.9024090139615
10383,C7_02500C_A,178,C7,538375,539295,920,21.63230089669144,26.992042972643613
10385,C7_02510W_A,302,C7,540438,540911,473,71.38654157228247,89.07367769103858
10387,C7_02520W_A,100,C7,541379,542170,791,14.134942843617187,17.637096787477184
10389,C7_02530C_A,508,C7,542111,543661,1550,36.64397298687101,45.72309243818311
10391,C7_02540W_A,455,C7,545757,547433,1676,30.35344035878308,37.87398161871703
10393,C7_02550C_A,248,C7,547659,548327,668,41.509333349501446,51.79392219469796
10395,C7_02560W_A,439,C7,548601,552542,3941,12.454566778744544,15.540381178266085
10397,C7_02570C_A,1286,C7,552627,553001,374,384.45003660538333,479.70356729246697
10399,C7_02600C_A,85938,C7,554233,558933,4700,2044.3625872616299,2550.8855054558962
10401,C7_02610C_A,26862,C7,558964,559916,952,3154.8007586156377,3936.452162594777
10403,C7_02630W_A,456,C7,560574,562490,1916,26.609693861802427,33.202663167306206
10405,C7_02640W_A,2532,C7,563064,564953,1889,149.86571279253903,186.99729534738353
10407,C7_02650W_A,54,C7,565312,566472,1160,5.204827143295383,6.494404760175003
10409,C7_02660C_A,63,C7,566564,567244,680,10.358626569499636,12.925138885446328
10411,C7_02670W_A,280,C7,568036,571017,2981,10.501868973513366,13.103871843309113
10413,C7_02680W_A,691,C7,571203,571655,452,170.92679633644082,213.2765929025678
10415,C7_02690C_A,230,C7,571898,573106,1208,21.287832380292013,26.562226974716257
10417,C7_02750W_A,427,C7,585449,586982,1533,31.14269986974305,38.85879256130418
10419,C7_02760W_A,107,C7,590345,590770,425,28.149156646005363,35.12355201886368
10421,C7_02770W_A,1417,C7,593118,596198,3080,51.4386632514279,64.1833994251735
10423,C7_02780W_A,3895,C7,596435,597913,1478,294.6480478980254,367.65172639982336
10425,C7_02790C_A,3645,C7,597970,601086,3116,130.78882070604254,163.19380382596367
10427,C7_02800W_A,3786,C7,601521,604766,3245,130.44770675591474,162.7681735407531
10429,C7_02810W_A,2089,C7,605320,606051,731,319.51525882148013,398.68017913174435
10431,C7_02830C_A,657,C7,609391,610782,1391,52.8091016647799,65.89338546508739
10433,C7_02840C_A,28851,C7,612138,613691,1553,2077.112193568118,2591.7493407447764
10435,C7_02850W_A,1924,C7,614917,616851,1934,111.22928311590228,138.78808380203165
10437,C7_02860C_A,3640,C7,617611,621030,3419,119.03449205339676,148.52715576009302
10439,C7_02870C_A,436,C7,621309,621806,497,98.0845583125819,122.38654711625715
10441,C7_02880C_A,96,C7,622107,623468,1361,7.886488021843605,9.840489211270148
10443,C7_02890C_A,6418,C7,624651,627284,2633,272.5331863567606,340.05756080890455
10445,C7_02910W_A,22488,C7,629776,632691,2915,862.5470887883542,1076.2566681043513
10447,C7_02920W_A,294,C7,633412,635133,1721,19.100159779515113,23.832524150580877
10449,C7_02930C_A,1434,C7,635249,636553,1304,122.9538409344932,153.4175848424436
10451,C7_02940C_A,4703,C7,636728,639031,2303,228.32400881061017,284.8948656425558
10453,C7_02950C_A,1640,C7,639193,640713,1520,120.63429772667078,150.52333839859804
10455,C7_02960C_A,504,C7,641273,642400,1127,50.00082390246497,62.38931280996276
10457,C7_02970W_A,713,C7,642586,644340,1754,45.449643499268824,56.710506029029325
10459,C7_02980C_A,785,C7,644348,647710,3362,26.106129490188692,32.57433281895343
10461,C7_02990W_A,1040,C7,648090,652049,3959,29.370975955729335,36.64809623958128
10463,C7_03000C_A,757,C7,652101,652583,482,175.5979257365354,219.10506792703524
10465,C7_03010W_A,3096,C7,653587,656172,2585,133.90936320184335,167.08750970343218
10467,C7_03020C_A,752,C7,656372,657406,1034,81.31447119491777,101.46140770105055
10469,C7_03030W_A,262,C7,658010,658528,518,56.55123213893655,70.56268749865534
10471,C7_03040W_A,76,C7,658745,659356,611,13.907303174908195,17.353055817937452
10473,C7_03050W_A,368,C7,659498,660100,602,68.34737944290431,85.28151544307572
10475,C7_03060C_A,567,C7,660102,662387,2285,27.743892606274738,34.61787745248645
10477,C7_03070C_A,3061,C7,662700,667772,5072,67.47682274260836,84.19526465649827
10479,C7_03080W_A,1155,C7,669562,671481,1919,67.29418685066639,83.96737785577432
10481,C7_03090C_A,132,C7,671607,672854,1247,11.835265855555395,14.767638731147294
10483,C7_03110W_A,49,C7,675478,676158,680,8.056709554055272,10.05288579979159
10485,C7_03120W_A,3495,C7,676794,677996,1202,325.0972176672852,405.6451558929793
10487,C7_03130C_A,263,C7,678065,678643,578,50.874300425367025,63.47920685102493
10489,C7_03140W_A,31,C7,679341,681512,2171,1.5965128211346709,1.9920739305653061
10491,C7_03150W_A,30,C7,682298,684385,2087,1.6071978614232671,2.0054063572919674
10493,C7_03160W_A,1477,C7,685122,687359,2237,73.82187156369184,92.11239891143097
10495,C7_03170W_A,307,C7,687921,690194,2273,15.101131171647454,18.842673438542
10497,C7_03180C_A,849,C7,691394,692238,844,112.46976399427386,140.33591328793116
10499,C7_03190C_A,43,C7,692216,692593,377,12.752567929441682,15.912216791311973
10501,C7_03200C_A,343,C7,693435,694121,686,55.903698946505976,69.75471779447226
10503,C7_03210W_A,223,C7,695611,696768,1157,21.54974047548977,26.889026911265884
10505,C7_03220C_A,4026,C7,697006,700323,3317,135.70593425301962,169.32920943053682
10507,C7_03230C_A,75,C7,700560,700940,380,22.067249584147095,27.534757024133786
10509,C7_03240W_A,2132,C7,703277,705439,2162,110.25595388894611,137.5735969822524
10511,C7_03250C_A,17885,C7,705589,707268,1679,1190.991847121214,1486.0787704039742
10513,C7_03260C_A,214,C7,708439,709125,686,34.87869263717866,43.52043617497686
10515,C7_03270W_A,5092,C7,710680,711873,1193,477.2198407973318,595.4585465372217
10517,C7_03280C_A,631,C7,713476,715191,1715,41.13729916646678,51.32971070357084
10519,C7_03290C_A,1078,C7,716697,721385,4688,25.70997758717297,32.08002806418135
10521,C7_03300C_A,964,C7,727464,728846,1382,77.9901096735626,97.31338343541427
10523,C7_03310W_A,725,C7,731779,732447,668,121.34784950963123,151.41368383530656
10525,C7_03320C_A,1290,C7,732621,735782,3161,45.628454059470236,56.93361971203366
10527,C7_03330C_A,4949,C7,736055,737536,1481,373.6224255047374,466.1932455973575
10529,C7_03340C_A,434,C7,737814,738770,956,50.75775176314559,63.33378142845389
10531,C7_03350C_A,783,C7,738908,739837,929,94.23594461811449,117.58437897324386
10533,C7_03360W_A,13003,C7,740654,742282,1628,893.0169501245911,1114.2759158249667
10535,C7_03370C_A,1317,C7,742537,743631,1094,134.59811976699882,167.94691651795242
10537,C7_03380W_A,598,C7,744358,744657,299,223.6147957860239,279.018871177889
10539,C7_03390C_A,1456,C7,744898,745518,620,262.56705053584744,327.62215841532776
10541,C7_03400C_A,2351,C7,745808,748996,3188,82.45269524669733,102.88164462660241
10543,C7_03410C_A,205,C7,749268,751232,1964,11.670324118160615,14.561830089477406
10545,C7_03420C_A,160,C7,753811,755640,1829,9.78085492776485,12.204215251083173
10547,C7_03440W_A,267,C7,756765,758426,1661,17.972652159803847,22.425658821341475
10549,C7_03450C_A,358,C7,758521,759939,1418,28.22781977834857,35.221705176898546
10551,C7_03460W_A,173,C7,762312,764132,1820,10.62784606345663,13.261061734553516
10553,C7_03470W_A,58,C7,765204,765881,677,9.578772640760256,11.952063905699823
10555,C7_03480W_A,682,C7,771011,774148,3137,24.307505694304794,30.33007174742115
10557,C7_03490W_A,2414,C7,774906,777236,2330,115.83822253808192,144.53896030545582
10559,C7_03500W_A,611,C7,777676,778842,1166,58.588610731243826,73.10485861478996
10561,C7_03520W_A,319,C7,779702,780436,734,48.59204349846161,60.631484949418656
10563,C7_03530C_A,281,C7,780464,781264,800,39.27234850992045,49.00268925061676
10565,C7_03540C_A,1230,C7,781559,783811,2252,61.06709565204471,76.19742707566687
10567,C7_03550C_A,11,C7,784193,786196,2003,0.6140196589231809,0.7661526667390862
10569,C7_03560W_A,21,C7,789476,790456,980,2.3958728119931134,2.989487905477382
10571,C7_03570W_A,903,C7,792047,793453,1406,71.8080229711165,89.59958772177589
10573,C7_03580C_A,419,C7,793704,795782,2078,22.54441757323003,28.130150871880534
10575,C7_03590C_A,318,C7,796798,798657,1859,19.12574100590522,23.864443527318105
10577,C7_03600W_A,703,C7,800395,802665,2270,34.625815294620004,43.20490450177444
10579,C7_03610C_A,761,C7,802914,806345,3431,24.799017719784928,30.943363591718676
10581,C7_03620C_A,1260,C7,806681,808660,1979,71.18611487882518,88.82359213848919
10583,C7_03630C_A,267,C7,809086,809449,363,82.23849927667821,102.61437824310795
10585,C7_03640C_A,1014,C7,809748,811217,1469,77.17678792614984,96.29854845962541
10587,C7_03650W_A,219,C7,811482,812438,956,25.612782571725543,31.958751458136867
10589,C7_03660C_A,5762,C7,812904,814979,2075,310.47432610098065,387.39921342819196
10591,C7_03670W_A,5959,C7,815421,817079,1658,401.84576842247174,501.4093647011582
10593,C7_03680W_A,59,C7,817565,819406,1841,3.583181138342045,4.470970505023208
10595,C7_03690W_A,78,C7,820478,821188,710,12.283066247401313,15.326388698503765
10597,C7_03700C_A,480,C7,822571,823998,1427,37.60865521278608,46.92678982669472
10599,C7_03710C_A,473,C7,824288,827590,3302,16.0160203523303,19.984240773340627
10601,C7_03720C_A,2776,C7,827988,829871,1883,164.83129928359065,205.67084078327667
10603,C7_03730C_A,627,C7,830249,833116,2867,24.451774844408263,30.51008584383265
10605,C7_03740C_A,10,C7,834984,835313,329,3.398401151763281,4.240408376563662
10607,C7_03760W_A,324,C7,836244,836981,737,49.15277736409209,61.33114943123205
10609,C7_03770C_A,688,C7,837011,837775,764,100.68519600836679,125.63153361936365
10611,C7_03780C_A,330,C7,838198,839559,1361,27.109802575087397,33.82668166374114
10613,C7_03790W_A,1354,C7,840836,842005,1169,129.50146856042616,161.58748998069365
10615,C7_03800W_A,233,C7,842328,842942,614,42.428540242787925,52.94087702316624
10617,C7_03810W_A,3537,C7,843505,846696,3191,123.9306694915648,154.63643800629796
10619,C7_03820C_A,107,C7,846800,847324,524,22.830899951435647,28.487613755757753
10621,C7_03830C_A,122,C7,847595,848101,506,26.957514907010786,33.636662335674366
10623,C7_03840W_A,644,C7,848744,849739,995,72.36579320914542,90.29555429073395
10625,C7_03850W_A,1305,C7,850058,852295,2237,65.22514718389834,81.38570113704631
10627,C7_03860W_A,4496,C7,853117,854598,1481,339.42340373192553,423.5208794111374
10629,C7_03870W_A,535,C7,855127,855881,754,79.33283537501511,98.98879050409192
10631,C7_03880C_A,557,C7,856037,856963,926,67.2534779982804,83.91658274626576
10633,C7_03890C_A,3144,C7,857114,859144,2030,173.1637728943988,216.06781551312392
10635,C7_03900W_A,15,C7,859698,860027,329,5.097601727644922,6.3606125648454945
10637,C7_03910W_A,288,C7,860161,861222,1061,30.349227703286942,37.86872521170219
10639,C7_03920C_A,2352,C7,861407,861733,326,806.6595087250431,1006.5220628993789
10641,C7_03930C_A,4768,C7,862087,862881,794,671.4076488084141,837.7594318489765
10643,C7_03940C_A,1406,C7,863305,864765,1460,107.67205577916083,134.3494975603123
10645,C7_03950C_A,1,C7,865870,865985,115,0.9722382425479299,1.2131255268603869
10647,C7_03960C_A,1023,C7,866443,867900,1457,78.5030666057318,97.95343349862063
10649,C7_03970C_A,303,C7,868066,868530,464,73.01215853789357,91.10206677467713
10651,C7_03980W_A,291,C7,868824,869354,530,61.388590163899,76.59857689883557
10653,C7_03990C_A,659,C7,869412,870218,806,91.4157260688522,114.06540701378962
10655,C7_04000W_A,890,C7,870453,872111,1658,60.01724012351064,74.88745336197866
10657,C7_04010W_A,4131,C7,872285,874201,1916,241.06281873488118,300.789915666978
10659,C7_04020C_A,2906,C7,874326,875177,851,381.8005855194979,476.39767311571416
10661,C7_04030C_A,1406,C7,875398,878340,2942,53.433447123580834,66.67242231069204
10663,C7_04040C_A,1275,C7,878586,879851,1265,112.69125084078281,140.61227697699942
10665,C7_04050W_A,872,C7,880352,881347,995,97.98598086704162,122.26354556136644
10667,C7_04060W_A,456,C7,881557,883278,1721,29.62473761720712,36.96473133559483
10669,C7_04070C_A,7,C7,883464,883853,389,2.0119583168408317,2.5104525684385903
10671,C7_04080C_A,6,C7,885185,885985,800,0.8385554841975896,1.0463207669170838
10673,C7_04090C_A,2668,C7,887242,888585,1343,222.11626029676535,277.14905000097093
10675,C7_04100C_A,183,C7,889548,890204,656,31.19017349759327,38.91802852557446
10677,C7_04110W_A,540,C7,890327,891421,1094,55.18829512086513,68.86206144244062
10679,C7_04120W_A,128,C7,891570,891977,407,35.16301457077525,43.87520333018402
10681,C7_04130C_A,3191,C7,892096,892941,845,422.22178304923204,526.8338567625111
10683,C7_04140C_A,806,C7,893178,893816,638,141.24884436013735,176.24546251518694
10685,C7_04150W_A,812,C7,893966,896869,2903,31.273719286643367,39.02227409515086
10687,C7_04160W_A,368,C7,897141,898802,1661,24.77129586070343,30.908773206942552
10689,C7_04170W_A,153,C7,898905,899724,819,20.887096309683553,26.06220225287974
10691,C7_04180W_A,751,C7,900072,902312,2240,37.485426704308914,46.773029521114886
10693,C7_04190C_A,2014,C7,902362,904020,1658,135.81429394241619,169.46441693373595
10695,C7_04200C_A,2646,C7,904199,907276,3077,96.14636815889165,119.96813993121455
10697,C7_04210C_A,3906,C7,907552,908649,1097,398.10364281686844,496.740068742404
10699,C7_04220W_A,14,C7,915497,915931,434,3.606690254613288,4.5003043738369195
10701,C7_04230W_A,8828,C7,918812,919744,932,1059.0511894844522,1321.4477439691009
10703,C7_04240C_A,1898,C7,924629,926377,1748,121.40185423394547,151.48106907769832
10705,C7_04250W_A,327,C7,928797,930488,1691,21.620945659973334,26.97787429780299
10707,C7_04260W_A,2105,C7,930547,932679,2132,110.39145054633684,137.74266506319333
10709,C7_04270C_A,1397,C7,932671,933591,920,169.77710310493225,211.8420451279951
10711,C7_04280C_A,1121,C7,933644,934390,746,168.0108485764965,209.63817331797156
10713,C7_04290W_A,387,C7,934460,934858,398,108.71724367988851,135.65364716814454
10715,C7_04300W_A,10480,C7,934878,939083,4205,278.6543471863889,347.69533530847525
10717,C7_04310C_A,1357,C7,939080,940303,1223,124.05775874146951,154.7950156125901
10719,C7_04320W_A,204,C7,940458,940859,401,56.879573990459946,70.97238119736828
10721,C7_04330C_A,312,C7,940993,941499,506,68.94052992612595,86.02162826828199
10723,C7_04340C_A,32,C7,942019,942219,200,17.88918366288191,22.32150969423112
10725,C7_04360C_A,8,C7,942825,943352,527,1.6972660021709591,2.117790293570315
10779,CR_00010C_A,224,CR,4884,6890,2006,12.484973643088072,15.578321820500285
10781,CR_00020W_A,134,CR,9111,9863,752,19.923126752212234,24.859394107604476
10783,CR_00030W_A,1,CR,10308,10418,110,1.0164308899364722,1.268267596263132
10785,CR_00040C_A,122,CR,10646,11815,1169,11.668522277970451,14.559581815099428
10787,CR_00050W_A,594,CR,13684,14823,1139,58.30868687308964,72.75557922724587
10789,CR_00060C_A,1705,CR,14971,16827,1856,102.71099860322487,128.1592606029905
10791,CR_00070W_A,1223,CR,16909,21366,4457,30.679929913204763,38.28136408464868
10793,CR_00080W_A,3856,CR,21385,24462,3077,140.11352820131754,174.8288539587163
10795,CR_00090C_A,932,CR,24474,25163,689,151.24019569852996,188.71232796646774
10797,CR_00100C_A,3546,CR,25279,27540,2261,175.35118661150835,218.79719531110004
10799,CR_00110W_A,1057,CR,28507,30687,2180,54.21120163895121,67.64287771445613
10801,CR_00120C_A,1641,CR,30873,32402,1529,119.9973446320684,149.72857017753952
10803,CR_00130C_A,947,CR,33075,34247,1172,90.34266706884155,112.72648080437753
10805,CR_00140W_A,367,CR,36752,38833,2081,19.71807545734521,24.603538136060852
10807,CR_00150C_A,1600,CR,39001,40227,1226,145.91503803329454,182.06777890889984
10809,CR_00160C_A,222,CR,40843,41283,440,56.411914391474205,70.38885159260383
10811,CR_00170W_A,275,CR,41616,43364,1748,17.589836625044786,21.947994729382
10813,CR_00180C_A,555,CR,43351,44739,1388,44.7068485811395,55.78367201142954
10815,CR_00190W_A,1138,CR,45583,48474,2891,44.011352058888825,54.91585530965717
10817,CR_00200W_A,3046,CR,49655,51316,1661,205.03632389049633,255.8372912726821
10819,CR_00210W_A,2752,CR,52344,53912,1568,196.23339222038834,244.85329511529036
10821,CR_00220W_A,297,CR,54836,56452,1616,20.5487606276142,25.64003859524537
10823,CR_00230W_A,2083,CR,56627,62170,5543,42.01602197567092,52.42615088070926
10825,CR_00240W_A,481,CR,62271,62572,301,178.6689647393314,222.93700504412726
10827,CR_00250W_A,2963,CR,62794,63164,370,895.3657296134984,1117.2066422974124
10829,CR_00260W_A,4026,CR,63737,67375,3638,123.73188123069437,154.3883968337247
10831,CR_00270C_A,328,CR,67399,67866,467,78.52853642164436,97.98521386118585
10833,CR_00280C_A,826,CR,67793,69016,1223,75.51341836437275,94.2230529815766
10835,CR_00290W_A,5573,CR,72120,73049,929,670.7240349383806,836.9064419130116
10837,CR_00300W_A,358,CR,73423,74526,1103,36.289255163824365,45.28048770701917
10839,CR_00310C_A,161,CR,75931,76707,776,23.197153428833662,28.94461228069596
10841,CR_00320C_A,5236,CR,82153,83460,1307,447.9139520794267,558.8916639202092
10843,CR_00330C_A,765,CR,83900,86197,2297,37.23668236314939,46.46265486527756
10845,CR_00340C_A,142,CR,86887,87078,191,83.12382461155862,103.71905682528859
10847,CR_00350W_A,829,CR,88058,89263,1205,76.9197783014995,95.97786066658506
10849,CR_00360C_A,2607,CR,89445,91775,2330,125.09952202020693,156.09489209458297
10851,CR_00370W_A,1051,CR,92310,94889,2579,45.564007439145236,56.85320543000414
10853,CR_00380W_A,211,CR,95282,96580,1298,18.175162523440306,22.678344306061085
10855,CR_00390W_A,405,CR,96952,102066,5114,8.854516258637043,11.048361637372414
10857,CR_00400C_A,1117,CR,102094,104001,1907,65.48970290849205,81.7158046947305
10859,CR_00410W_A,103,CR,104225,105304,1079,10.672995350306053,13.317397465858466
10861,CR_00420W_A,222,CR,105862,107451,1589,15.620668553963908,19.490934361702756
10863,CR_00430C_A,87,CR,107586,107855,269,36.16075693937561,45.12015203062517
10865,CR_00440C_A,2191,CR,108217,112623,4406,55.599184925916745,69.37475564579606
10867,CR_00450C_A,23,CR,112872,112934,62,41.47693792805282,51.753500299124575
10869,CR_00460C_A,239,CR,115600,116151,551,48.49721977573476,60.51316716108483
10871,CR_00470W_A,728,CR,116814,118070,1256,64.80556183607699,80.86215693371943
10873,CR_00480W_A,521,CR,118387,119088,701,83.09793766370788,103.68675597980041
10875,CR_00490W_A,1471,CR,119368,120249,881,186.68408887698135,232.93800198789714
10877,CR_00500C_A,3,CR,120697,120831,134,2.5031506990972825,3.123345572886817
10879,CR_00510C_A,2061,CR,120977,121852,875,263.354339494283,328.6045105700739
10881,CR_00520C_A,1809,CR,122317,125556,3239,62.44507032678561,77.91681660401377
10883,CR_00530W_A,5,CR,126526,127080,554,1.009092038745595,1.2591104295031093
10885,CR_00540C_A,1609,CR,127168,128181,1013,177.58944048356983,221.59001171037679
10887,CR_00550W_A,12,CR,129408,130007,599,2.2398810930152644,2.7948467897618268
10889,CR_00560W_A,1887,CR,130642,133365,2723,77.48092538527858,96.67804074782897
10891,CR_00570W_A,1076,CR,134039,135571,1532,78.5279113138909,97.98443387317512
10893,CR_00580W_A,2345,CR,136149,136787,638,410.9535236036254,512.7737091788007
10895,CR_00590W_A,388,CR,137383,141375,3992,10.867051699020198,13.559534320769156
10897,CR_00600C_A,105,CR,141503,143776,2273,5.164881996817534,6.444562576700033
10899,CR_00610W_A,288,CR,145023,149603,4580,7.0306835356304465,8.77264573135721
10901,CR_00620C_A,3015,CR,149870,151120,1250,269.6794437179449,336.49675864053415
10903,CR_00630W_A,431,CR,152179,153792,1613,29.87538034215012,37.277474729593976
10905,CR_00640W_A,11493,CR,155196,162011,6815,188.5550145244881,235.27247882960225
10907,CR_00650W_A,6,CR,163014,164153,1139,0.5889766350817135,0.7349048406792511
10909,CR_00660W_A,180,CR,164515,165780,1265,15.909353059875219,19.85114498498815
10911,CR_00670C_A,153,CR,165832,167064,1232,13.885171978596453,17.325441270380285
10913,CR_00680W_A,540,CR,167245,168624,1379,43.78244732576247,54.63023583613491
10915,CR_00690C_A,379,CR,168752,170080,1328,31.90888840470748,39.814816331483414
10917,CR_00700W_A,83,CR,170219,171604,1385,6.700371137270753,8.360493251900646
10919,CR_00710C_A,60,CR,171645,172334,689,9.736493285313086,12.148862315437837
10921,CR_00720W_A,1,CR,171661,171984,323,0.3461529346532877,0.43191775724131426
10923,CR_00730C_A,1,CR,172432,172504,72,1.5528805262918324,1.9376310498464517
10925,CR_00740C_A,1517,CR,172978,174627,1649,102.8573818093991,128.34191254604536
10927,CR_00750C_A,264,CR,175807,177243,1436,20.555120504007768,25.647974230836592
10929,CR_00760C_A,418,CR,177792,181469,3677,12.710223638639922,15.859381037851186
10931,CR_00770W_A,1,CR,178149,178532,383,0.29192532086948286,0.3642544010155209
10933,CR_00780C_A,2941,CR,182254,184239,1985,165.65519254576733,206.69886653253693
10935,CR_00790C_A,9,CR,185398,185736,338,2.9771200622399636,3.7147482849127234
10937,CR_00800C_A,994,CR,186234,189002,2768,40.15048898325646,50.09840280903571
10939,CR_00810W_A,141,CR,189237,189632,395,39.91099519725236,49.79957067858526
10941,CR_00820C_A,227,CR,189674,190655,981,25.87184436464191,32.28199987634088
10943,CR_00830W_A,37,CR,191176,192171,995,4.157662032202454,5.187788057076329
10945,CR_00840C_A,1,CR,191346,191900,554,0.20181840774911902,0.2518220859006219
10947,CR_00850C_A,1332,CR,192172,197094,4922,30.257507922286045,37.75428041537466
10949,CR_00860C_A,5799,CR,197957,198460,503,1289.0081518520403,1608.3801530423248
10951,CR_00870C_A,124,CR,198806,199867,1061,13.067028594470765,16.304590021705106
10953,CR_00880W_A,297,CR,200121,201206,1085,30.60534301771848,38.18829711513043
10955,CR_00890C_A,161,CR,201467,201727,260,69.23458100298048,86.38853511469257
10957,CR_00900W_A,1107,CR,202216,203886,1670,74.11424519015823,92.47721269279135
10959,CR_00910W_A,5636,CR,206330,206494,164,3842.3566739330204,4794.360847434704
10961,CR_00920W_A,37,CR,207723,208721,998,4.145164050141726,5.172193503798544
10963,CR_00930W_A,32,CR,210182,210634,452,7.915567992425624,9.876774200987223
10965,CR_00970W_A,45,CR,215621,216148,527,9.547121262211647,11.912570401333022
10967,CR_00980C_A,2495,CR,216776,218971,2195,127.08859122690882,158.5767844165907
10969,CR_00990W_A,96,CR,221203,221703,500,21.467020395458295,26.785811633077348
10971,CR_01000C_A,1440,CR,221874,225995,4121,39.06883110068848,48.74874720894931
10973,CR_01010W_A,22,CR,227653,228033,380,6.473059878016481,8.076862060412576
10975,CR_01020C_A,459,CR,228566,230386,1820,28.197580018072795,35.18397304138765
10977,CR_01030W_A,440,CR,231760,234396,2636,18.662843350882113,23.286855712873894
10979,CR_01040C_A,126,CR,234556,235158,602,23.4015483962118,29.199649309313966
10981,CR_01050C_A,893,CR,235391,237199,1808,55.2234548221569,68.90593251157492
10983,CR_01060W_A,599,CR,238178,239416,1238,54.0974404991229,67.50093046670256
10985,CR_01070W_A,55,CR,239879,240880,1001,6.143263620495162,7.6653536037881596
10987,CR_01080W_A,434,CR,241115,247618,6503,7.461850020846868,9.31064048064
10989,CR_01090W_A,792,CR,248128,250674,2546,34.78062024008856,43.39806480221683
10991,CR_01100C_A,364,CR,250793,251212,419,97.13100914810585,121.19674117989453
10993,CR_01110W_A,1922,CR,251455,253125,1670,128.67893338345448,160.56115880356367
10995,CR_01120C_A,492,CR,253261,253995,734,74.94446834245487,93.51313666179932
10997,CR_01130W_A,1194,CR,254233,258486,4253,31.38914485874824,39.166298164401546
10999,CR_01140C_A,2591,CR,258558,259598,1040,278.55093071230186,347.56629577976463
11001,CR_01150C_A,587,CR,259797,262358,2561,25.6270763620453,31.976586759355886
11003,CR_01160W_A,28,CR,269096,269497,401,7.807000351631756,9.741307223168194
11005,CR_01170W_A,1828,CR,269855,274990,5135,39.80212723435751,49.66372896915104
11007,CR_01180W_A,232,CR,275359,276201,842,30.80678896814581,38.4396544615619
11009,CR_01190C_A,44,CR,276255,276551,296,16.62001860571799,20.737889074032292
11011,CR_01200W_A,235,CR,277552,278730,1178,22.304531837740075,27.830829680307268
11013,CR_01210C_A,1542,CR,278915,280411,1496,115.2453259030912,143.79916422336393
11015,CR_01220W_A,56,CR,282664,284229,1565,4.000775899047072,4.992030922032519
11017,CR_01230C_A,157,CR,288278,290905,2627,6.682056135973688,8.33764042156996
11019,CR_01240C_A,1038,CR,291720,295238,3518,32.98922086780739,41.16281811862547
11021,CR_01250C_A,1,CR,299565,299870,305,0.3665816324361047,0.457407985537523
11023,CR_01260W_A,578,CR,300879,303074,2195,29.441765823307932,36.73642540793163
11025,CR_01270C_A,299,CR,303468,305003,1535,21.778770013036205,27.174802111462157
11027,CR_01280C_A,309,CR,305767,306345,578,59.772467039689786,74.58203390481636
11029,CR_01290C_A,1931,CR,307230,310298,3068,70.37160538833314,87.807275137631
11031,CR_01300W_A,705,CR,310826,311203,377,209.08279977340433,260.8863450668591
11033,CR_01310W_A,4779,CR,311996,313136,1140,468.70838116728436,584.8382391926017
11035,CR_01320C_A,493,CR,313501,316497,2996,18.398213338202567,22.956659461064632
11037,CR_01330W_A,963,CR,318322,321771,3449,31.21789625136866,38.952620026718925
11039,CR_01340W_A,93,CR,322485,324131,1646,6.3171859076853645,7.882367867419101
11041,CR_01350C_A,795,CR,324493,325374,881,100.89316835975538,125.89103438502939
11043,CR_01360W_A,119,CR,325668,326258,590,22.550983642827834,28.13834378827864
11045,CR_01370C_A,2198,CR,326329,327291,962,255.46014612145558,318.75440688617465
11047,CR_01380W_A,542,CR,327526,330459,2933,20.661305713608073,25.780468492740514
11049,CR_01390W_A,2320,CR,330749,331477,728,356.3092899887194,444.59050901971324
11051,CR_01400W_A,3220,CR,332022,333152,1130,318.6016116951314,397.5401615897357
11053,CR_01410C_A,332,CR,333193,334479,1286,28.864740358071515,36.01643282700589
11055,CR_01420W_A,1728,CR,334910,336898,1988,97.18469997943896,121.26373475739241
11057,CR_01430W_A,263,CR,337258,337875,617,47.65858289442811,59.46674482964733
11059,CR_01440C_A,572,CR,338122,338310,188,340.1799552915044,424.4648784940227
11061,CR_01450C_A,1,CR,339491,339606,115,0.9722382425479299,1.2131255268603869
11063,CR_01460C_A,2,CR,340527,340859,332,0.6735385415241683,0.8404182866803886
11065,CR_01470W_A,2128,CR,341030,341995,965,246.55558830707713,307.64360511220093
11067,CR_01480W_A,1301,CR,342520,344247,1727,84.22780814059556,105.09656960116781
11069,CR_01490C_A,648,CR,344477,344854,377,192.17823298321414,239.79340652953857
11071,CR_01500W_A,1043,CR,345897,348482,2585,45.1122305618613,56.28949374052964
11073,CR_01510C_A,10,CR,349038,349379,341,3.2788093223757167,4.0911857943972
11075,CR_01520W_A,1434,CR,349630,351381,1751,91.56585298605319,114.25273023103736
11077,CR_01530C_A,23,CR,352937,353272,335,7.676328810564999,9.578259756852907
11079,CR_01540W_A,606,CR,353346,355763,2417,28.032802285132494,34.97836903884997
11081,CR_01550C_A,83,CR,355983,357224,1241,7.477851752715545,9.330606892733597
11083,CR_01560W_A,140,CR,357404,358150,746,20.9826215885009,26.18139541883677
11085,CR_01570W_A,217,CR,358522,359118,596,40.70839822614697,50.79454282349155
11087,CR_01580C_A,675,CR,359334,361136,1802,41.88123949932468,52.257973930376
11089,CR_01590C_A,1381,CR,361874,363512,1638,94.26496733226465,117.62059252034943
11091,CR_01600C_A,555,CR,363823,366783,2960,20.96388710493974,26.158019172927094
11093,CR_01610C_A,1396,CR,367035,368150,1115,139.9848676759145,174.66831576875924
11095,CR_01620C_A,23358,CR,368747,371050,2303,1133.9979157555244,1414.9636979967718
11097,CR_01630C_A,68,CR,372034,373998,1964,3.8711319026093753,4.8302655906559195
11099,CR_01640C_A,38,CR,374212,375279,1067,3.981894207998551,4.9684709956700015
11101,CR_01650W_A,383,CR,377249,377905,656,65.27779480643838,81.45139303439902
11103,CR_01660C_A,1280,CR,378021,378848,827,173.05135344988548,215.92754238675812
11105,CR_01670W_A,289,CR,379272,380720,1448,22.31515054632628,27.844079340611163
11107,CR_01680C_A,1395,CR,380831,383137,2306,67.6371726195801,84.39534373225393
11109,CR_01690C_A,7387,CR,384286,387579,3293,250.81118986810787,312.9535987535782
11111,CR_01700C_A,655,CR,387843,390590,2747,26.659572486320656,33.26490000391651
11113,CR_01710W_A,378,CR,390661,391524,863,48.972417617101414,61.10610272609621
11115,CR_01720W_A,723,CR,391750,394848,3098,26.093204866574453,32.55820591698092
11117,CR_01730W_A,7509,CR,395478,396188,710,1182.4813391248263,1475.4596504751894
11119,CR_01740W_A,1320,CR,396471,396890,419,352.2333298777465,439.5046658171999
11121,CR_01750C_A,2566,CR,397246,397878,632,453.9521882808048,566.4259679133412
11123,CR_01760C_A,6415,CR,398686,400464,1778,403.399582386767,503.3481604629241
11125,CR_01770C_A,1794,CR,400727,403447,2720,73.74355581619979,92.01467920829647
11127,CR_01780W_A,238,CR,404537,405496,959,27.747821374908078,34.62277963521251
11129,CR_01790C_A,352,CR,405497,407908,2411,16.323601849166405,20.3680304136493
11131,CR_01800C_A,167,CR,408029,409024,995,18.765663766967833,23.415151500858023
11133,CR_01810C_A,46,CR,409235,410230,995,5.168985229224673,6.449682449338138
11135,CR_01820W_A,1502,CR,410663,413719,3056,54.952457995845535,68.56779196812651
11137,CR_01830C_A,5,CR,414010,415965,1955,0.2859524242788029,0.35680162554717265
11139,CR_01870C_A,2,CR,418960,419550,590,0.37900812845088794,0.4729133409794729
11141,CR_01900C_A,192,CR,420757,422253,1496,14.34961256380902,17.90495430018539
11143,CR_01910C_A,43,CR,422477,423115,638,7.535608321942812,9.40267355850253
11145,CR_01920W_A,27,CR,423365,424666,1301,2.3203687495090874,2.8952765264423537
11147,CR_01930C_A,633,CR,425221,426345,1124,62.96626589526384,78.56714655498388
11149,CR_01950W_A,945,CR,427487,428386,899,117.52835484860545,146.6478494233065
11151,CR_01960C_A,416,CR,428526,429932,1406,33.080993971189876,41.27732944879155
11153,CR_01970C_A,2222,CR,430298,431046,748,332.1337407998296,414.425088073041
11155,CR_01980C_A,972,CR,431374,432228,854,127.2561952599621,158.78591497945442
11157,CR_01990C_A,156,CR,433224,435581,2357,7.400065367547673,9.233547709747706
11159,CR_02000C_A,2115,CR,436061,437755,1694,139.59424235166486,174.18090688938472
11161,CR_02020C_A,361,CR,440887,443238,2351,17.168213798118806,21.421908229523165
11163,CR_02030C_A,359,CR,445207,446703,1496,26.830785991705405,33.47853434253415
11165,CR_02040W_A,2112,CR,447150,449222,2072,113.96584186778053,142.20266793622142
11167,CR_02050C_A,1016,CR,449417,451918,2501,45.4203583603759,56.67396503733212
11169,CR_02060W_A,413,CR,452957,453880,923,50.0286623291592,62.42404864380724
11171,CR_02070C_A,6427,CR,454017,455027,1010,711.4714319389977,887.7496460694518
11173,CR_02080W_A,12,CR,456551,456671,120,11.180739789301194,13.950943558894451
11175,CR_02090C_A,1687,CR,456872,458434,1562,120.75485291005836,150.67376302083827
11177,CR_02100C_A,271,CR,458808,459412,604,50.16523978312291,62.594465305635694
11179,CR_02110W_A,1133,CR,459667,462309,2642,47.94768425919097,59.82747559510754
11181,CR_02120C_A,140,CR,462365,463117,752,20.815207054550097,25.972501306452436
11183,CR_02130W_A,1360,CR,463707,464792,1085,140.1456784649735,174.86896995480603
11185,CR_02140W_A,642,CR,465453,466273,820,87.53701152111422,109.22568005866142
11187,CR_02150W_A,554,CR,467256,469313,2057,30.112444546781052,37.573275311752674
11189,CR_02160W_A,934,CR,470534,475072,4538,23.01192367388126,28.713488946688884
11191,CR_02170W_A,878,CR,475602,476831,1229,79.87542339305492,99.66581321976672
11193,CR_02180W_A,8,CR,478027,479415,1388,0.6444230426110198,0.8040889659305159
11195,CR_02190C_A,914,CR,479677,482430,2753,37.120218552202296,46.31733531721587
11197,CR_02200C_A,893,CR,484025,485110,1085,92.02212563913335,114.82205159532485
11199,CR_02210W_A,1157,CR,490308,493292,2984,43.35159496052776,54.09263303498955
11201,CR_02220C_A,76,CR,493892,496609,2717,3.1274796613429916,3.9023618346557907
11203,CR_02230W_A,4,CR,497838,498158,320,1.3975924736626493,1.7438679448618064
11205,CR_02240C_A,24,CR,499907,502696,2789,0.9621289169710602,1.200511457201387
11207,CR_02250C_A,783,CR,504777,507014,2237,39.13508831033901,48.83142068222779
11209,CR_02260C_A,335,CR,507449,508468,1019,36.757093517329736,45.864240355541135
11211,CR_02270C_A,361,CR,508632,509357,725,55.67237329569285,69.46607758290892
11213,CR_02280W_A,2138,CR,510499,511347,848,281.8917649708249,351.7348741617493
11215,CR_02290W_A,75,CR,511771,512280,509,16.47456746950078,20.556400135895558
11217,CR_02300C_A,4630,CR,512524,514905,2381,217.41631761639874,271.28462275380645
11219,CR_02310C_A,1,CR,515738,515811,73,1.531608190315232,1.9110881587526645
11221,CR_02320W_A,1,CR,516594,516683,89,1.2562628976742913,1.567521748190388
11223,CR_02330C_A,275,CR,516753,517862,1109,27.72500849466031,34.59431450582483
11225,CR_02340W_A,17,CR,518245,519572,1327,1.432347976022007,1.7872346684341045
11227,CR_02350C_A,1057,CR,520042,522621,2579,45.82412546448764,57.177771778795794
11229,CR_02360W_A,3803,CR,525541,526779,1238,343.4600437698905,428.5576603754087
11231,CR_02370W_A,1240,CR,527702,528628,926,149.7204896191521,186.81609085344624
11233,CR_02380C_A,68,CR,528825,529232,407,18.680351490724355,23.308701769160262
11235,CR_02390W_A,1000,CR,530045,532714,2669,41.89111948033419,52.270301831751404
11237,CR_02400W_A,14,CR,533719,535104,1385,1.1301830833950666,1.4102036810434824
11239,CR_02410W_A,839,CR,535397,538387,2990,31.373380211450513,39.14662757830249
11241,CR_02420W_A,776,CR,538766,539575,809,107.24665113099786,133.81869223364765
11243,CR_02430C_A,1601,CR,539688,542237,2549,70.22504669545395,87.62440422828566
11245,CR_02440W_A,132,CR,542623,542955,332,44.453543740595116,55.46760692090565
11247,CR_02460W_A,611,CR,544683,546848,2165,31.553958481584434,39.37194694912013
11249,CR_02470W_A,1675,CR,547329,547457,128,1463.104620865586,1825.6117547772035
11251,CR_02480W_A,1,CR,548257,548727,470,0.23788808062342964,0.2968285863594564
11253,CR_02490W_A,69,CR,550905,552005,1100,7.013373140561659,8.75104641421561
11255,CR_02500W_A,161,CR,552462,554012,1550,11.613542619854789,14.490980083754883
11257,CR_02510W_A,1685,CR,556957,560259,3302,57.05495622341767,71.19121713124515
11259,CR_02520W_A,230,CR,560832,561227,395,65.10304181112089,81.23334224166388
11261,CR_02530W_A,4215,CR,561929,564680,2751,171.30795424174678,213.7521886613599
11263,CR_02540W_A,335,CR,566051,568717,2666,14.049316689481996,17.530255409713583
11265,CR_02550C_A,221,CR,568818,569693,875,28.239354210692163,35.236097445893414
11267,CR_02560C_A,557,CR,570071,573043,2972,20.954482041186964,26.14628385701282
11269,CR_02570C_A,256,CR,574720,575925,1205,23.75327291337017,29.63851909607452
11271,CR_02580W_A,315,CR,576979,577929,950,37.07297930136711,46.25839180054476
11273,CR_02590C_A,527,CR,578065,581277,3212,18.344489006730168,22.889624083242143
11275,CR_02600W_A,5,CR,581329,581982,653,0.8561056500230624,1.0682192617836486
11277,CR_02610C_A,1083,CR,582048,583778,1730,69.99272365209939,87.33451950452422
11279,CR_02620C_A,737,CR,584443,584970,527,156.36063044999963,195.10143079516527
11281,CR_02630C_A,12,CR,585248,586093,845,1.5877973665279803,1.981199085286786
11283,CR_02640W_A,1266,CR,600287,602089,1802,78.55059141651117,98.01273332719407
11285,CR_02650C_A,538,CR,609126,610355,1229,48.94416604266918,61.07085138067709
11287,CR_02660C_A,1,CR,612660,612749,89,1.2562628976742913,1.567521748190388
11289,CR_02670C_A,645,CR,613118,614518,1400,51.511265457851934,64.27398996776373
11291,CR_02680W_A,251,CR,615879,618245,2366,11.861224374956043,14.800028881160218
11293,CR_02690W_A,230,CR,618837,619685,848,30.325119711548055,37.83864408662411
11295,CR_02700W_A,86,CR,620000,620383,383,25.105577594775532,31.325878487334798
11297,CR_02710W_A,571,CR,620810,622459,1649,38.71559987684041,48.30799740526823
11299,CR_02720C_A,431,CR,622652,623521,869,55.45338146362272,69.19282708726708
11301,CR_02740W_A,2211,CR,627510,629489,1979,124.91468253736706,155.86425572872983
11303,CR_02750C_A,3,CR,630053,630646,593,0.5656360770304145,0.7057812930300734
11305,CR_02760C_A,571,CR,632985,634427,1442,44.273248402850086,55.242640583417
11307,CR_02770C_A,225,CR,634965,636134,1169,21.519815676584848,26.851687773748946
11309,CR_02780W_A,71,CR,636866,637357,491,16.16766853442739,20.173462172739434
11311,CR_02790C_A,240,CR,637548,638519,971,27.63519618364868,34.482249785115016
11313,CR_02800C_A,156,CR,638889,641339,2450,7.119164927065251,8.883049776275652
11315,CR_02810W_A,459,CR,641816,643483,1667,30.785600259683555,38.413215918011716
11317,CR_02820W_A,1406,CR,644421,646103,1682,93.46088075955696,116.61728087874909
11319,CR_02850C_A,2907,CR,647406,649544,2138,152.02250031570895,189.68846083117947
11321,CR_02860W_A,1999,CR,653851,654447,596,375.0050140740451,467.9183921850672
11323,CR_02870W_A,841,CR,655163,657649,2486,37.82382205471563,47.195267630853714
11325,CR_02880W_A,96,CR,658227,658640,413,25.98912880806089,32.42834338144957
11327,CR_02890C_A,368,CR,658855,660642,1787,23.024690780429992,28.729419304270607
11329,CR_02910W_A,780,CR,664676,666961,2285,38.166201468949374,47.62247691876442
11331,CR_02920C_A,211,CR,667781,668602,821,28.73490981172414,35.85443472505151
11333,CR_02930W_A,3652,CR,672970,678726,5756,70.93825870487832,88.51432570723165
11335,CR_02940C_A,264,CR,678887,679966,1079,27.356026917289302,34.13391195132655
11337,CR_02950C_A,922,CR,680604,681185,581,177.42929579579518,221.39018866266235
11339,CR_02960W_A,133,CR,681670,682533,863,17.231035828239385,21.500295403626442
11341,CR_02970C_A,1447,CR,682676,685207,2531,63.92149535803567,79.7590491099181
11343,CR_02980C_A,1084,CR,685569,686855,1286,94.24511610888409,117.59582284480237
11345,CR_02990C_A,652,CR,686998,688026,1028,70.91286325510097,88.4826381361788
11347,CR_03000C_A,383,CR,689760,690260,500,85.64446678604715,106.8642276611315
11349,CR_03010C_A,599,CR,690457,691064,607,110.33382427992447,137.67076098480686
11351,CR_03020C_A,461,CR,691388,692170,782,65.91203379626407,82.24277468862329
11353,CR_03030C_A,12065,CR,692731,693531,800,1686.1953194739865,2103.9766754757693
11355,CR_03040C_A,481,CR,693874,695364,1490,36.09352911848238,45.036267461934436
11357,CR_03050C_A,1135,CR,695733,697517,1784,71.13306984785234,88.7574043685269
11359,CR_03060W_A,3461,CR,698441,699550,1109,348.9318341818885,435.3851727442173
11361,CR_03070W_A,490,CR,699794,700975,1181,46.389182868396155,57.882831023355465
11363,CR_03080C_A,235,CR,700998,701573,575,45.69519739975271,57.01689976243819
11365,CR_03090C_A,417,CR,701827,702325,498,93.6218572718594,116.81814184857402
11367,CR_03100W_A,1302,CR,702956,706177,3221,45.19504255097844,56.39282369972237
11369,CR_03110W_A,1041,CR,706382,707911,1529,76.12262995855163,94.98320631006621
11371,CR_03120W_A,2017,CR,708144,709112,968,232.97058011384826,290.69269791622014
11373,CR_03130W_A,62,CR,709559,709993,434,15.972485413287421,19.929919369849216
11375,CR_03140C_A,153,CR,710184,710984,800,21.38316484703854,26.681179556385636
11377,CR_03150W_A,1661,CR,711420,714107,2687,69.11503085236058,86.23936453786261
11379,CR_03160W_A,192,CR,714284,715111,827,25.95770301748282,32.38913135801372
11381,CR_03170W_A,5212,CR,715385,717121,1736,335.67981441150823,418.8497570792505
11383,CR_03180W_A,233,CR,717480,718601,1121,23.23918261290971,28.997054854793998
11385,CR_03190C_A,2,CR,718810,719053,243,0.9202254970618267,1.1482258073164158
11387,CR_03200C_A,602,CR,719189,721528,2339,28.77642305754305,35.90623352909132
11389,CR_03210C_A,433,CR,721748,722428,680,71.19500483481497,88.83468472060731
11391,CR_03220C_A,222,CR,722592,723932,1340,18.523315173319887,23.11275723936245
11393,CR_03230W_A,968,CR,724231,726348,2117,51.124025111211886,63.79080474733032
11395,CR_03240C_A,378,CR,726435,728183,1748,24.17802997915247,30.168516391659622
11397,CR_03250C_A,640,CR,728528,729391,863,82.91626263212937,103.46006810767612
11399,CR_03260W_A,259,CR,731819,732900,1081,26.788266470203602,33.425479942217045
11401,CR_03270W_A,255,CR,734584,736089,1505,18.944110606457176,23.637811345635114
11403,CR_03280W_A,1419,CR,737211,738287,1076,147.44860372693674,183.98130957315266
11405,CR_03290C_A,292,CR,738489,740051,1562,20.901254919820417,26.079868880903838
11407,CR_03300C_A,18,CR,740776,741861,1085,1.85486927380112,2.3144422494018446
11409,CR_03310C_A,387,CR,742230,743781,1551,27.89778400038403,34.809897854881704
11411,CR_03320C_A,1,CR,743131,743781,650,0.1720113813738645,0.21462990090606848
11413,CR_03330W_A,437,CR,744085,745158,1073,45.535724957359015,56.81791551944898
11415,CR_03340C_A,247,CR,745188,746252,1064,25.95528879659206,32.38611897600497
11417,CR_03350C_A,1712,CR,746467,748209,1742,109.88189735524482,137.10686207133926
11419,CR_03360W_A,427,CR,748450,749193,743,64.25539555897187,80.1756783263517
11421,CR_03370C_A,351,CR,749202,750068,866,45.31685526610531,56.54481742692785
11423,CR_03380W_A,352,CR,750308,751414,1106,35.58427130048843,44.40083302649951
11425,CR_03390C_A,343,CR,751411,753240,1829,20.9677077513959,26.16278644450955
11427,CR_03400W_A,2710,CR,753492,756413,2921,103.73093060255475,129.43189676345074
11429,CR_03410W_A,179,CR,756742,757680,938,21.33637976849588,26.622802740320967
11431,CR_03420C_A,1881,CR,757726,759538,1812,116.06496436907035,144.82188098388778
11433,CR_03430W_A,146,CR,759808,760161,353,46.243286380679166,57.70078639089489
11435,CR_03440W_A,61,CR,760304,761083,779,8.755136420377058,10.924358884371777
11437,CR_03450W_A,1,CR,762146,763934,1788,0.06253210172987245,0.07802541140321281
11439,CR_03460W_A,885,CR,764417,765511,1094,90.44748367030674,112.85726736399991
11441,CR_03470W_A,1455,CR,767511,769010,1499,108.52552630709299,135.4144288071476
11443,CR_03480W_A,361,CR,770493,772619,2126,18.985169632820938,23.689043390220583
11445,CR_03490W_A,528,CR,773209,775044,1835,32.17128397139526,40.14222451823581
11447,CR_03500W_A,20261,CR,777835,779331,1496,1514.2578133090342,1889.438953521126
11449,CR_03510W_A,184,CR,780328,782037,1709,12.037777186842714,15.020325423268453
11451,CR_03520C_A,1408,CR,782046,783887,1841,85.51049225060338,106.69705883174029
11453,CR_03530W_A,4457,CR,784375,786078,1703,292.6163079325627,365.1165909688348
11455,CR_03540W_A,243,CR,786518,787492,974,27.89445347844138,34.80574214385371
11457,CR_03550W_A,626,CR,787654,789012,1358,51.540081797515086,64.30994600786396
11459,CR_03560W_A,268,CR,789311,790126,815,36.766113662978164,45.875495383849234
11461,CR_03570C_A,190,CR,790132,791100,968,21.94566694181019,27.38305037386307
11463,CR_03580C_A,202,CR,791587,792717,1130,19.986809180874705,24.938854857492736
11465,CR_03590C_A,52,CR,794436,795215,779,7.463394981305034,9.312568229300533
11467,CR_03600C_A,356,CR,795625,796227,602,66.118660548027,82.5005964612363
11469,CR_03610C_A,967,CR,796561,798915,2354,45.92937712937236,57.30910119562844
11471,CR_03620C_A,631,CR,801143,803746,2603,27.10352211697677,33.818845123558965
11473,CR_03630W_A,143,CR,804770,807595,2825,5.659631114584322,7.061893553705863
11475,CR_03640C_A,733,CR,808438,809547,1109,73.8997499148582,92.20957284643492
11477,CR_03650W_A,1869,CR,809883,812918,3035,68.85272707151213,85.91207087833189
11479,CR_03660C_A,900,CR,812990,814756,1766,56.97998760119522,71.09767385620049
11481,CR_03670W_A,5,CR,816393,818339,1946,0.2872749175051694,0.35845178722750387
11483,CR_03680C_A,1503,CR,818425,822147,3722,45.149521502739645,56.336024097308865
11485,CR_03690W_A,418,CR,823246,825456,2210,21.147281592433934,26.38685252315783
11487,CR_03700C_A,1116,CR,825518,829063,3545,35.19804119847711,43.91890835465785
11489,CR_03710C_A,972,CR,829626,830528,902,120.48424695344526,150.33611019119076
11491,CR_03720W_A,11857,CR,831859,832830,971,1365.29383812301,1703.5668154254533
11493,CR_03730C_A,739,CR,833215,834933,1718,48.09410188762272,60.0101704890745
11495,CR_03740C_A,636,CR,836037,836567,530,134.16887747161434,167.41132270673342
11497,CR_03750C_A,301,CR,836856,838037,1181,28.49621233344335,35.556596200061215
11499,CR_03760W_A,561,CR,839136,839924,788,79.59892159642095,99.32080376319526
11501,CR_03770C_A,3741,CR,840282,840809,527,793.6840142651948,990.3316860308187
11503,CR_03780C_A,490,CR,841232,841969,737,74.33599045804051,92.75389883118427
11505,CR_03790C_A,860,CR,844006,844398,392,245.2917402754854,306.06661889411293
11507,CR_03800C_A,277,CR,847829,848824,995,31.12628061946162,38.838305184057916
11509,CR_03810W_A,172,CR,849445,852048,2603,7.387964824278931,9.218449066960606
11511,CR_03820C_A,307,CR,852102,853577,1475,23.27109908688452,29.03687913613964
11513,CR_03830C_A,892,CR,853958,856669,2711,36.78797451883683,45.90277260986297
11515,CR_03840C_A,160,CR,857988,858500,512,34.93981184156623,43.59669862154516
11517,CR_03850W_A,457,CR,860662,862605,1943,26.297468264079495,32.813078777224725
11519,CR_03860C_A,872,CR,862757,864421,1664,58.59137678047261,73.10830999612958
11521,CR_03870W_A,729,CR,864747,865049,302,269.89269226491956,336.7628428620548
11523,CR_03880W_A,95,CR,866454,869279,2825,3.7598947964021714,4.69146774546893
11525,CR_03890W_A,113,CR,878579,880504,1925,6.56323946073265,8.189385050156224
11527,CR_03900W_A,664,CR,884029,885798,1769,41.96727654096096,52.36532799946815
11529,CR_03910C_A,800,CR,885976,888228,2252,39.71843619645185,49.55930216303535
11531,CR_03920C_A,276,CR,888806,890914,2108,14.638919268724525,18.26594128204397
11533,CR_03930C_A,366,CR,892917,894218,1301,31.453887493345405,39.24708180288523
11535,CR_03940W_A,236,CR,894731,895831,1100,23.987769002500745,29.93111527180991
11537,CR_03950W_A,417,CR,896166,896951,785,59.393229199217814,74.10883393705716
11539,CR_03960C_A,255,CR,897030,898727,1697,16.800758080564552,20.96340959056031
11541,CR_03970C_A,165,CR,899035,899762,727,25.375819329225546,31.663076853061682
11543,CR_03980W_A,514,CR,900136,900864,728,78.94093752336283,98.49979380867785
11545,CR_03990C_A,1389,CR,901285,902727,1442,107.69797203425354,134.38183497437166
11547,CR_04000W_A,3101,CR,903050,904336,1286,269.60710798307156,336.40650059200385
11549,CR_04010C_A,2191,CR,904414,905430,1016,241.11221336967438,300.85154859781244
11551,CR_04020C_A,278,CR,905753,906449,696,44.65870203197891,55.72359639903244
11553,CR_04030W_A,758,CR,906681,909368,2687,31.540754597284355,39.35547159524374
11555,CR_04040C_A,319,CR,909343,910701,1358,26.26403529298293,32.771362262793296
11557,CR_04050C_A,1726,CR,911098,912951,1853,104.14439760568733,129.947806706162
11559,CR_04060C_A,1395,CR,913389,913856,467,333.9856960615668,416.73589431815327
11561,CR_04070W_A,648,CR,914672,915199,527,137.4785461758477,171.5410137791955
11563,CR_04080C_A,2517,CR,915381,917402,2021,139.24751137887733,173.7482678759888
11565,CR_04090C_A,9133,CR,917825,919603,1778,574.3177530691103,716.6139905702082
11567,CR_04100C_A,7028,CR,920395,921009,614,1279.7758833747362,1596.8604451451172
11569,CR_04110W_A,797,CR,921803,923548,1745,51.066186888670785,63.71863619735746
11571,CR_04120C_A,3090,CR,923584,926355,2771,124.67876560426089,155.56988667262308
11573,CR_04130C_A,1703,CR,926631,927968,1337,142.41435947030618,177.69975228718963
11575,CR_04140W_A,2859,CR,928306,929691,1385,230.7995311018925,287.9837374359512
11577,CR_04150W_A,227,CR,929946,930866,920,27.587260132297512,34.42243682466348
11579,CR_04160C_A,697,CR,930968,932329,1361,57.25918907526035,71.44605187765931
11581,CR_04170W_A,2265,CR,932629,934485,1856,136.44598934680607,170.25262478931
11583,CR_04180C_A,3091,CR,934581,936911,2330,148.3247497370386,185.0745345087672
11585,CR_04190W_A,3220,CR,937197,938834,1637,219.92658595937598,274.41684947855913
11587,CR_04200W_A,2772,CR,939255,940436,1181,262.43023451264105,327.4514440749823
11589,CR_04210C_A,748,CR,941149,942678,1529,54.69714429298427,68.24922028811673
11591,CR_04220C_A,122,CR,943890,945383,1493,9.136304449395483,11.399967275185016
11593,CR_04230W_A,327,CR,947438,948166,728,50.22118009754795,62.66426571096821
11595,CR_04240C_A,2526,CR,948342,951470,3128,90.28947796603202,112.66011326651977
11597,CR_04250W_A,40,CR,952020,953492,1472,3.0382445079622813,3.79101727143871
11599,CR_04260W_A,131,CR,953783,954152,369,39.69314125741075,49.527740005831255
11601,CR_04270C_A,130,CR,954290,954736,446,32.58960028271649,40.664185261351534
11603,CR_04275W_A,410,CR,955228,955492,264,173.640277030814,216.66238102828504
11605,CR_04280C_A,281,CR,955596,957281,1685,18.645625405303477,23.265371751034664
11607,CR_04290W_A,283,CR,957628,957945,317,99.8154372357173,124.5462784595309
11609,CR_04300W_A,7687,CR,958467,960608,2141,401.43085829219194,500.8916540738984
11611,CR_04310C_A,107,CR,960689,961276,587,20.380564862951072,25.43016968997796
11613,CR_04330W_A,449,CR,961901,963100,1199,41.869492622153764,52.24331658001342
11615,CR_04340W_A,10158,CR,963533,966769,3236,350.97019400408385,437.92856820534564
11617,CR_04350C_A,247,CR,966882,968228,1346,20.51740511112478,25.600914257406608
11619,CR_04360C_A,945,CR,968673,969152,479,220.58035701230958,275.2326025710909
11621,CR_04370W_A,136,CR,969415,970200,785,19.37045364770653,24.16978756700185
11623,CR_04380C_A,4196,CR,970313,973171,2858,164.15109921591258,204.8221104727821
11625,CR_04390C_A,508,CR,973585,975972,2387,23.794787653812346,29.69031976505396
11627,CR_04400W_A,20,CR,977144,977368,224,9.982803383304638,12.456199606155762
11629,CR_04410W_A,19,CR,977512,978837,1325,1.6032758943148882,2.000512661275431
11631,CR_04420C_A,269,CR,979245,979751,506,59.43911073758935,74.16608334669183
11633,CR_04430W_A,6,CR,980798,981112,314,2.1364470934970434,2.665785393419322
11635,CR_04440C_A,83,CR,982073,982408,335,27.70153440334326,34.56502433994745
11637,CR_04450C_A,1620,CR,984184,986580,2396,75.59598688926518,94.32607915446165
11639,CR_04460C_A,341,CR,986837,987634,797,47.83729320140159,59.689733420113015
11641,CR_04470W_A,113,CR,987812,988726,914,13.823015275613074,17.247884268655064
11643,CR_04480C_A,1131,CR,988875,990404,1529,82.70383715957914,103.19501089018722
11645,CR_04490C_A,244,CR,990786,991736,950,28.716847458836753,35.831897140739436
11647,CR_04500C_A,954,CR,992082,993203,1121,95.15098803740715,118.72613876168872
11649,CR_04510W_A,14034,CR,995376,996830,1454,1079.1643892919735,1346.5443047147505
11651,CR_04520W_A,128,CR,997160,997549,389,36.79009493651807,45.905418394305656
11653,CR_04530W_A,1176,CR,997809,999197,1388,94.73018726381991,118.20107799178584
11655,CR_04540C_A,97,CR,999194,999619,425,25.518394342640374,31.84097706382969
11657,CR_04550W_A,1113,CR,999810,1000746,936,132.95046352021615,165.89102757531543
11659,CR_04560C_A,691,CR,1000795,1001913,1118,69.10457240077929,86.22631484075193
11661,CR_04570C_A,2088,CR,1002171,1003244,1073,217.5711526566719,271.47782060551367
11663,CR_04580W_A,2190,CR,1004038,1004661,623,393.03082084381407,490.41037550527847
11665,CR_04590C_A,1323,CR,1004818,1005627,809,182.84448382256465,228.14707451690182
11667,CR_04600W_A,545,CR,1006481,1008139,1658,36.75213018799247,45.85804728345884
11669,CR_04610C_A,182,CR,1008189,1009691,1502,13.547900410471488,16.90460537762177
11671,CR_04620C_A,3,CR,1009945,1011462,1517,0.22110889497629257,0.27589209411129434
11673,CR_04630C_A,121,CR,1011959,1013122,1163,11.63258395963409,14.514739214326987
11675,CR_04640W_A,81,CR,1014145,1015671,1526,5.934730818698537,7.405153527329296
11677,CR_04650W_A,178,CR,1015922,1016209,287,69.3439610625649,86.52501580080879
11679,CR_04660C_A,3650,CR,1016385,1018027,1642,248.53654221041023,310.11537143705687
11681,CR_04670C_A,3,CR,1018393,1018749,356,0.9421971732557186,1.175641311142791
11683,CR_04680C_A,13,CR,1019056,1019358,302,4.8129012338051504,6.005373055153241
11685,CR_04690C_A,1,CR,1019991,1020106,115,0.9722382425479299,1.2131255268603869
11687,CR_04700C_A,1,CR,1020200,1020314,114,0.9807666481843152,1.2237669788503904
11689,CR_04710W_A,31,CR,1020906,1021310,404,8.579280531394481,10.704931938755642
11691,CR_04720C_A,1110,CR,1021410,1025573,4163,29.811725116801167,37.198047923067115
11693,CR_04730W_A,200,CR,1026934,1027266,332,67.35385415241683,84.04182866803886
11695,CR_04740C_A,2378,CR,1027449,1031561,4112,64.6590447931864,80.67933799380108
11697,CR_04750W_A,68,CR,1032104,1032370,266,28.582342318514335,35.66406624078281
11699,CR_04760C_A,258,CR,1032764,1034449,1685,17.119471012698565,21.361088653974885
11701,CR_04770C_A,117,CR,1034922,1035491,569,22.990273380461154,28.686474453262754
11703,CR_04780W_A,382,CR,1036032,1036478,446,95.76328698459768,119.49014438335605
11705,CR_04790W_A,299,CR,1037049,1037616,567,58.96016220460419,73.56846779734464
11707,CR_04800W_A,176,CR,1038242,1040401,2159,9.114452074650348,11.372700631613819
11709,CR_04810W_A,5949,CR,1040990,1041745,755,880.9830596894411,1099.2604401571268
11711,CR_04820W_A,1612,CR,1043307,1043612,305,590.9295914870008,737.3416726864871
11713,CR_04830C_A,225,CR,1044383,1046803,2420,10.39531591980483,12.970918598145666
11715,CR_04840C_A,661,CR,1048237,1050153,1916,38.572385181253075,48.129299021029404
11717,CR_04850C_A,19,CR,1051306,1052082,776,2.737552267999004,3.4158238095231255
11719,CR_04860C_A,130,CR,1052051,1053439,1388,10.471874442429074,13.066445696370883
11721,CR_04870C_A,868,CR,1054455,1055960,1505,64.48426669178363,80.46125587455403
11723,CR_04880W_A,299,CR,1056963,1058072,1109,30.14464559964885,37.61345468087863
11725,CR_04890W_A,11,CR,1058318,1059307,989,1.2435605427938639,1.5516721855190998
11727,CR_04900C_A,51,CR,1059951,1060796,845,6.748138807743917,8.42009611246884
11729,CR_04910W_A,79,CR,1062959,1064113,1154,7.654059301168062,9.550472626972805
11731,CR_04920W_A,740,CR,1064625,1065713,1088,76.04547283164416,94.88693229395122
11733,CR_04930W_A,981,CR,1066170,1067528,1358,80.76808345585032,100.77964382382517
11735,CR_04940W_A,179,CR,1068772,1069845,1073,18.651933106103577,23.27324228371022
11737,CR_04950W_A,201,CR,1070692,1073802,3110,7.226137291477621,9.016526222951077
11739,CR_04960C_A,270,CR,1073848,1074759,911,33.13720903525052,41.3474726772942
11741,CR_04970C_A,3,CR,1075494,1076363,869,0.38598641389992616,0.4816206061758729
11743,CR_04980C_A,1,CR,1077754,1078335,581,0.1924395832926195,0.24011951048011104
11745,CR_04990C_A,1,CR,1079939,1080766,827,0.13519636988272302,0.1686933924896548
11747,CR_05000C_A,1,CR,1081690,1082016,326,0.34296747819942314,0.4279430539538175
11749,CR_05010W_A,411,CR,1082017,1084071,2054,22.372366374891875,27.915471288732324
11751,CR_05020W_A,106,CR,1084330,1085919,1589,7.458517417658443,9.306482172704921
11753,CR_05030W_A,1001,CR,1087249,1090161,2912,38.433793025722856,47.95636848369968
11755,CR_05040W_A,43,CR,1091568,1091867,299,16.07932478060038,20.063229867306404
11757,CR_05050W_A,9270,CR,1095486,1096607,1121,924.580355457824,1153.6596502315035
11759,CR_05070W_A,2,CR,1098929,1099026,97,2.3053071730517924,2.8764832080194744
11761,CR_05080W_A,512,CR,1099596,1101072,1476,38.78413802250821,48.393516952262594
11763,CR_05090C_A,32,CR,1101386,1103358,1972,1.8143188299068875,2.2638447965751647
11765,CR_05100W_A,732,CR,1105182,1109018,3836,21.335509712639404,26.62171711447012
11767,CR_05120W_A,859,CR,1110467,1113241,2774,34.622406196862755,43.20065074654049
11769,CR_05130C_A,274,CR,1113311,1114213,902,33.963666322267485,42.37869772879245
11771,CR_05140W_A,100,CR,1114420,1115133,713,15.681261976579515,19.566540755812696
11773,CR_05150W_A,228,CR,1115354,1115629,275,92.69849716220628,115.66600477919764
11775,CR_05160C_A,120,CR,1115649,1116845,1196,11.21813356786073,13.997602233004466
11777,CR_05170C_A,377,CR,1117036,1118175,1139,37.00736523763433,46.17652082267961
11779,CR_05180C_A,3445,CR,1119608,1120399,791,486.9487809626121,607.597984328589
11781,CR_05190W_A,1,CR,1122154,1122981,827,0.13519636988272302,0.1686933924896548
11783,CR_05200C_A,316,CR,1124185,1124604,419,84.3225244252787,105.21475333199633
11785,CR_05210W_A,94,CR,1125688,1126713,1025,10.253556489700607,12.794036044254423
11787,CR_05220C_A,1167,CR,1126971,1128866,1895,68.85447669717412,85.91425400121278
11789,CR_05240C_A,1292,CR,1129264,1132713,3449,41.88320037047592,52.26042063813173
11791,CR_05250C_A,222,CR,1132887,1134713,1826,13.593232383487761,16.961169058458754
11793,CR_05260C_A,235,CR,1135405,1136463,1058,24.83434641290908,30.987445523064235
11795,CR_05270W_A,11,CR,1136783,1137096,313,3.9293334722783753,4.90288751271051
11797,CR_05280W_A,7,CR,1137083,1137402,319,2.4534538722604498,3.0613355771868704
11799,CR_05290W_A,138,CR,1138119,1139255,1136,13.582236715876451,16.94744904161474
11801,CR_05300C_A,1528,CR,1139330,1141312,1982,86.19662158452182,107.55318747724884
11803,CR_05310W_A,474,CR,1142603,1143064,461,114.96031800713159,143.44354114785185
11805,CR_05320C_A,9,CR,1146067,1146381,314,3.204670640245566,3.998678090128983
11807,CR_05330W_A,166,CR,1147599,1147784,185,100.32447594724316,125.18143950143129
11809,CR_05340C_A,153,CR,1148612,1149919,1307,13.08839470361961,16.331249919746373
11811,CR_05350W_A,13,CR,1151638,1151704,66,22.022669281956897,27.479131252367857
11813,CR_05360C_A,645,CR,1151763,1153322,1559,46.25771112315119,57.718785089717265
11815,CR_05370W_A,186,CR,1153825,1155368,1543,13.477755027932742,16.817080375595385
11817,CR_05380C_A,2640,CR,1155586,1156452,866,340.84472336899717,425.2943532965514
11819,CR_05390W_A,8537,CR,1157977,1158576,599,1593.4887409226094,1988.3005870163927
11821,CR_05400C_A,4,CR,1158859,1158954,95,4.707679911284713,5.874081498481874
11823,CR_05410C_A,3,CR,1158985,1159078,93,3.6066902546132886,4.5003043738369195
11825,CR_05420W_A,43,CR,1160039,1160353,314,15.311204170062148,19.104795319505143
11827,CR_05430W_A,167,CR,1160460,1161524,1064,17.548717526440786,21.896687728715914
11829,CR_05440W_A,510,CR,1162025,1162540,515,110.72188917560408,138.15497504924602
11831,CR_05450C_A,544,CR,1162653,1163300,647,94.00807488995132,117.3000509434093
11833,CR_05460W_A,256,CR,1163597,1164436,839,34.115248939941665,42.567837319153504
11835,CR_05470C_A,7,CR,1164573,1164644,71,11.023264581001177,13.754451396093119
11837,CR_05480W_A,1521,CR,1165883,1166743,860,197.74308394798973,246.73703666370304
11839,CR_05490W_A,303,CR,1167478,1168518,1040,32.574655347675595,40.64553748408672
11841,CR_05500C_A,333,CR,1168592,1171228,2636,14.124379172372146,17.62391580087956
11843,CR_05510W_A,1004,CR,1171820,1174612,2792,40.20581213631232,50.1674331415832
11845,CR_05520W_A,1795,CR,1174805,1176949,2144,93.60740635165878,116.80011048607994
11847,CR_05530C_A,822,CR,1177061,1178797,1736,52.94106052307363,66.05803920167764
11849,CR_05540C_A,336,CR,1179301,1181166,1865,20.14331672496087,25.1341396020833
11851,CR_05550C_A,1826,CR,1181749,1185222,3473,58.78500102293113,73.34990768367771
11853,CR_05560W_A,265,CR,1185511,1186995,1484,19.965606766609277,24.912399212311524
11855,CR_05570C_A,245,CR,1187177,1189627,2450,11.180739789301196,13.950943558894451
11857,CR_05580C_A,1,CR,1190023,1190650,627,0.17832120876078458,0.22250308706370736
11859,CR_05590C_A,2,CR,1190766,1190860,94,2.3788808062342968,2.968285863594564
11861,CR_05600C_A,1,CR,1190939,1191036,97,1.1526535865258962,1.4382416040097372
11863,CR_05610C_A,317,CR,1194011,1194859,848,41.79592586330753,52.1515225019993
11865,CR_05620C_A,795,CR,1198841,1200487,1646,54.00175050118135,67.38153176987296
11867,CR_05630W_A,539,CR,1201081,1202403,1322,45.5856183542613,56.88017078853335
11869,CR_05640C_A,100,CR,1202423,1202998,575,19.4447648509586,24.262510537207742
11871,CR_05650W_A,1201,CR,1203262,1204923,1661,80.84327806713266,100.8734690802663
11873,CR_05660W_A,2300,CR,1205203,1207482,2279,112.83765474064393,140.7949547409269
11875,CR_05670C_A,1419,CR,1207729,1208400,671,236.44515292128753,295.02815067170235
11877,CR_05680C_A,65,CR,1208432,1208830,398,18.260002168456726,22.78420430472712
11879,CR_05690W_A,310,CR,1209450,1210475,1025,33.81492033837435,42.19309759275395
11881,CR_05700C_A,493,CR,1210658,1211560,902,61.109808382765955,76.25072255582002
11883,CR_05710C_A,71,CR,1211886,1212743,857,9.262923279351048,11.557957907602171
11885,CR_05720W_A,741,CR,1213671,1215107,1436,57.694485960112715,71.98920039791636
11887,CR_05730C_A,705,CR,1215325,1216785,1460,53.989188708611934,67.36585759603142
11889,CR_05740C_A,563,CR,1217854,1218891,1037,60.70160560633146,75.7413811345957
11891,CR_05750W_A,1415,CR,1219964,1220992,1028,153.89831519320222,192.029038286339
11893,CR_05760C_A,199,CR,1221035,1222030,995,22.36147957860239,27.901887117788903
11895,CR_05770W_A,293,CR,1222388,1223902,1514,21.63775930161988,26.99885378306522
11897,CR_05780W_A,4189,CR,1224232,1225770,1538,304.5261311923453,379.977259871319
11899,CR_05790C_A,4946,CR,1225928,1228303,2375,232.84184841214193,290.5320709149135
11901,CR_05800C_A,235,CR,1228646,1229050,404,65.03648144766784,81.1502905034702
11903,CR_05810C_A,1,CR,1229471,1229561,90,1.242304421033466,1.550104839877161
11905,CR_05820C_A,3,CR,1230058,1230148,90,3.726913263100398,4.650314519631484
11907,CR_05830C_A,479,CR,1230747,1232063,1316,40.69585379236529,50.77889030934986
11909,CR_05840W_A,456,CR,1232321,1233040,719,70.90983788485876,88.47886318297455
11911,CR_05850W_A,1,CR,1233214,1233287,73,1.531608190315232,1.9110881587526645
11913,CR_05860W_A,1368,CR,1233738,1234418,680,224.93017693770636,280.660158655406
11915,CR_05870W_A,1,CR,1234600,1234681,81,1.38033824559274,1.7223387109746235
11917,CR_05880W_A,560,CR,1235017,1235643,626,100.01939747617682,124.80077305081296
11919,CR_05890C_A,1110,CR,1235775,1236602,827,150.06797056982256,187.2496656635168
11921,CR_05900W_A,370,CR,1236909,1238417,1508,27.432849615659435,34.22976867898506
11923,CR_05910W_A,279,CR,1238642,1239028,386,80.81415547189206,100.83713090496249
11925,CR_05920C_A,1713,CR,1239215,1242844,3629,52.77654246093399,65.85275920745714
11927,CR_05930C_A,2,CR,1243713,1243794,81,2.76067649118548,3.444677421949247
11929,CR_05940W_A,224,CR,1244534,1245652,1118,22.40148222543352,27.951801048232173
11931,CR_05950C_A,1535,CR,1245828,1248944,3116,55.07841969376551,68.72496265373229
11933,CR_05960W_A,94,CR,1249568,1249843,275,38.21780146161135,47.68686161949376
11935,CR_05970C_A,1780,CR,1249893,1251227,1334,149.1882820461479,186.1520205009904
11937,CR_05980W_A,1759,CR,1251495,1255409,3914,50.247627208433315,62.69726550867485
11939,CR_05990C_A,4125,CR,1255695,1258112,2417,190.8173422874118,238.095333804053
11941,CR_06000W_A,4307,CR,1274159,1276636,2477,194.4103604058145,242.57857855534277
11943,CR_06010W_A,833,CR,1278556,1279848,1292,72.08634864154719,89.94687294550369
11945,CR_06020W_A,518,CR,1280965,1282092,1127,51.389735677533444,64.12234927690618
11947,CR_06030C_A,316,CR,1282621,1285008,2387,14.801482083867523,18.468781586135933
11949,CR_06040W_A,3983,CR,1290764,1292656,1892,235.37466480331213,293.69243232070085
11951,CR_06050W_A,705,CR,1293451,1294404,953,82.71166370889132,103.20477658993272
11953,CR_06060W_A,633,CR,1295059,1295826,767,92.27390204208156,115.1362095538486
11955,CR_06070W_A,1772,CR,1295893,1297119,1226,161.60090462187372,201.64006514160658
11957,CR_06080W_A,2255,CR,1297516,1298547,1031,244.5447936457245,305.13460451316183
11959,CR_06090W_A,565,CR,1298889,1299875,986,64.06813368108696,79.9420193790605
11961,CR_06100C_A,179,CR,1299955,1301847,1892,10.577972633641194,13.198831379715152
11963,CR_06110C_A,849,CR,1302431,1304986,2555,37.152438673646635,46.35753847945749
11965,CR_06120W_A,880,CR,1308687,1309574,887,110.9250396232813,138.40845920887392
11967,CR_06130C_A,1,CR,1315840,1316193,353,0.31673483822382986,0.3952108656910609
11969,CR_06140W_A,2788,CR,1316618,1318372,1754,177.71894260303156,221.75160001252982
11971,CR_06150C_A,2312,CR,1318865,1320313,1448,178.52120437061023,222.7526347248893
11973,CR_06160C_A,97,CR,1320937,1321353,416,26.07047498947634,32.529844356076005
11975,CR_06170W_A,264,CR,1321747,1322535,788,37.458316045374566,46.739201770915415
11977,CR_06180W_A,2003,CR,1322879,1324033,1154,194.06431367391934,242.14679331425987
11979,CR_06190C_A,4,CR,1324260,1324350,90,4.969217684133864,6.200419359508644
11981,CR_06200C_A,1,CR,1324465,1324551,86,1.3000860220117667,1.6222027394063316
11983,CR_06210C_A,1,CR,1324474,1324560,86,1.3000860220117667,1.6222027394063316
11985,CR_06220C_A,1,CR,1324683,1324826,143,0.7818699153357478,0.9755904586639477
11987,CR_06230W_A,305,CR,1326329,1328179,1850,18.43311154452359,23.000204245744904
11989,CR_06240C_A,90,CR,1328224,1330083,1859,5.412945567709024,6.754087790750407
11991,CR_06250W_A,198,CR,1330782,1331681,899,24.624988634945904,30.726216069645176
11993,CR_06260W_A,343,CR,1331745,1332917,1172,32.72178965640197,40.82912662713991
11995,CR_06270W_A,53,CR,1334033,1334527,494,11.995530543177395,14.967611510554775
11997,CR_06290C_A,1152,CR,1335351,1336430,1079,119.37175382089877,148.94797942397042
11999,CR_06300C_A,332,CR,1336646,1337380,734,50.57228351564028,63.102360511620674
12001,CR_06310W_A,37,CR,1338711,1339799,1088,3.802273641582208,4.744346614697562
12003,CR_06320C_A,344,CR,1339957,1341360,1403,27.41393077348262,34.206162396719115
12005,CR_06330C_A,225,CR,1342340,1342891,551,45.656378449959504,56.96846280855266
12007,CR_06340C_A,6507,CR,1343151,1344803,1652,440.3939092553443,549.5084124559697
12009,CR_06350C_A,44,CR,1346060,1346347,287,17.14120385816211,21.388206153008912
12011,CR_06380C_A,302,CR,1348951,1350489,1538,21.954378519954233,27.393920382224472
12013,CR_06420W_A,648,CR,1364396,1365844,1448,50.035354858198716,62.4323993519586
12015,CR_06430W_A,83,CR,1366337,1367128,791,11.732002560202265,14.638790333606062
12017,CR_06440C_A,1625,CR,1368264,1370486,2222,81.76733644290928,102.0264774221579
12019,CR_06450W_A,254,CR,1378087,1380147,2060,13.785960711080113,17.201648854170827
12021,CR_06460W_A,286,CR,1380753,1381400,647,49.42336290170234,61.668776782748274
12023,CR_06470W_A,853,CR,1381903,1383804,1901,50.16923219502325,62.59944690024707
12025,CR_06480C_A,386,CR,1383886,1385961,2075,20.79887016226632,25.952116692690403
12027,CR_06490C_A,13050,CR,1386423,1388123,1700,858.2862014728271,1070.9400790798386
12029,CR_06500C_A,48,CR,1389144,1389644,500,10.733510197729148,13.392905816538674
12031,CR_06510W_A,72,CR,1390614,1391096,482,16.701520017213404,20.839583739427397
12033,CR_06520C_A,56,CR,1391227,1391886,659,9.501083887721803,11.855126544735802
12035,CR_06530W_A,379,CR,1392635,1393051,416,101.8629899073354,127.10114444281243
12037,CR_06540W_A,271,CR,1393317,1396052,2735,11.078539242781073,13.823421222889932
12039,CR_06550C_A,7839,CR,1396675,1397004,329,2664.006662867236,3324.0561263882555
12041,CR_06560C_A,841,CR,1400076,1400852,776,121.17270828353486,151.1951486215236
12043,CR_06570C_A,98,CR,1401467,1403584,2117,5.175779401754922,6.458159984750384
12045,CR_06580W_A,23,CR,1406153,1406851,698,3.6841979248413677,4.5970157858821254
12047,CR_06590C_A,1410,CR,1409035,1410333,1298,121.45487752630729,151.54722972296747
12049,CR_06600C_A,33,CR,1416506,1416586,80,46.12055163086743,57.54764218043961
12051,CR_06610W_A,54,CR,1418649,1420058,1409,4.285024475672566,5.346706544927611
12053,CR_06620W_A,203,CR,1420374,1421720,1346,16.862482743151133,21.040427507099356
12055,CR_06630W_A,3,CR,1424337,1424474,137,2.4483371801389477,3.0549511442834563
12057,CR_06640C_A,1010,CR,1424764,1426245,1481,76.24947459280355,95.14147869333824
12059,CR_06650C_A,44,CR,1426753,1427130,377,13.049139276637998,16.2822683445983
12061,CR_06660W_A,111,CR,1429410,1431239,1829,6.7854681061368645,8.46667433043895
12063,CR_06670W_A,21,CR,1433878,1436097,2219,1.0581141756436463,1.320278570242377
12065,CR_06680C_A,2038,CR,1436296,1439613,3317,68.69565176543816,85.71607769980974
12067,CR_06690C_A,340,CR,1439829,1440640,811,46.87363166908023,58.48730961805318
12069,CR_06700C_A,770,CR,1440889,1441668,779,110.51565645393993,137.89764493387327
12071,CR_06710C_A,696,CR,1441949,1443298,1349,57.68565525095354,71.97818174196098
12073,CR_06720W_A,1901,CR,1443567,1445129,1562,136.07289589924181,169.7870915842404
12075,CR_06730W_A,251,CR,1445416,1447335,1919,14.624104674906722,18.24745614008602
12077,CR_06740W_A,328,CR,1447534,1450149,2615,14.024025433616794,17.498697848250018
12079,CR_06750C_A,1360,CR,1450291,1451058,767,198.25040565123373,247.37005528157047
12081,CR_06760C_A,6242,CR,1451389,1453027,1638,426.0694613236755,531.6348577205077
12083,CR_06770C_A,872,CR,1453898,1454575,677,144.01189211625763,179.69309872017666
12085,CR_06780W_A,753,CR,1455508,1456623,1115,75.50759696272466,94.21578923630065
12087,CR_06790C_A,115,CR,1457397,1459211,1814,7.0881205940994345,8.844313722562635
12089,CR_06800C_A,1956,CR,1460975,1461292,317,689.8904425196573,860.8216277980299
12091,CR_06810W_A,1203,CR,1462250,1462660,410,328.05926747632526,409.34110003292744
12093,CR_06820W_A,81,CR,1462868,1463392,524,17.283204636133526,21.56538985248951
12095,CR_06830C_A,202,CR,1463495,1464340,845,26.72792233655434,33.350184602327566
12097,CR_06840W_A,641,CR,1464905,1467055,2150,33.3342056043817,41.59327823837834
12099,CR_06850C_A,20,CR,1467125,1467409,284,7.873760415000841,9.824608140066514
12101,CR_06860C_A,2568,CR,1467616,1469505,1889,151.99650491755145,189.65602466511885
12103,CR_06870C_A,39,CR,1470593,1472848,2255,1.9336977906108497,2.412801768500592
12105,CR_06880C_A,1,CR,1474054,1474135,81,1.38033824559274,1.7223387109746235
12107,CR_06900C_A,278,CR,1475518,1477209,1691,18.381109765971214,22.935318210364624
12109,CR_06910W_A,1148,CR,1479588,1484264,4676,27.44972044079934,34.25081951584865
12111,CR_06920W_A,32,CR,1484615,1485739,1124,3.1831287656373504,3.971798877977068
12113,CR_06930W_A,247,CR,1486110,1487075,965,28.618059357071452,35.70863273623761
12115,CR_06940W_A,130,CR,1487266,1489308,2042,7.11800280415845,8.881599719178642
12117,CR_06950C_A,75,CR,1489480,1489704,224,37.4355126873924,46.71074852308409
12119,CR_06960W_A,119,CR,1490321,1491811,1490,8.929584127025787,11.14202874837879
12121,CR_06970C_A,455,CR,1491831,1493075,1244,40.8941849206756,51.026361087596264
12123,CR_06980W_A,27,CR,1493258,1493704,446,6.76860928948727,8.445638477357628
12125,CR_06990W_A,2,CR,1496722,1499319,2597,0.08610504265923137,0.10743891843584483
12127,CR_07000C_A,1708,CR,1499481,1506116,6635,28.781768741712796,35.91290369041707
12129,CR_07010W_A,7600,CR,1507086,1509926,2840,299.20289577003194,373.33510932252756
12131,CR_07020W_A,1115,CR,1510568,1511113,545,228.74357550588684,285.4183865718773
12133,CR_07030C_A,226,CR,1511408,1512253,845,29.903517069610295,37.31258277290113
12135,CR_07040W_A,251,CR,1512664,1514073,1409,19.917428581366927,24.85228412549686
12137,CR_07050C_A,10886,CR,1514438,1521088,6650,183.02786969373355,228.37589711597747
12139,CR_07060C_A,1670,CR,1523634,1525187,1553,120.23074982699933,150.01980517291523
12141,CR_07070C_A,1263,CR,1532277,1535744,3467,40.73052885459305,50.82215666248541
12143,CR_07080W_A,693,CR,1538707,1539444,737,105.13232936208585,131.18051406124633
12145,CR_07090W_A,1433,CR,1540034,1545817,5783,27.705343451614407,34.569777139712514
12147,CR_07100W_A,3939,CR,1547917,1550352,2435,180.86625885033843,225.6787132586663
12149,CR_07110C_A,213,CR,1550708,1552915,2207,10.790655075311077,13.464209234456357
12151,CR_07120C_A,291,CR,1553189,1554349,1160,28.04823516109179,34.99762565205418
12153,CR_07130C_A,2623,CR,1555145,1556692,1547,189.5738879595154,236.54379414983933
12155,CR_07140C_A,153,CR,1557476,1558195,719,23.79211665873551,29.68698698902435
12157,CR_07150W_A,3072,CR,1559026,1560444,1418,242.2230792153263,302.237648892269
12159,CR_07160C_A,676,CR,1560577,1561917,1340,56.404329086325426,70.37938690904961
12161,CR_07170W_A,564,CR,1563256,1564104,848,74.36246746657869,92.7869359341565
12163,CR_07180W_A,1188,CR,1564407,1565804,1397,95.08030686964796,118.63794522524415
12165,CR_07190W_A,410,CR,1566214,1568853,2639,17.370607478641492,21.674448121056173
12167,CR_07200W_A,1077,CR,1569149,1570732,1583,76.06858340541622,94.91576887510628
12169,CR_07210W_A,723,CR,1570998,1571474,476,169.8251022618648,211.90193682942623
12171,CR_07220C_A,1869,CR,1571688,1574810,3122,66.93402519604079,83.51798049831432
12173,CR_07230W_A,1368,CR,1576200,1576703,503,304.0805572915315,379.4212880430936
12175,CR_07240C_A,2044,CR,1576964,1577719,755,302.69446528916086,377.69176999179143
12177,CR_07250C_A,377,CR,1579345,1581459,2114,19.939162254335624,24.879402657063427
12179,CR_07260C_A,12,CR,1582019,1582624,605,2.21766739622503,2.7671293009377425
12181,CR_07270C_A,264,CR,1582853,1584550,1697,17.393726012819773,21.70329463493303
12183,CR_07280W_A,1892,CR,1586232,1587092,860,245.9762753646263,306.9207582956779
12185,CR_07290W_A,4714,CR,1587150,1588361,1211,435.22714588576247,543.061502366874
12187,CR_07300W_A,26,CR,1589557,1591749,2192,1.32618263924193,1.6547652031535387
12189,CR_07310W_A,572,CR,1592134,1594029,1895,33.74872379672973,42.11049981893206
12191,CR_07320C_A,2198,CR,1594104,1595033,929,264.5346184809906,330.07722220075345
12193,CR_07330W_A,210,CR,1595318,1595608,290,80.96397778459486,101.02407404716672
12195,CR_07340C_A,461,CR,1595677,1596750,1073,48.03654280398742,59.93835023905258
12197,CR_07350W_A,1035,CR,1597334,1599787,2453,47.17515565400218,58.86354090279558
12199,CR_07360W_A,1079,CR,1600181,1602901,2720,44.35300820829408,55.34216213252615
12201,CR_07370W_A,353,CR,1603281,1603664,383,103.04963826692747,128.58180355847887
12203,CR_07380C_A,471,CR,1603744,1604676,932,56.503524042498526,70.50315897252453
12205,CR_07390C_A,1879,CR,1604878,1605645,767,273.9062589843148,341.7708337309345
12207,CR_07400C_A,11141,CR,1606023,1607498,1475,844.5059118142686,1053.7455063704617
12209,CR_07410C_A,1,CR,1607966,1608040,74,1.5109107823379992,1.8852626430938448
12211,CR_07420W_A,7643,CR,1609157,1610482,1325,644.9388242236154,804.7325405330588
12213,CR_07440W_A,764,CR,1611767,1614118,2351,36.33383751180822,45.336116031456235
12215,CR_07450C_A,1625,CR,1614446,1617163,2717,66.87045328529423,83.43865764889024
12217,CR_07460C_A,388,CR,1618134,1620149,2015,21.5291664429224,26.86335533921115
12219,CR_07470W_A,160,CR,1620898,1621350,452,39.577839962128124,49.38387100493611
12221,CR_07480W_A,2487,CR,1622533,1623873,1340,207.5111929551647,258.92534799231714
12223,CR_07490C_A,548,CR,1624294,1625424,1130,54.22164074811553,67.65590327676247
12225,CR_07500W_A,42,CR,1626254,1626940,686,6.845350891408896,8.541394015649663
12227,CR_07510W_A,223,CR,1627319,1627769,450,55.40677717809259,69.13467585852139
12229,CR_07520C_A,2037,CR,1627966,1628634,668,340.9456130360259,425.4202399620958
12231,CR_07530C_A,2787,CR,1629332,1631914,2582,120.68443761728284,150.5859012340776
12233,CR_07540C_A,15,CR,1634660,1636483,1823,0.9199731038920347,1.147910879777382
12235,CR_07550C_A,2,CR,1637820,1638125,305,0.7331632648722094,0.914815971075046
12237,CR_07560W_A,290,CR,1639406,1642045,2639,12.286527240990324,15.330707207576319
12239,CR_07570W_A,207,CR,1642482,1643309,827,27.985648565723665,34.919532245358546
12241,CR_07580C_A,583,CR,1643364,1647227,3863,16.873857875129683,21.054621006563462
12243,CR_07590W_A,607,CR,1649718,1650320,602,112.7360307658775,140.6681518313776
12245,CR_07600W_A,1529,CR,1650950,1654243,3293,51.91421542010789,64.77677710765143
12247,CR_07610C_A,41,CR,1654471,1654964,493,9.298384003272798,11.602204582447719
12249,CR_07620W_A,2327,CR,1655311,1656561,1250,208.140651917631,259.7107652923791
12251,CR_07630C_A,3847,CR,1657163,1657839,676,636.2767155242855,793.9242584477361
12253,CR_07640C_A,454,CR,1658503,1659099,596,85.16872255608628,106.27061033117585
12255,CR_07650W_A,2000,CR,1660822,1661814,992,225.41814091333055,281.2690233648075
12257,CR_07660C_A,511,CR,1662889,1663806,917,62.30488584877765,77.74189922132022
12259,CR_07670W_A,136,CR,1664072,1664860,788,19.29670826579902,24.077770609259456
12261,CR_07680C_A,168,CR,1665030,1667474,2444,7.685614912449267,9.589846636228591
12263,CR_07690W_A,203,CR,1669651,1669986,335,67.75194558889977,84.53855350613652
12265,CR_07700W_A,498,CR,1671100,1672311,1211,45.97859962900078,57.37051934210931
12267,CR_07710W_A,2148,CR,1672493,1673734,1241,193.52319957630112,241.47160970592492
12269,CR_07720C_A,316,CR,1673907,1675646,1739,20.316927966757778,25.350765753942763
12271,CR_07730W_A,320,CR,1677339,1679117,1778,20.12281626870856,25.10855983603051
12273,CR_07740W_A,79,CR,1679654,1679848,194,45.529816667772906,56.81054335838462
12275,CR_07750C_A,747,CR,1679976,1681796,1820,45.890179245098864,57.26019142029756
12277,CR_07760W_A,404,CR,1682063,1682338,275,164.25523181373393,204.9520435561221
12279,CR_07770C_A,932,CR,1682501,1683802,1301,80.09569164972109,99.94065639423235
12281,CR_07780W_A,1026,CR,1684645,1686483,1838,62.41261710458665,77.87632258664695
12283,CR_07790C_A,2829,CR,1686913,1688109,1196,264.46749886231675,329.9934726430803
12285,CR_07800W_A,412,CR,1692632,1693828,1196,38.515591916321846,48.05843433331534
12287,CR_07810W_A,154,CR,1696870,1698072,1202,14.324741493780232,17.87392103219422
12289,CR_07820W_A,339,CR,1699955,1702141,2186,17.338841667763518,21.63481183195434
12291,CR_07830C_A,1019,CR,1702917,1703366,449,253.74551993981999,316.61495515620146
12293,CR_07840C_A,347,CR,1703463,1704053,590,65.75791028622906,82.05046465993854
12295,CR_07850W_A,748,CR,1706856,1708703,1847,45.27987743582726,56.49867775881456
12297,CR_07860C_A,267,CR,1708816,1709559,743,40.17843235186297,50.13326958579836
12299,CR_07870W_A,234,CR,1712422,1713414,992,26.373922486859673,32.90847573368247
12301,CR_07880C_A,1,CR,1713590,1713660,70,1.597248541328742,1.9929919369849218
12303,CR_07890W_A,2610,CR,1723489,1725146,1657,176.11183373612624,219.74630469954448
12305,CR_07900C_A,7,CR,1725543,1725878,335,2.33627398582413,2.9151225346943628
12307,CR_07910C_A,1447,CR,1726113,1729280,3167,51.084718898385944,63.74175980334787
12309,CR_07920W_A,1272,CR,1731199,1733115,1916,74.22704077239624,92.6179551509068
12311,CR_07930C_A,29,CR,1733827,1734141,314,10.326160951902377,12.884629401526722
12313,CR_07940W_A,297,CR,1734390,1736519,2129,15.59736832983774,19.461861141341718
12315,CR_07950W_A,718,CR,1736935,1737786,851,94.33338623640725,117.70596328185917
12317,CR_07960C_A,816,CR,1737861,1741031,3170,28.780705577507177,35.91157711059265
12319,CR_07970C_A,2,CR,1742830,1743189,359,0.6228824395153868,0.7772113403283817
12321,CR_07990C_A,1,CR,1748632,1749009,377,0.2965713471963181,0.37005155328632494
12323,CR_08000C_A,2184,CR,1749562,1751244,1682,145.17678775168733,181.14661553285066
12325,CR_08010W_A,127,CR,1751963,1752281,318,44.65264003903307,55.71603245218853
12327,CR_08020C_A,604,CR,1752667,1752846,179,377.2718900970906,470.746922322472
12329,CR_08030C_A,1761,CR,1753067,1755388,2321,84.83103304161742,105.84925293930688
12331,CR_08040W_A,522,CR,1755653,1756840,1187,49.16888096053263,61.351242946444
12333,CR_08050C_A,1572,CR,1756914,1757813,899,195.5074855259341,243.94753364384957
12335,CR_08060C_A,2568,CR,1758278,1758928,650,441.7252273680841,551.1695855267839
12337,CR_08070W_A,947,CR,1760025,1761143,1118,94.70626637270331,118.17123032444584
12339,CR_08080W_A,139,CR,1761311,1762069,758,20.5029397191671,25.58286483755051
12341,CR_08090W_A,41261,CR,1762392,1764233,1841,2505.8582533751037,3126.723966233264
12343,CR_08100C_A,1836,CR,1764414,1765817,1403,146.31388633754094,182.56544814062872
12345,CR_08110W_A,210,CR,1765907,1767181,1274,18.429790861485486,22.99606081136448
12347,CR_08120C_A,3538,CR,1767218,1769941,2723,145.2716025506707,181.26492218644353
12349,CR_08130W_A,770,CR,1770028,1771158,1130,76.18734192709664,95.06395168450202
12351,CR_08140W_A,2,CR,1771650,1771740,90,2.484608842066932,3.100209679754322
12353,CR_08150W_A,5708,CR,1772154,1772513,359,1777.7064823769142,2218.161165297201
12355,CR_08160W_A,1456,CR,1773596,1775338,1742,93.45095943296522,116.6049013877745
12357,CR_08170C_A,406,CR,1775806,1776909,1103,41.154853621543836,51.35161455041838
12359,CR_08180C_A,532,CR,1777046,1777843,797,74.63178880687875,93.12298586363674
12361,CR_08190W_A,113,CR,1778013,1778471,458,27.585668039105567,34.42045026539461
12363,CR_08200C_A,2145,CR,1778586,1783058,4472,53.628548407985384,66.91586300051118
12365,CR_08210C_A,43194,CR,1783404,1785737,2333,2070.042325156776,2582.9278014697256
12367,CR_08220C_A,3,CR,1786876,1786961,85,3.9461434550474803,4.923862432550983
12369,CR_08230C_A,1,CR,1787634,1787708,74,1.5109107823379992,1.8852626430938448
12371,CR_08240W_A,1,CR,1788639,1788713,74,1.5109107823379992,1.8852626430938448
12373,CR_08250C_A,4818,CR,1788887,1791586,2699,199.58801150371676,249.03907397833817
12375,CR_08260C_A,4,CR,1791590,1791892,302,1.4808926873246615,1.8478070938933049
12377,CR_08270W_A,6,CR,1792283,1793203,920,0.7291786819109475,0.9098441451452902
12379,CR_08280W_A,212,CR,1793368,1794405,1037,22.857442963663,28.520733215869082
12381,CR_08290W_A,1331,CR,1794674,1795927,1253,118.7674753356735,148.19398145960506
12383,CR_08300C_A,2016,CR,1796429,1800589,4160,54.18358513276733,67.60841878541157
12385,CR_08310C_A,40,CR,1800912,1802069,1157,3.8654243005362816,4.823143840585809
12387,CR_08320W_A,376,CR,1802701,1803603,902,46.60707495318458,58.15470929206556
12389,CR_08330W_A,352,CR,1804012,1804677,665,59.18226174186497,73.845595980915
12391,CR_08340W_A,2996,CR,1805596,1806795,1199,279.37861892198816,348.59905673434343
12393,CR_08350W_A,1070,CR,1807225,1808469,1244,96.16874256070963,119.99605794225933
12395,CR_08360C_A,2963,CR,1808666,1809337,671,493.7188076855356,616.045391430764
12397,CR_08370W_A,1521,CR,1810203,1811660,1457,116.7186356865279,145.63750962991395
12399,CR_08380C_A,61,CR,1811724,1812676,952,7.1641294868421515,8.939155011476487
12401,CR_08390W_A,2,CR,1813131,1813216,85,2.6307623033649867,3.282574955033989
12403,CR_08400C_A,950,CR,1813616,1813984,368,288.6332282564167,360.14664078667744
12405,CR_08410W_A,1075,CR,1814233,1815585,1352,88.90011296966557,110.92651128558828
12407,CR_08420W_A,1650,CR,1816595,1818214,1619,113.94824368342788,142.1807095254839
12409,CR_08430W_A,2596,CR,1818617,1821289,2672,108.62724735413886,135.54135284015717
12411,CR_08440W_A,554,CR,1821550,1823403,1853,33.42757605651842,41.709782685523614
12413,CR_08450C_A,745,CR,1823510,1825432,1922,43.33845547882097,54.07623804045976
12415,CR_08460W_A,6346,CR,1826834,1827706,872,813.6809025562544,1015.2831172562406
12417,CR_08470W_A,740,CR,1828604,1830001,1397,59.22510697267634,73.89905679013525
12419,CR_08480C_A,1659,CR,1831039,1831209,170,1091.1086653206282,1361.4479626003467
12421,CR_08490W_A,3763,CR,1832314,1834842,2528,166.42849615166298,207.66376824414485
12423,CR_08500W_A,869,CR,1835068,1836330,1262,76.98940472981567,96.064738135335
12425,CR_08510W_A,13971,CR,1838763,1840133,1370,1140.190624790708,1422.6907478928056
12427,CR_08520C_A,219,CR,1840750,1841170,420,58.29957175849909,72.74420569994965
12429,CR_08530C_A,10,CR,1841759,1841873,114,9.807666481843153,12.237669788503904
12431,CR_08540C_A,556,CR,1842179,1844686,2507,24.796534993424267,30.94026573093464
12433,CR_08550W_A,595,CR,1845221,1846249,1028,64.71342582329,80.74719277764785
12435,CR_08560C_A,714,CR,1846338,1846997,659,121.13881956845302,151.15286344538146
12437,CR_08570W_A,2300,CR,1847067,1850804,3737,68.81375840351285,85.86344711120482
12439,CR_08580C_A,120,CR,1850799,1851599,800,16.771109683951792,20.926415338341677
12441,CR_08590W_A,561,CR,1851759,1854059,2300,27.27128270346944,34.02817102843386
12443,CR_08600C_A,1980,CR,1854148,1855146,998,221.8222924129896,276.7822469600302
12445,CR_08610W_A,472,CR,1855954,1856352,398,132.59570805402421,165.44837587432613
12447,CR_08620C_A,380,CR,1856428,1857492,1064,39.931213533218546,49.82479842462305
12449,CR_08630W_A,451,CR,1857629,1859377,1748,28.84733206507345,35.99471135618648
12451,CR_08640C_A,1156,CR,1859509,1861272,1763,73.31216787539525,91.47640813432778
12453,CR_08650C_A,867,CR,1861693,1863837,2144,45.21315950244467,56.41542941026814
12455,CR_08660W_A,3095,CR,1864316,1871566,7250,47.730192617775444,59.556096985901135
12457,CR_08670C_A,335,CR,1871583,1872386,803,46.64443125050934,58.2013211983766
12459,CR_08680C_A,1140,CR,1872526,1874673,2147,59.366759943192186,74.07580650740417
12461,CR_08690C_A,1537,CR,1874776,1875693,917,187.40236702460123,233.83424482029196
12463,CR_08700C_A,344,CR,1875929,1876468,539,71.3575971710503,89.03756186010558
12465,CR_08710W_A,3085,CR,1876702,1878855,2153,160.20707036690285,199.9008865731044
12467,CR_08720W_A,106,CR,1879051,1880910,1859,6.375247001968406,7.9548145091060345
12469,CR_08730W_A,7,CR,1880901,1880994,93,8.415610594097673,10.500710205619479
12471,CR_08740W_A,14,CR,1881722,1882402,680,2.3019170154443636,2.87225308565474
12473,CR_08750C_A,2,CR,1882565,1882635,70,3.194497082657484,3.9859838739698437
12475,CR_08760C_A,201,CR,1888934,1889054,120,187.277391470795,233.67830461148205
12477,CR_08770W_A,258557,CR,1891236,1893022,1786,16186.218016250554,20196.607579826836
12479,CR_08780W_A,1775,CR,1893023,1893161,138,1438.1024004354797,1794.4148418143225
12481,CR_08790W_A,2274,CR,1893162,1893318,156,1629.8078385173665,2033.6183110849988
12483,CR_08800W_A,1033,CR,1893319,1893469,150,769.9802801565422,960.7549797558646
12485,CR_08810W_A,274553,CR,1893470,1896830,3360,9136.02872432146,11399.623234896273
12487,CR_08820C_A,1,CR,1893653,1893922,269,0.4156408843606392,0.5186224371336228
12489,CR_08830W_A,3165,CR,1898484,1898747,263,1345.5148833892881,1678.8873142167656
12491,CR_08840C_A,494,CR,1899386,1900285,899,61.43810295789533,76.6603572646703
12493,CR_08850W_A,65,CR,1900674,1900997,323,22.499940752463708,28.074654220685428
12495,CR_08860W_A,3380,CR,1902380,1903915,1535,246.19479145171357,307.1934151730505
12497,CR_08870W_A,1366,CR,1904766,1905881,1115,136.97659688058684,170.9146986677114
12499,CR_08880C_A,33,CR,1906305,1906673,368,10.026206876275529,12.510356995747742
12501,CR_08890C_A,2182,CR,1907038,1907814,776,314.38626572493826,392.28039749365587
12503,CR_08900C_A,1310,CR,1908216,1909313,1097,133.51658271635887,166.59741168780064
12505,CR_08910C_A,2088,CR,1910065,1911267,1202,194.22117038320212,242.34251373520476
12507,CR_08920W_A,1209,CR,1911649,1912971,1322,102.25048718052301,127.58465024737816
12509,CR_08930C_A,706,CR,1913084,1913587,503,156.930463046653,195.81244836142113
12511,CR_08940W_A,884,CR,1914210,1915217,1007,98.1506849428228,122.46905765702776
12513,CR_08950W_A,2060,CR,1915454,1916695,1241,185.59487482643402,231.57891806061699
12515,CR_08960C_A,807,CR,1916751,1918823,2072,43.54660719095591,54.33596260631188
12517,CR_08970W_A,1,CR,1919560,1919633,73,1.531608190315232,1.9110881587526645
12519,CR_08980C_A,1110,CR,1919749,1921311,1562,79.45340055137213,99.13922759521665
12521,CR_08990C_A,14512,CR,1922057,1923109,1052,1542.346918463298,1924.4875753486335
12523,CR_09010C_A,2652,CR,1924790,1925941,1151,257.6135701236036,321.4413754838235
12525,CR_09020C_A,3071,CR,1926708,1929737,3029,113.3577150641927,141.4438681722181
12527,CR_09030C_A,13,CR,1930897,1931196,299,4.86119121273965,6.0656276343019355
12529,CR_09040W_A,628,CR,1931725,1932549,824,85.21243431651882,106.3251523663315
12531,CR_09050C_A,225,CR,1932933,1934693,1760,14.29355938973164,17.835013072450295
12533,CR_09060W_A,18,CR,1935842,1936579,737,2.730709853560672,3.407286079512892
12535,CR_09070C_A,81,CR,1936663,1938141,1478,6.127469032025688,7.6456456581221275
12537,CR_09090C_A,335,CR,1940339,1941622,1283,29.19366975382619,36.42685964325519
12539,CR_09100C_A,1795,CR,1942195,1943244,1049,191.319617938948,238.722056131702
12541,CR_09110C_A,488,CR,1943868,1944725,857,63.66628958201847,79.44061209732195
12543,CR_09120C_A,3933,CR,1945291,1946851,1560,281.8836512264205,351.72475010981975
12545,CR_09140C_A,1034,CR,1947500,1949866,2366,48.86257371993844,60.969043279361216
12547,CR_09150W_A,149,CR,1950586,1951170,584,28.526202544621192,35.59401695676837
12549,CR_09160C_A,8270,CR,1951279,1952634,1355,682.3964432289364,851.470872561307
12551,CR_09170C_A,1187,CR,1953918,1955363,1445,91.84455453218352,114.60048445956895
12553,CR_09180W_A,1294,CR,1957742,1958539,797,181.52920059417494,226.5059092247104
12555,CR_09190C_A,360,CR,1958669,1959574,905,44.47587098506553,55.49546609062986
12557,CR_09200C_A,260,CR,1959810,1961258,1448,20.0759139863143,25.05003677702042
12559,CR_09210W_A,742,CR,1961676,1963181,1505,55.12364733329891,68.78139615082846
12561,CR_09220C_A,90,CR,1963272,1964552,1280,7.861457664352403,9.809257189847662
12563,CR_09230C_A,812,CR,1964921,1966741,1820,49.88330059842071,62.242671262759856
12565,CR_09240C_A,1050,CR,1967127,1967570,443,265.0062478276807,330.6657051205231
12567,CR_09270C_A,4525,CR,1968719,1970188,1469,344.40331890121104,429.734646725646
12569,CR_09290W_A,393,CR,1972214,1973233,1019,43.12100821585249,53.8049148051572
12571,CR_09300C_A,1983,CR,1973390,1974295,905,244.98792267606927,305.6875257158861
12573,CR_09310W_A,402,CR,1974738,1976477,1739,25.846218489356414,32.25002478824364
12575,CR_09320C_A,1088,CR,1976705,1977280,575,211.55904157842957,263.9761146448202
12577,CR_09330C_A,5070,CR,1977674,1980379,2705,209.56137054253998,261.4834892554339
12579,CR_09340W_A,1460,CR,1981012,1981515,503,324.5304193316053,404.93792437347713
12581,CR_09350C_A,2,CR,1982021,1982734,713,0.31362523953159027,0.3913308151162539
12583,CR_09360W_A,113,CR,1983094,1984680,1586,7.9661008587076605,9.93982737802694
12585,CR_09370W_A,2332,CR,1985044,1988631,3587,72.68883520671979,90.69863501349836
12587,CR_09380W_A,1387,CR,1989010,1989912,902,171.92556638315696,214.5228239045078
12589,CR_09390C_A,14,CR,1990348,1992162,1814,0.8629016375425397,1.0766990618771903
12591,CR_09410W_A,326,CR,2000249,2002363,2114,17.241822002422847,21.513754021757762
12593,CR_09420C_A,468,CR,2002832,2005762,2930,17.858656045709758,22.283418380759738
12595,CR_09430C_A,5,CR,2006281,2006613,332,1.683846353810421,2.101045716700972
12597,CR_09440C_A,619,CR,2006760,2007807,1047,66.10198595584947,82.47979047713147
12599,CR_09450C_A,1,CR,2008897,2008968,71,1.5747520830001682,1.964921628013303
12601,CR_09460C_A,496,CR,2015134,2015427,293,189.27122646735128,236.16614352258185
12603,CR_09470W_A,1099,CR,2017154,2021266,4112,29.882376041930968,37.28620372379621
12605,CR_09480W_A,866,CR,2021791,2023167,1376,70.36715594138688,87.8017232703677
12607,CR_09490W_A,223,CR,2023612,2026119,2507,9.945372848082036,12.409495068342492
12609,CR_09500C_A,175,CR,2026459,2027463,1004,19.48834126621224,24.31688369329212
12611,CR_09510C_A,297,CR,2027819,2028619,800,41.50849646778069,51.79287796239565
12613,CR_09520C_A,927,CR,2028990,2031764,2774,37.363178747953164,46.62049271483474
12615,CR_09530C_A,1177,CR,2032341,2034509,2168,60.69986500003462,75.73920926576922
12617,CR_09550C_A,700,CR,2035681,2036295,614,127.4677174676032,159.04984513397585
12619,CR_09560C_A,69,CR,2037364,2038728,1364,5.6559460810981115,7.05729549533517
12621,CR_09570W_A,83,CR,2039079,2039942,863,10.753202810104279,13.417477582714247
12623,CR_09580C_A,231,CR,2040062,2041437,1375,18.78364284602601,23.437585178942676
12625,CR_09590W_A,306,CR,2042657,2043526,869,39.37061421779247,49.12530182993903
12627,CR_09600C_A,333,CR,2043667,2044170,503,74.01960934070175,92.35912932627936
12629,CR_09610C_A,1269,CR,2044932,2046140,1208,117.45330126343723,146.55420013441272
12631,CR_09620C_A,145,CR,2047539,2048129,590,27.478089312689377,34.28621722101179
12633,CR_09630W_A,1,CR,2049080,2049173,93,1.202230084871096,1.50010145794564
12635,CR_09640C_A,626,CR,2049605,2049799,194,360.7805725826056,450.1696220550478
12637,CR_09650W_A,2043,CR,2050217,2052358,2141,106.6896375037008,133.1236697376056
12639,CR_09660W_A,144,CR,2052941,2054116,1175,13.702353443909551,17.097326574304688
12641,CR_09670C_A,596,CR,2054141,2055052,911,73.14732068521965,91.2707174654346
12643,CR_09680C_A,476,CR,2055720,2057090,1370,38.8469499248713,48.47189148929751
12645,CR_09690C_A,1760,CR,2059146,2061044,1898,103.67809288287725,129.36596766941113
12647,CR_09700W_A,120,CR,2063617,2065386,1769,7.584447567643546,9.463613493879786
12649,CR_09710W_A,351,CR,2066448,2067626,1178,33.314428404454326,41.56860092675681
12651,CR_09720W_A,39,CR,2067865,2068431,566,7.704043317716372,9.61284096814282
12653,CR_09730C_A,1029,CR,2068472,2069818,1346,85.47534356011091,106.65320150150364
12655,CR_09740W_A,756,CR,2069945,2071549,1604,52.69725237351436,65.75382375638533
12657,CR_09750C_A,790,CR,2071617,2072705,1088,81.1836804554039,101.298211503002
12659,CR_09760W_A,260,CR,2073298,2073834,536,54.23493181377446,67.67248741254771
12661,CR_09770C_A,504,CR,2073883,2076060,2177,25.884670894845208,32.29800438072027
12663,CR_09780C_A,58,CR,2077962,2079998,2036,3.185083044103484,3.974237359606474
12665,CR_09790W_A,2355,CR,2090643,2092316,1673,157.38578723134677,196.38058625939289
12667,CR_09800C_A,2491,CR,2092517,2095135,2618,106.38358600133414,132.74178917191014
12669,CR_09810W_A,105,CR,2095754,2096467,713,16.46532507540849,20.54486779360333
12671,CR_09820C_A,36,CR,2096565,2097002,437,9.21067808729618,11.492768149203666
12673,CR_09830W_A,321,CR,2096976,2098658,1682,21.337797100866133,26.62457123903162
12675,CR_09840C_A,56,CR,2098780,2099424,644,9.7223824254793,12.131255268603871
12677,CR_09850C_A,16,CR,2100198,2100560,362,4.941763442785058,6.1661628989588735
12679,CR_09860W_A,1699,CR,2100701,2103163,2462,77.15709545906877,96.27397687474279
12681,CR_09880W_A,4933,CR,2106063,2108726,2663,207.1144926046669,258.4303589035912
12683,CR_09890C_A,984,CR,2112885,2113910,1025,107.33510197729146,133.92905816538672
12685,CR_09900C_A,395,CR,2114184,2116310,2126,20.773246551147565,25.920144429742745
12687,CR_09910W_A,269,CR,2118630,2120327,1697,17.72315264185045,22.114341881806762
12689,CR_09920W_A,2045,CR,2122776,2124491,1715,133.3213578374399,166.35381678098634
12691,CR_09930W_A,468,CR,2125325,2126614,1289,40.5941522218228,50.651990578453095
12693,CR_09940W_A,109,CR,2126919,2127764,845,14.422492745962488,17.995891691354974
12695,CR_09950C_A,4793,CR,2127986,2129536,1550,345.73732780722986,431.3991772760071
12697,CR_09960C_A,1919,CR,2129808,2132219,2411,88.99145439929072,111.04048398804832
12699,CR_09970W_A,2465,CR,2133546,2134433,887,310.71616212657773,387.7009681248571
12701,CR_09980W_A,1548,CR,2135208,2139131,3923,44.1187489009387,55.049861404967146
12703,CR_09990W_A,1273,CR,2139765,2144084,4319,32.954576873768055,41.11959053130965
12705,CR_10000C_A,90,CR,2144187,2144645,458,21.970886048845145,27.414517910491277
12707,CR_10010C_A,2271,CR,2144900,2146207,1307,194.27283903215772,242.40698410290204
12709,CR_10020C_A,676,CR,2146647,2147423,776,97.39922806143824,121.5314155388228
12711,CR_10030W_A,976,CR,2147924,2149489,1565,69.72780852624898,87.00396749828106
12713,CR_10040W_A,104,CR,2149779,2150093,314,37.03174962061542,46.20694681926825
12715,CR_10060W_A,664,CR,2150598,2152013,1415,52.46651038937098,65.46591182407008
12717,CR_10070C_A,5679,CR,2152028,2154073,2045,310.4910575229412,387.42009032255055
12719,CR_10100C_A,5150,CR,2155482,2157044,1562,368.6351467023121,459.97029019402316
12721,CR_10110W_A,439,CR,2161683,2163386,1703,28.821754359971962,35.96279637319239
12723,CR_10120C_A,35,CR,2163621,2164442,821,4.766454234172251,5.947418082354517
12725,CR_10130W_A,191,CR,2164549,2165283,734,29.09429563700992,36.30286402927575
12727,CR_10140W_A,3689,CR,2165844,2168006,2162,190.7758976999635,238.04362066957276
12729,CR_10160W_A,3512,CR,2172466,2174556,2090,187.8792255503627,234.42925253032206
12731,CR_10170C_A,268,CR,2174773,2176227,1454,20.608241152219534,25.71425635339555
12733,CR_10180W_A,85,CR,2176706,2177347,641,14.826254010773818,18.49969114673991
12735,CR_10190C_A,145,CR,2177405,2178733,1328,12.207886065125551,15.232581446082042
12737,CR_10200W_A,34,CR,2179388,2180371,983,3.8671938233595182,4.8253517904619665
12739,CR_10210W_A,2,CR,2180905,2181852,947,0.23612966820065878,0.29463449965986166
12741,CR_10230W_A,3094,CR,2182766,2184085,1319,262.26845267701214,327.24957825033687
12743,CR_10240W_A,1190,CR,2184322,2186232,1910,69.66010654067237,86.91949128316438
12745,CR_10250C_A,3302,CR,2186349,2187698,1349,273.67533568771347,341.48269556315404
12747,CR_10260W_A,215,CR,2188415,2189230,815,29.495203125150393,36.80310264002831
12749,CR_10270C_A,977,CR,2189291,2190331,1040,105.03444975141603,131.05838324076805
12751,CR_10280W_A,398,CR,2190995,2191321,326,136.50105632337042,170.3213354736194
12753,CR_10290C_A,1170,CR,2191398,2195222,3824,34.2088534348389,42.684633796826645
12755,CR_10300W_A,1850,CR,2195626,2196444,818,252.86514193407348,315.51644968159826
12757,CR_10310W_A,25,CR,2197472,2197963,491,5.692841033249081,7.103331750964587
12759,CR_10320W_A,2,CR,2199524,2199919,395,0.566113407053225,0.7063768890579469
12761,CR_10330W_A,50,CR,2201576,2201950,374,14.947513087301063,18.650994062693115
12763,CR_10340W_A,7435,CR,2206795,2209563,2768,300.32081045323116,374.7300049146685
12765,CR_10350C_A,1226,CR,2210175,2210486,311,440.7584238483364,549.963241260598
12767,CR_10360C_A,1694,CR,2211476,2213536,2060,91.94258836444769,114.72280771246213
12769,CR_10370W_A,3357,CR,2214108,2214965,857,437.9666682926968,546.4797844481759
12771,CR_10380C_A,350,CR,2215084,2216109,1025,38.17813586590652,47.63736824988349
12773,CR_10390W_A,177,CR,2216407,2217153,746,26.52802872260471,33.10076420810078
12775,CR_10400W_A,628,CR,2217315,2217947,632,111.09975613419542,138.62646447762208
12777,CR_10410C_A,655,CR,2217987,2218817,830,88.23354893966606,110.0947955551309
12779,CR_10420W_A,1222,CR,2219749,2221599,1850,73.85331904068141,92.15163799442713
12781,CR_10430C_A,92,CR,2221721,2222299,578,17.7963332286455,22.205654107582863
12783,CR_10440W_A,425,CR,2222852,2225545,2693,17.645059080776118,22.01689941526232
12785,CR_10450C_A,312,CR,2225562,2226548,986,35.37921718318431,44.144973533215705
12787,CR_10460W_A,29,CR,2226852,2226936,84,38.60017308211127,48.16397181046894
12789,CR_10470C_A,1355,CR,2227306,2228901,1595,94.98371419751173,118.51742020252026
12791,CR_10480W_A,873,CR,2229306,2229704,398,245.24587527788802,306.00939012348886
12793,CR_10490W_A,1922,CR,2230203,2230832,629,341.64359101807463,426.29115294427874
12795,CR_10500C_A,312,CR,2230879,2231769,890,39.195402407437896,48.906678543540096
12797,CR_10510W_A,574,CR,2231968,2235234,3266,19.650167296567318,24.51880466260078
12799,CR_10520C_A,97,CR,2235243,2235953,710,15.275095205101632,19.05973979172904
12801,CR_10530W_A,295,CR,2236119,2237606,1487,22.18102379182147,27.6767205774974
12803,CR_10540C_A,717,CR,2237629,2239323,1694,47.32343818730199,59.04856276108219
12805,CR_10550W_A,2254,CR,2240734,2242575,1841,136.88966586140626,170.80622912410695
12807,CR_10570C_A,472,CR,2244004,2245206,1202,43.90440250041733,54.782407319452425
12809,CR_10580W_A,916,CR,2245713,2246984,1271,80.5787383713603,100.54338552279557
12811,CR_10590W_A,802,CR,2247055,2249460,2405,37.28462915184848,46.52248122342349
12813,CR_10600C_A,960,CR,2249443,2250489,1046,102.61482024597655,128.03925254817088
12815,CR_10610C_A,152,CR,2250555,2250956,401,42.38085905171525,52.88138206862734
12817,CR_10620C_A,1599,CR,2251020,2253017,1997,89.52430106706366,111.70535178103268
12819,CR_10630W_A,148,CR,2253074,2254015,941,17.585010508146407,21.94197286627395
12821,CR_10640W_A,431,CR,2254171,2255601,1430,33.69859335097073,42.04794876841614
12823,CR_10650W_A,753,CR,2255688,2256839,1151,73.14593450342137,91.26898783533903
12825,CR_10660W_A,1077,CR,2257148,2258155,1007,119.5795109540952,149.20721164775892
12827,CR_10670W_A,2468,CR,2258666,2259775,1109,248.81934896298782,310.4682480013662
12829,CR_10680W_A,7894,CR,2260358,2265544,5186,170.19043558955576,212.35778722312534
12831,CR_10690W_A,153,CR,2265597,2266343,746,22.931007878861703,28.612524993443042
12833,CR_10700W_A,619,CR,2266418,2267389,971,71.27577682366055,88.93546923744249
12835,CR_10710C_A,453,CR,2267386,2268957,1571,32.23981619703018,40.22773667841621
12837,CR_10720W_A,390,CR,2269081,2270994,1913,22.793980751842476,28.441547245001754
12839,CR_10730C_A,800,CR,2270978,2271985,1007,88.82414926952289,110.83172638645046
12841,CR_10740W_A,286,CR,2272097,2272774,677,47.23325819409367,58.93603925914052
12843,CR_10750C_A,394,CR,2272778,2273182,404,109.03988804417503,136.05623173773301
12845,CR_10760C_A,222,CR,2273274,2273660,386,64.30373661204314,80.23599663405616
12847,CR_10770W_A,456,CR,2274183,2275754,1571,32.45332491356681,40.494145530591155
12849,CR_10780C_A,309,CR,2275766,2276572,806,42.86412648751947,53.48438659675416
12851,CR_10790W_A,251,CR,2276745,2278457,1712,16.392322938753505,20.453778231790345
12853,CR_10800C_A,1803,CR,2278465,2281236,2771,72.74945449336,90.77427367985095
12855,CR_10810C_A,670,CR,2281329,2282324,995,75.2873935560985,93.94102697949029
12857,CR_10820W_A,293,CR,2282415,2282765,350,93.59876452186428,116.7893275073164
12859,CR_10830C_A,1054,CR,2282796,2283272,476,247.57352390595503,308.91375023266284
12861,CR_10840C_A,2187,CR,2283372,2284454,1082,225.99147799631896,281.9844137088925
12863,CR_10850C_A,6305,CR,2284743,2285228,485,1453.4961726091556,1813.6226626562786
12865,CR_10860C_A,538,CR,2285377,2286198,821,73.26721079956204,91.42031223733514
